County Name/State Abbreviation,State,Year,LaborForce,Employed,Unemployed,UnemploymentRate,LaborForceChange
"Abbeville County, SC",SC,2021,9621,9184,437,4.5,-115
"Abbeville County, SC",SC,2020,9736,9107,629,6.5,-88
"Abbeville County, SC",SC,2019,9824,9502,322,3.3,109
"Abbeville County, SC",SC,2018,9715,9334,381,3.9,-43
"Abbeville County, SC",SC,2017,9758,9316,442,4.5,-494
"Abbeville County, SC",SC,2016,10252,9702,550,5.4,-90
"Abbeville County, SC",SC,2015,10342,9637,705,6.8,-228
"Abbeville County, SC",SC,2014,10570,9776,794,7.5,0
"Abbeville County, SC",SC,2013,10570,9590,980,9.3,-127
"Abbeville County, SC",SC,2012,10697,9584,1113,10.4,-128
"Abbeville County, SC",SC,2011,10825,9493,1332,12.3,-201
"Abbeville County, SC",SC,2010,11026,9506,1520,13.8,0
"Acadia Parish, LA",LA,2021,23518,22355,1163,4.9,207
"Acadia Parish, LA",LA,2020,23311,21493,1818,7.8,-669
"Acadia Parish, LA",LA,2019,23980,22748,1232,5.1,-7
"Acadia Parish, LA",LA,2018,23987,22713,1274,5.3,-81
"Acadia Parish, LA",LA,2017,24068,22647,1421,5.9,-472
"Acadia Parish, LA",LA,2016,24540,22724,1816,7.4,-1170
"Acadia Parish, LA",LA,2015,25710,23962,1748,6.8,-833
"Acadia Parish, LA",LA,2014,26543,25045,1498,5.6,197
"Acadia Parish, LA",LA,2013,26346,24838,1508,5.7,79
"Acadia Parish, LA",LA,2012,26267,24767,1500,5.7,370
"Acadia Parish, LA",LA,2011,25897,24257,1640,6.3,-224
"Acadia Parish, LA",LA,2010,26121,24332,1789,6.8,0
"Accomack County, VA",VA,2021,15176,14516,660,4.3,-849
"Accomack County, VA",VA,2020,16025,14987,1038,6.5,-770
"Accomack County, VA",VA,2019,16795,16206,589,3.5,-118
"Accomack County, VA",VA,2018,16913,16273,640,3.8,124
"Accomack County, VA",VA,2017,16789,16035,754,4.5,969
"Accomack County, VA",VA,2016,15820,15060,760,4.8,-118
"Accomack County, VA",VA,2015,15938,15082,856,5.4,-174
"Accomack County, VA",VA,2014,16112,15056,1056,6.6,-114
"Accomack County, VA",VA,2013,16226,15083,1143,7.0,-162
"Accomack County, VA",VA,2012,16388,15123,1265,7.7,-176
"Accomack County, VA",VA,2011,16564,15177,1387,8.4,-267
"Accomack County, VA",VA,2010,16831,15471,1360,8.1,0
"Ada County, ID",ID,2021,266936,258240,8696,3.3,7448
"Ada County, ID",ID,2020,259488,245265,14223,5.5,3059
"Ada County, ID",ID,2019,256429,249853,6576,2.6,10127
"Ada County, ID",ID,2018,246302,240076,6226,2.5,10221
"Ada County, ID",ID,2017,236081,229402,6679,2.8,10946
"Ada County, ID",ID,2016,225135,217925,7210,3.2,7680
"Ada County, ID",ID,2015,217455,210124,7331,3.4,6503
"Ada County, ID",ID,2014,210952,203035,7917,3.8,2785
"Ada County, ID",ID,2013,208167,196090,12077,5.8,3103
"Ada County, ID",ID,2012,205064,192057,13007,6.3,4958
"Ada County, ID",ID,2011,200106,185656,14450,7.2,2821
"Ada County, ID",ID,2010,197285,181222,16063,8.1,0
"Adair County, IA",IA,2021,4307,4174,133,3.1,68
"Adair County, IA",IA,2020,4239,4076,163,3.8,-108
"Adair County, IA",IA,2019,4347,4250,97,2.2,152
"Adair County, IA",IA,2018,4195,4096,99,2.4,19
"Adair County, IA",IA,2017,4176,4061,115,2.8,-79
"Adair County, IA",IA,2016,4255,4131,124,2.9,31
"Adair County, IA",IA,2015,4224,4089,135,3.2,73
"Adair County, IA",IA,2014,4151,3985,166,4.0,73
"Adair County, IA",IA,2013,4078,3906,172,4.2,14
"Adair County, IA",IA,2012,4064,3885,179,4.4,-49
"Adair County, IA",IA,2011,4113,3910,203,4.9,18
"Adair County, IA",IA,2010,4095,3864,231,5.6,0
"Adair County, KY",KY,2021,7267,6906,361,5.0,248
"Adair County, KY",KY,2020,7019,6530,489,7.0,-125
"Adair County, KY",KY,2019,7144,6782,362,5.1,-48
"Adair County, KY",KY,2018,7192,6844,348,4.8,23
"Adair County, KY",KY,2017,7169,6744,425,5.9,86
"Adair County, KY",KY,2016,7083,6622,461,6.5,-136
"Adair County, KY",KY,2015,7219,6707,512,7.1,-5
"Adair County, KY",KY,2014,7224,6602,622,8.6,-335
"Adair County, KY",KY,2013,7559,6799,760,10.1,-270
"Adair County, KY",KY,2012,7829,7082,747,9.5,63
"Adair County, KY",KY,2011,7766,6854,912,11.7,-86
"Adair County, KY",KY,2010,7852,6867,985,12.5,0
"Adair County, MO",MO,2021,9908,9481,427,4.3,-138
"Adair County, MO",MO,2020,10046,9536,510,5.1,-217
"Adair County, MO",MO,2019,10263,9885,378,3.7,-342
"Adair County, MO",MO,2018,10605,10235,370,3.5,145
"Adair County, MO",MO,2017,10460,10016,444,4.2,101
"Adair County, MO",MO,2016,10359,9772,587,5.7,-21
"Adair County, MO",MO,2015,10380,9784,596,5.7,-177
"Adair County, MO",MO,2014,10557,9873,684,6.5,-188
"Adair County, MO",MO,2013,10745,10001,744,6.9,70
"Adair County, MO",MO,2012,10675,9900,775,7.3,-191
"Adair County, MO",MO,2011,10866,9914,952,8.8,-170
"Adair County, MO",MO,2010,11036,10089,947,8.6,0
"Adair County, OK",OK,2021,8467,8156,311,3.7,207
"Adair County, OK",OK,2020,8260,7771,489,5.9,190
"Adair County, OK",OK,2019,8070,7754,316,3.9,-70
"Adair County, OK",OK,2018,8140,7815,325,4.0,-52
"Adair County, OK",OK,2017,8192,7808,384,4.7,51
"Adair County, OK",OK,2016,8141,7683,458,5.6,-15
"Adair County, OK",OK,2015,8156,7673,483,5.9,74
"Adair County, OK",OK,2014,8082,7457,625,7.7,-161
"Adair County, OK",OK,2013,8243,7459,784,9.5,-207
"Adair County, OK",OK,2012,8450,7701,749,8.9,-356
"Adair County, OK",OK,2011,8806,8038,768,8.7,-67
"Adair County, OK",OK,2010,8873,7980,893,10.1,0
"Adams County, CO",CO,2021,276299,259081,17218,6.2,5950
"Adams County, CO",CO,2020,270349,249734,20615,7.6,-754
"Adams County, CO",CO,2019,271103,263585,7518,2.8,4609
"Adams County, CO",CO,2018,266494,257987,8507,3.2,7981
"Adams County, CO",CO,2017,258513,251187,7326,2.8,4914
"Adams County, CO",CO,2016,253599,244903,8696,3.4,5856
"Adams County, CO",CO,2015,247743,237372,10371,4.2,2801
"Adams County, CO",CO,2014,244942,230977,13965,5.7,3343
"Adams County, CO",CO,2013,241599,222280,19319,8.0,2802
"Adams County, CO",CO,2012,238797,216056,22741,9.5,2781
"Adams County, CO",CO,2011,236016,211759,24257,10.3,2453
"Adams County, CO",CO,2010,233563,209082,24481,10.5,0
"Adams County, IA",IA,2021,2027,1966,61,3.0,-30
"Adams County, IA",IA,2020,2057,1981,76,3.7,-164
"Adams County, IA",IA,2019,2221,2184,37,1.7,73
"Adams County, IA",IA,2018,2148,2107,41,1.9,-6
"Adams County, IA",IA,2017,2154,2104,50,2.3,-73
"Adams County, IA",IA,2016,2227,2169,58,2.6,-62
"Adams County, IA",IA,2015,2289,2226,63,2.8,77
"Adams County, IA",IA,2014,2212,2138,74,3.3,59
"Adams County, IA",IA,2013,2153,2074,79,3.7,-38
"Adams County, IA",IA,2012,2191,2104,87,4.0,-27
"Adams County, IA",IA,2011,2218,2118,100,4.5,-16
"Adams County, IA",IA,2010,2234,2124,110,4.9,0
"Adams County, ID",ID,2021,1804,1685,119,6.6,28
"Adams County, ID",ID,2020,1776,1606,170,9.6,42
"Adams County, ID",ID,2019,1734,1615,119,6.9,4
"Adams County, ID",ID,2018,1730,1634,96,5.5,-30
"Adams County, ID",ID,2017,1760,1659,101,5.7,20
"Adams County, ID",ID,2016,1740,1624,116,6.7,28
"Adams County, ID",ID,2015,1712,1591,121,7.1,49
"Adams County, ID",ID,2014,1663,1510,153,9.2,-75
"Adams County, ID",ID,2013,1738,1478,260,15.0,-14
"Adams County, ID",ID,2012,1752,1485,267,15.2,15
"Adams County, ID",ID,2011,1737,1433,304,17.5,-119
"Adams County, ID",ID,2010,1856,1521,335,18.0,0
"Adams County, IL",IL,2021,30856,29647,1209,3.9,-283
"Adams County, IL",IL,2020,31139,29136,2003,6.4,-1151
"Adams County, IL",IL,2019,32290,31239,1051,3.3,-685
"Adams County, IL",IL,2018,32975,31715,1260,3.8,543
"Adams County, IL",IL,2017,32432,31172,1260,3.9,-189
"Adams County, IL",IL,2016,32621,31068,1553,4.8,42
"Adams County, IL",IL,2015,32579,30956,1623,5.0,-50
"Adams County, IL",IL,2014,32629,30873,1756,5.4,-298
"Adams County, IL",IL,2013,32927,30704,2223,6.8,-804
"Adams County, IL",IL,2012,33731,31518,2213,6.6,-645
"Adams County, IL",IL,2011,34376,32000,2376,6.9,-451
"Adams County, IL",IL,2010,34827,32120,2707,7.8,0
"Adams County, IN",IN,2021,16691,16326,365,2.2,-85
"Adams County, IN",IN,2020,16776,15831,945,5.6,-620
"Adams County, IN",IN,2019,17396,16929,467,2.7,-119
"Adams County, IN",IN,2018,17515,17062,453,2.6,255
"Adams County, IN",IN,2017,17260,16812,448,2.6,203
"Adams County, IN",IN,2016,17057,16454,603,3.5,159
"Adams County, IN",IN,2015,16898,16257,641,3.8,474
"Adams County, IN",IN,2014,16424,15673,751,4.6,505
"Adams County, IN",IN,2013,15919,14969,950,6.0,18
"Adams County, IN",IN,2012,15901,14797,1104,6.9,-291
"Adams County, IN",IN,2011,16192,14955,1237,7.6,-211
"Adams County, IN",IN,2010,16403,14792,1611,9.8,0
"Adams County, MS",MS,2021,10634,9762,872,8.2,205
"Adams County, MS",MS,2020,10429,9310,1119,10.7,-716
"Adams County, MS",MS,2019,11145,10353,792,7.1,-76
"Adams County, MS",MS,2018,11221,10494,727,6.5,14
"Adams County, MS",MS,2017,11207,10368,839,7.5,0
"Adams County, MS",MS,2016,11207,10261,946,8.4,-173
"Adams County, MS",MS,2015,11380,10461,919,8.1,-188
"Adams County, MS",MS,2014,11568,10592,976,8.4,-273
"Adams County, MS",MS,2013,11841,10742,1099,9.3,-655
"Adams County, MS",MS,2012,12496,11281,1215,9.7,-452
"Adams County, MS",MS,2011,12948,11579,1369,10.6,318
"Adams County, MS",MS,2010,12630,11220,1410,11.2,0
"Adams County, ND",ND,2021,967,934,33,3.4,-44
"Adams County, ND",ND,2020,1011,973,38,3.8,-50
"Adams County, ND",ND,2019,1061,1041,20,1.9,-22
"Adams County, ND",ND,2018,1083,1063,20,1.8,-47
"Adams County, ND",ND,2017,1130,1102,28,2.5,-1
"Adams County, ND",ND,2016,1131,1102,29,2.6,31
"Adams County, ND",ND,2015,1100,1068,32,2.9,0
"Adams County, ND",ND,2014,1100,1071,29,2.6,3
"Adams County, ND",ND,2013,1097,1070,27,2.5,-8
"Adams County, ND",ND,2012,1105,1075,30,2.7,-55
"Adams County, ND",ND,2011,1160,1129,31,2.7,-44
"Adams County, ND",ND,2010,1204,1170,34,2.8,0
"Adams County, NE",NE,2021,16942,16539,403,2.4,-90
"Adams County, NE",NE,2020,17032,16364,668,3.9,59
"Adams County, NE",NE,2019,16973,16434,539,3.2,235
"Adams County, NE",NE,2018,16738,16242,496,3.0,-37
"Adams County, NE",NE,2017,16775,16249,526,3.1,26
"Adams County, NE",NE,2016,16749,16226,523,3.1,72
"Adams County, NE",NE,2015,16677,16157,520,3.1,-51
"Adams County, NE",NE,2014,16728,16167,561,3.4,-178
"Adams County, NE",NE,2013,16906,16305,601,3.6,55
"Adams County, NE",NE,2012,16851,16225,626,3.7,358
"Adams County, NE",NE,2011,16493,15781,712,4.3,21
"Adams County, NE",NE,2010,16472,15677,795,4.8,0
"Adams County, OH",OH,2021,10967,10275,692,6.3,107
"Adams County, OH",OH,2020,10860,9850,1010,9.3,-24
"Adams County, OH",OH,2019,10884,10136,748,6.9,-66
"Adams County, OH",OH,2018,10950,10180,770,7.0,-10
"Adams County, OH",OH,2017,10960,10175,785,7.2,-27
"Adams County, OH",OH,2016,10987,10156,831,7.6,265
"Adams County, OH",OH,2015,10722,9870,852,7.9,180
"Adams County, OH",OH,2014,10542,9574,968,9.2,-142
"Adams County, OH",OH,2013,10684,9329,1355,12.7,-89
"Adams County, OH",OH,2012,10773,9421,1352,12.5,-716
"Adams County, OH",OH,2011,11489,9845,1644,14.3,-410
"Adams County, OH",OH,2010,11899,9998,1901,16.0,0
"Adams County, PA",PA,2021,54462,52066,2396,4.4,-143
"Adams County, PA",PA,2020,54605,50835,3770,6.9,-1360
"Adams County, PA",PA,2019,55965,54078,1887,3.4,225
"Adams County, PA",PA,2018,55740,53838,1902,3.4,-138
"Adams County, PA",PA,2017,55878,53794,2084,3.7,406
"Adams County, PA",PA,2016,55472,53294,2178,3.9,492
"Adams County, PA",PA,2015,54980,52627,2353,4.3,-76
"Adams County, PA",PA,2014,55056,52499,2557,4.6,-159
"Adams County, PA",PA,2013,55215,52086,3129,5.7,564
"Adams County, PA",PA,2012,54651,51235,3416,6.3,669
"Adams County, PA",PA,2011,53982,50453,3529,6.5,-451
"Adams County, PA",PA,2010,54433,50354,4079,7.5,0
"Adams County, WA",WA,2021,9611,9080,531,5.5,344
"Adams County, WA",WA,2020,9267,8599,668,7.2,-718
"Adams County, WA",WA,2019,9985,9411,574,5.7,552
"Adams County, WA",WA,2018,9433,8924,509,5.4,501
"Adams County, WA",WA,2017,8932,8428,504,5.6,215
"Adams County, WA",WA,2016,8717,8166,551,6.3,100
"Adams County, WA",WA,2015,8617,8038,579,6.7,80
"Adams County, WA",WA,2014,8537,7944,593,6.9,171
"Adams County, WA",WA,2013,8366,7680,686,8.2,171
"Adams County, WA",WA,2012,8195,7512,683,8.3,22
"Adams County, WA",WA,2011,8173,7431,742,9.1,-92
"Adams County, WA",WA,2010,8265,7480,785,9.5,0
"Adams County, WI",WI,2021,8020,7524,496,6.2,-118
"Adams County, WI",WI,2020,8138,7354,784,9.6,-48
"Adams County, WI",WI,2019,8186,7790,396,4.8,-19
"Adams County, WI",WI,2018,8205,7821,384,4.7,-53
"Adams County, WI",WI,2017,8258,7842,416,5.0,3
"Adams County, WI",WI,2016,8255,7770,485,5.9,-47
"Adams County, WI",WI,2015,8302,7713,589,7.1,-81
"Adams County, WI",WI,2014,8383,7652,731,8.7,-338
"Adams County, WI",WI,2013,8721,7779,942,10.8,-246
"Adams County, WI",WI,2012,8967,8002,965,10.8,-62
"Adams County, WI",WI,2011,9029,7990,1039,11.5,-106
"Adams County, WI",WI,2010,9135,8022,1113,12.2,0
"Addison County, VT",VT,2021,19901,19352,549,2.8,-630
"Addison County, VT",VT,2020,20531,19588,943,4.6,-819
"Addison County, VT",VT,2019,21350,20861,489,2.3,-42
"Addison County, VT",VT,2018,21392,20854,538,2.5,44
"Addison County, VT",VT,2017,21348,20746,602,2.8,423
"Addison County, VT",VT,2016,20925,20323,602,2.9,124
"Addison County, VT",VT,2015,20801,20088,713,3.4,-113
"Addison County, VT",VT,2014,20914,20128,786,3.8,144
"Addison County, VT",VT,2013,20770,19911,859,4.1,-45
"Addison County, VT",VT,2012,20815,19903,912,4.4,-257
"Addison County, VT",VT,2011,21072,20017,1055,5.0,-185
"Addison County, VT",VT,2010,21257,19973,1284,6.0,0
"Adjuntas Municipio, PR",PR,2021,4475,3967,508,11.4,
"Adjuntas Municipio, PR",PR,2020,N.A.,N.A.,N.A.,N.A.,
"Adjuntas Municipio, PR",PR,2019,4182,3545,637,15.2,146
"Adjuntas Municipio, PR",PR,2018,4036,3484,552,13.7,-332
"Adjuntas Municipio, PR",PR,2017,4368,3710,658,15.1,-102
"Adjuntas Municipio, PR",PR,2016,4470,3717,753,16.8,85
"Adjuntas Municipio, PR",PR,2015,4385,3608,777,17.7,-106
"Adjuntas Municipio, PR",PR,2014,4491,3505,986,22.0,-323
"Adjuntas Municipio, PR",PR,2013,4814,3702,1112,23.1,-162
"Adjuntas Municipio, PR",PR,2012,4976,3898,1078,21.7,-108
"Adjuntas Municipio, PR",PR,2011,5084,4009,1075,21.1,-101
"Adjuntas Municipio, PR",PR,2010,5185,4169,1016,19.6,0
"Aguada Municipio, PR",PR,2021,12927,11801,1126,8.7,
"Aguada Municipio, PR",PR,2020,N.A.,N.A.,N.A.,N.A.,
"Aguada Municipio, PR",PR,2019,11947,10744,1203,10.1,99
"Aguada Municipio, PR",PR,2018,11848,10534,1314,11.1,-20
"Aguada Municipio, PR",PR,2017,11868,10334,1534,12.9,-39
"Aguada Municipio, PR",PR,2016,11907,10245,1662,14.0,81
"Aguada Municipio, PR",PR,2015,11826,10172,1654,14.0,-164
"Aguada Municipio, PR",PR,2014,11990,9927,2063,17.2,-365
"Aguada Municipio, PR",PR,2013,12355,10071,2284,18.5,-361
"Aguada Municipio, PR",PR,2012,12716,10387,2329,18.3,-402
"Aguada Municipio, PR",PR,2011,13118,10516,2602,19.8,-377
"Aguada Municipio, PR",PR,2010,13495,10869,2626,19.5,0
"Aguadilla Municipio, PR",PR,2021,15629,14194,1435,9.2,
"Aguadilla Municipio, PR",PR,2020,N.A.,N.A.,N.A.,N.A.,
"Aguadilla Municipio, PR",PR,2019,14494,13004,1490,10.3,-169
"Aguadilla Municipio, PR",PR,2018,14663,12846,1817,12.4,-228
"Aguadilla Municipio, PR",PR,2017,14891,12732,2159,14.5,-15
"Aguadilla Municipio, PR",PR,2016,14906,12689,2217,14.9,138
"Aguadilla Municipio, PR",PR,2015,14768,12694,2074,14.0,-165
"Aguadilla Municipio, PR",PR,2014,14933,12472,2461,16.5,-449
"Aguadilla Municipio, PR",PR,2013,15382,12693,2689,17.5,-773
"Aguadilla Municipio, PR",PR,2012,16155,13142,3013,18.7,-524
"Aguadilla Municipio, PR",PR,2011,16679,13369,3310,19.8,-740
"Aguadilla Municipio, PR",PR,2010,17419,13863,3556,20.4,0
"Aguas Buenas Municipio, PR",PR,2021,6988,6347,641,9.2,
"Aguas Buenas Municipio, PR",PR,2020,N.A.,N.A.,N.A.,N.A.,
"Aguas Buenas Municipio, PR",PR,2019,6518,5918,600,9.2,33
"Aguas Buenas Municipio, PR",PR,2018,6485,5832,653,10.1,-131
"Aguas Buenas Municipio, PR",PR,2017,6616,5789,827,12.5,-171
"Aguas Buenas Municipio, PR",PR,2016,6787,5814,973,14.3,-41
"Aguas Buenas Municipio, PR",PR,2015,6828,5830,998,14.6,-93
"Aguas Buenas Municipio, PR",PR,2014,6921,5778,1143,16.5,-196
"Aguas Buenas Municipio, PR",PR,2013,7117,5921,1196,16.8,-246
"Aguas Buenas Municipio, PR",PR,2012,7363,5995,1368,18.6,-206
"Aguas Buenas Municipio, PR",PR,2011,7569,5990,1579,20.9,-400
"Aguas Buenas Municipio, PR",PR,2010,7969,6202,1767,22.2,0
"Aibonito Municipio, PR",PR,2021,6712,6149,563,8.4,
"Aibonito Municipio, PR",PR,2020,N.A.,N.A.,N.A.,N.A.,
"Aibonito Municipio, PR",PR,2019,6469,5793,676,10.4,35
"Aibonito Municipio, PR",PR,2018,6434,5667,767,11.9,-141
"Aibonito Municipio, PR",PR,2017,6575,5643,932,14.2,-98
"Aibonito Municipio, PR",PR,2016,6673,5680,993,14.9,25
"Aibonito Municipio, PR",PR,2015,6648,5678,970,14.6,-191
"Aibonito Municipio, PR",PR,2014,6839,5641,1198,17.5,-173
"Aibonito Municipio, PR",PR,2013,7012,5816,1196,17.1,-220
"Aibonito Municipio, PR",PR,2012,7232,5856,1376,19.0,-113
"Aibonito Municipio, PR",PR,2011,7345,5879,1466,20.0,-202
"Aibonito Municipio, PR",PR,2010,7547,6080,1467,19.4,0
"Aiken County, SC",SC,2021,74070,71580,2490,3.4,429
"Aiken County, SC",SC,2020,73641,70057,3584,4.9,209
"Aiken County, SC",SC,2019,73432,71349,2083,2.8,1033
"Aiken County, SC",SC,2018,72399,70013,2386,3.3,-90
"Aiken County, SC",SC,2017,72489,69563,2926,4.0,-1418
"Aiken County, SC",SC,2016,73907,70293,3614,4.9,27
"Aiken County, SC",SC,2015,73880,69572,4308,5.8,926
"Aiken County, SC",SC,2014,72954,68338,4616,6.3,65
"Aiken County, SC",SC,2013,72889,67531,5358,7.4,-188
"Aiken County, SC",SC,2012,73077,66929,6148,8.4,-558
"Aiken County, SC",SC,2011,73635,66901,6734,9.1,665
"Aiken County, SC",SC,2010,72970,66098,6872,9.4,0
"Aitkin County, MN",MN,2021,7244,6904,340,4.7,-277
"Aitkin County, MN",MN,2020,7521,6889,632,8.4,146
"Aitkin County, MN",MN,2019,7375,6892,483,6.5,145
"Aitkin County, MN",MN,2018,7230,6797,433,6.0,20
"Aitkin County, MN",MN,2017,7210,6757,453,6.3,186
"Aitkin County, MN",MN,2016,7024,6531,493,7.0,131
"Aitkin County, MN",MN,2015,6893,6432,461,6.7,101
"Aitkin County, MN",MN,2014,6792,6328,464,6.8,-20
"Aitkin County, MN",MN,2013,6812,6297,515,7.6,-101
"Aitkin County, MN",MN,2012,6913,6350,563,8.1,-215
"Aitkin County, MN",MN,2011,7128,6443,685,9.6,-187
"Aitkin County, MN",MN,2010,7315,6553,762,10.4,0
"Alachua County, FL",FL,2021,138458,133316,5142,3.7,3972
"Alachua County, FL",FL,2020,134486,126648,7838,5.8,-3302
"Alachua County, FL",FL,2019,137788,133643,4145,3.0,1526
"Alachua County, FL",FL,2018,136262,131666,4596,3.4,1914
"Alachua County, FL",FL,2017,134348,129134,5214,3.9,1293
"Alachua County, FL",FL,2016,133055,127302,5753,4.3,3062
"Alachua County, FL",FL,2015,129993,123941,6052,4.7,692
"Alachua County, FL",FL,2014,129301,122367,6934,5.4,294
"Alachua County, FL",FL,2013,129007,121314,7693,6.0,-72
"Alachua County, FL",FL,2012,129079,120238,8841,6.8,797
"Alachua County, FL",FL,2011,128282,118574,9708,7.6,898
"Alachua County, FL",FL,2010,127384,117504,9880,7.8,0
"Alamance County, NC",NC,2021,81009,77122,3887,4.8,2088
"Alamance County, NC",NC,2020,78921,73409,5512,7.0,-2798
"Alamance County, NC",NC,2019,81719,78642,3077,3.8,1999
"Alamance County, NC",NC,2018,79720,76663,3057,3.8,910
"Alamance County, NC",NC,2017,78810,75458,3352,4.3,116
"Alamance County, NC",NC,2016,78694,74964,3730,4.7,1488
"Alamance County, NC",NC,2015,77206,73126,4080,5.3,380
"Alamance County, NC",NC,2014,76826,72595,4231,5.5,-572
"Alamance County, NC",NC,2013,77398,71939,5459,7.1,-1243
"Alamance County, NC",NC,2012,78641,71776,6865,8.7,981
"Alamance County, NC",NC,2011,77660,70181,7479,9.6,577
"Alamance County, NC",NC,2010,77083,68786,8297,10.8,0
"Alameda County, CA",CA,2021,809964,760859,49105,6.1,-6865
"Alameda County, CA",CA,2020,816829,743193,73636,9.0,-25816
"Alameda County, CA",CA,2019,842645,817355,25290,3.0,1210
"Alameda County, CA",CA,2018,841435,815554,25881,3.1,3260
"Alameda County, CA",CA,2017,838175,807100,31075,3.7,6348
"Alameda County, CA",CA,2016,831827,796037,35790,4.3,12819
"Alameda County, CA",CA,2015,819008,779897,39111,4.8,12682
"Alameda County, CA",CA,2014,806326,758819,47507,5.9,6479
"Alameda County, CA",CA,2013,799847,741222,58625,7.3,3391
"Alameda County, CA",CA,2012,796456,726131,70325,8.8,11332
"Alameda County, CA",CA,2011,785124,704596,80528,10.3,2444
"Alameda County, CA",CA,2010,782680,695343,87337,11.2,0
"Alamosa County, CO",CO,2021,8533,8062,471,5.5,221
"Alamosa County, CO",CO,2020,8312,7809,503,6.1,-106
"Alamosa County, CO",CO,2019,8418,8138,280,3.3,-59
"Alamosa County, CO",CO,2018,8477,8161,316,3.7,410
"Alamosa County, CO",CO,2017,8067,7810,257,3.2,103
"Alamosa County, CO",CO,2016,7964,7657,307,3.9,316
"Alamosa County, CO",CO,2015,7648,7267,381,5.0,139
"Alamosa County, CO",CO,2014,7509,6970,539,7.2,-46
"Alamosa County, CO",CO,2013,7555,6832,723,9.6,-182
"Alamosa County, CO",CO,2012,7737,6915,822,10.6,61
"Alamosa County, CO",CO,2011,7676,6904,772,10.1,-5
"Alamosa County, CO",CO,2010,7681,6955,726,9.5,0
"Albany County, NY",NY,2021,156527,149645,6882,4.4,-2537
"Albany County, NY",NY,2020,159064,148104,10960,6.9,-2001
"Albany County, NY",NY,2019,161065,155432,5633,3.5,154
"Albany County, NY",NY,2018,160911,154984,5927,3.7,-182
"Albany County, NY",NY,2017,161093,154316,6777,4.2,2567
"Albany County, NY",NY,2016,158526,151974,6552,4.1,329
"Albany County, NY",NY,2015,158197,151269,6928,4.4,1148
"Albany County, NY",NY,2014,157049,149307,7742,4.9,-3525
"Albany County, NY",NY,2013,160574,150583,9991,6.2,173
"Albany County, NY",NY,2012,160401,148855,11546,7.2,1895
"Albany County, NY",NY,2011,158506,147443,11063,7.0,-3120
"Albany County, NY",NY,2010,161626,150137,11489,7.1,0
"Albany County, WY",WY,2021,20767,20086,681,3.3,195
"Albany County, WY",WY,2020,20572,19810,762,3.7,61
"Albany County, WY",WY,2019,20511,19862,649,3.2,61
"Albany County, WY",WY,2018,20450,19773,677,3.3,-70
"Albany County, WY",WY,2017,20520,19914,606,3.0,-455
"Albany County, WY",WY,2016,20975,20299,676,3.2,504
"Albany County, WY",WY,2015,20471,19836,635,3.1,220
"Albany County, WY",WY,2014,20251,19516,735,3.6,-141
"Albany County, WY",WY,2013,20392,19620,772,3.8,-101
"Albany County, WY",WY,2012,20493,19586,907,4.4,-1043
"Albany County, WY",WY,2011,21536,20574,962,4.5,288
"Albany County, WY",WY,2010,21248,20224,1024,4.8,0
"Albemarle County, VA",VA,2021,55448,53650,1798,3.2,-1037
"Albemarle County, VA",VA,2020,56485,53473,3012,5.3,-2204
"Albemarle County, VA",VA,2019,58689,57256,1433,2.4,1918
"Albemarle County, VA",VA,2018,56771,55264,1507,2.7,894
"Albemarle County, VA",VA,2017,55877,54055,1822,3.3,1343
"Albemarle County, VA",VA,2016,54534,52631,1903,3.5,398
"Albemarle County, VA",VA,2015,54136,52053,2083,3.8,348
"Albemarle County, VA",VA,2014,53788,51417,2371,4.4,1234
"Albemarle County, VA",VA,2013,52554,50068,2486,4.7,-17
"Albemarle County, VA",VA,2012,52571,49877,2694,5.1,491
"Albemarle County, VA",VA,2011,52080,49185,2895,5.6,1037
"Albemarle County, VA",VA,2010,51043,47912,3131,6.1,0
"Alcona County, MI",MI,2021,3725,3462,263,7.1,-116
"Alcona County, MI",MI,2020,3841,3440,401,10.4,-52
"Alcona County, MI",MI,2019,3893,3643,250,6.4,77
"Alcona County, MI",MI,2018,3816,3564,252,6.6,-24
"Alcona County, MI",MI,2017,3840,3569,271,7.1,1
"Alcona County, MI",MI,2016,3839,3543,296,7.7,13
"Alcona County, MI",MI,2015,3826,3515,311,8.1,-10
"Alcona County, MI",MI,2014,3836,3428,408,10.6,28
"Alcona County, MI",MI,2013,3808,3304,504,13.2,84
"Alcona County, MI",MI,2012,3724,3257,467,12.5,-67
"Alcona County, MI",MI,2011,3791,3269,522,13.8,-45
"Alcona County, MI",MI,2010,3836,3171,665,17.3,0
"Alcorn County, MS",MS,2021,15128,14407,721,4.8,11
"Alcorn County, MS",MS,2020,15117,14189,928,6.1,-1048
"Alcorn County, MS",MS,2019,16165,15399,766,4.7,73
"Alcorn County, MS",MS,2018,16092,15407,685,4.3,94
"Alcorn County, MS",MS,2017,15998,15271,727,4.5,251
"Alcorn County, MS",MS,2016,15747,14911,836,5.3,76
"Alcorn County, MS",MS,2015,15671,14777,894,5.7,588
"Alcorn County, MS",MS,2014,15083,14071,1012,6.7,-304
"Alcorn County, MS",MS,2013,15387,14198,1189,7.7,-782
"Alcorn County, MS",MS,2012,16169,14789,1380,8.5,-58
"Alcorn County, MS",MS,2011,16227,14506,1721,10.6,482
"Alcorn County, MS",MS,2010,15745,13978,1767,11.2,0
"Aleutians East Borough, AK",AK,2021,2558,2499,59,2.3,43
"Aleutians East Borough, AK",AK,2020,2515,2411,104,4.1,-37
"Aleutians East Borough, AK",AK,2019,2552,2493,59,2.3,236
"Aleutians East Borough, AK",AK,2018,2316,2251,65,2.8,-228
"Aleutians East Borough, AK",AK,2017,2544,2485,59,2.3,-45
"Aleutians East Borough, AK",AK,2016,2589,2523,66,2.5,117
"Aleutians East Borough, AK",AK,2015,2472,2395,77,3.1,253
"Aleutians East Borough, AK",AK,2014,2219,2121,98,4.4,12
"Aleutians East Borough, AK",AK,2013,2207,2073,134,6.1,77
"Aleutians East Borough, AK",AK,2012,2130,1983,147,6.9,-44
"Aleutians East Borough, AK",AK,2011,2174,2036,138,6.3,146
"Aleutians East Borough, AK",AK,2010,2028,1910,118,5.8,0
"Aleutians West Census Area, AK",AK,2021,3625,3494,131,3.6,-210
"Aleutians West Census Area, AK",AK,2020,3835,3655,180,4.7,190
"Aleutians West Census Area, AK",AK,2019,3645,3531,114,3.1,6
"Aleutians West Census Area, AK",AK,2018,3639,3523,116,3.2,-106
"Aleutians West Census Area, AK",AK,2017,3745,3616,129,3.4,-237
"Aleutians West Census Area, AK",AK,2016,3982,3856,126,3.2,-78
"Aleutians West Census Area, AK",AK,2015,4060,3908,152,3.7,-404
"Aleutians West Census Area, AK",AK,2014,4464,4253,211,4.7,212
"Aleutians West Census Area, AK",AK,2013,4252,3957,295,6.9,0
"Aleutians West Census Area, AK",AK,2012,4252,3953,299,7.0,14
"Aleutians West Census Area, AK",AK,2011,4238,3985,253,6.0,289
"Aleutians West Census Area, AK",AK,2010,3949,3742,207,5.2,0
"Alexander County, IL",IL,2021,1831,1682,149,8.1,-3
"Alexander County, IL",IL,2020,1834,1644,190,10.4,-113
"Alexander County, IL",IL,2019,1947,1828,119,6.1,-127
"Alexander County, IL",IL,2018,2074,1905,169,8.1,-62
"Alexander County, IL",IL,2017,2136,1957,179,8.4,-79
"Alexander County, IL",IL,2016,2215,2008,207,9.3,-82
"Alexander County, IL",IL,2015,2297,2086,211,9.2,-259
"Alexander County, IL",IL,2014,2556,2281,275,10.8,-131
"Alexander County, IL",IL,2013,2687,2348,339,12.6,-61
"Alexander County, IL",IL,2012,2748,2418,330,12.0,-141
"Alexander County, IL",IL,2011,2889,2516,373,12.9,-78
"Alexander County, IL",IL,2010,2967,2615,352,11.9,0
"Alexander County, NC",NC,2021,17283,16553,730,4.2,156
"Alexander County, NC",NC,2020,17127,15874,1253,7.3,-685
"Alexander County, NC",NC,2019,17812,17231,581,3.3,120
"Alexander County, NC",NC,2018,17692,17121,571,3.2,-26
"Alexander County, NC",NC,2017,17718,17073,645,3.6,-60
"Alexander County, NC",NC,2016,17778,17022,756,4.3,255
"Alexander County, NC",NC,2015,17523,16671,852,4.9,52
"Alexander County, NC",NC,2014,17471,16518,953,5.5,-42
"Alexander County, NC",NC,2013,17513,16189,1324,7.6,-313
"Alexander County, NC",NC,2012,17826,16078,1748,9.8,-163
"Alexander County, NC",NC,2011,17989,15961,2028,11.3,-333
"Alexander County, NC",NC,2010,18322,15955,2367,12.9,0
"Alexandria city, VA",VA,2021,97365,93692,3673,3.8,-2017
"Alexandria city, VA",VA,2020,99382,93425,5957,6.0,-2784
"Alexandria city, VA",VA,2019,102166,100011,2155,2.1,1164
"Alexandria city, VA",VA,2018,101002,98733,2269,2.2,723
"Alexandria city, VA",VA,2017,100279,97446,2833,2.8,3743
"Alexandria city, VA",VA,2016,96536,93776,2760,2.9,1985
"Alexandria city, VA",VA,2015,94551,91485,3066,3.2,658
"Alexandria city, VA",VA,2014,93893,90355,3538,3.8,151
"Alexandria city, VA",VA,2013,93742,90037,3705,4.0,586
"Alexandria city, VA",VA,2012,93156,89424,3732,4.0,790
"Alexandria city, VA",VA,2011,92366,88257,4109,4.4,1930
"Alexandria city, VA",VA,2010,90436,85872,4564,5.0,0
"Alfalfa County, OK",OK,2021,2683,2620,63,2.3,-63
"Alfalfa County, OK",OK,2020,2746,2645,101,3.7,-41
"Alfalfa County, OK",OK,2019,2787,2733,54,1.9,-102
"Alfalfa County, OK",OK,2018,2889,2829,60,2.1,-58
"Alfalfa County, OK",OK,2017,2947,2873,74,2.5,-18
"Alfalfa County, OK",OK,2016,2965,2870,95,3.2,-197
"Alfalfa County, OK",OK,2015,3162,3071,91,2.9,70
"Alfalfa County, OK",OK,2014,3092,3018,74,2.4,159
"Alfalfa County, OK",OK,2013,2933,2840,93,3.2,25
"Alfalfa County, OK",OK,2012,2908,2827,81,2.8,356
"Alfalfa County, OK",OK,2011,2552,2453,99,3.9,57
"Alfalfa County, OK",OK,2010,2495,2378,117,4.7,0
"Alger County, MI",MI,2021,3089,2841,248,8.0,-31
"Alger County, MI",MI,2020,3120,2768,352,11.3,-70
"Alger County, MI",MI,2019,3190,2937,253,7.9,-25
"Alger County, MI",MI,2018,3215,2959,256,8.0,-76
"Alger County, MI",MI,2017,3291,3021,270,8.2,17
"Alger County, MI",MI,2016,3274,3002,272,8.3,28
"Alger County, MI",MI,2015,3246,2966,280,8.6,-78
"Alger County, MI",MI,2014,3324,2977,347,10.4,-62
"Alger County, MI",MI,2013,3386,2993,393,11.6,-60
"Alger County, MI",MI,2012,3446,3040,406,11.8,-17
"Alger County, MI",MI,2011,3463,3042,421,12.2,-93
"Alger County, MI",MI,2010,3556,3068,488,13.7,0
"Allamakee County, IA",IA,2021,7039,6718,321,4.6,-59
"Allamakee County, IA",IA,2020,7098,6746,352,5.0,-422
"Allamakee County, IA",IA,2019,7520,7269,251,3.3,40
"Allamakee County, IA",IA,2018,7480,7251,229,3.1,-106
"Allamakee County, IA",IA,2017,7586,7288,298,3.9,-122
"Allamakee County, IA",IA,2016,7708,7329,379,4.9,11
"Allamakee County, IA",IA,2015,7697,7325,372,4.8,-6
"Allamakee County, IA",IA,2014,7703,7270,433,5.6,41
"Allamakee County, IA",IA,2013,7662,7177,485,6.3,36
"Allamakee County, IA",IA,2012,7626,7133,493,6.5,-155
"Allamakee County, IA",IA,2011,7781,7213,568,7.3,-118
"Allamakee County, IA",IA,2010,7899,7270,629,8.0,0
"Allegan County, MI",MI,2021,60557,57735,2822,4.7,-1423
"Allegan County, MI",MI,2020,61980,57267,4713,7.6,-508
"Allegan County, MI",MI,2019,62488,60494,1994,3.2,456
"Allegan County, MI",MI,2018,62032,59982,2050,3.3,794
"Allegan County, MI",MI,2017,61238,58962,2276,3.7,-209
"Allegan County, MI",MI,2016,61447,59033,2414,3.9,692
"Allegan County, MI",MI,2015,60755,58207,2548,4.2,896
"Allegan County, MI",MI,2014,59859,56610,3249,5.4,1688
"Allegan County, MI",MI,2013,58171,54330,3841,6.6,1288
"Allegan County, MI",MI,2012,56883,52752,4131,7.3,160
"Allegan County, MI",MI,2011,56723,51967,4756,8.4,233
"Allegan County, MI",MI,2010,56490,50270,6220,11.0,0
"Allegany County, MD",MD,2021,30504,28538,1966,6.4,-878
"Allegany County, MD",MD,2020,31382,28925,2457,7.8,-1427
"Allegany County, MD",MD,2019,32809,31166,1643,5.0,270
"Allegany County, MD",MD,2018,32539,30875,1664,5.1,-104
"Allegany County, MD",MD,2017,32643,30836,1807,5.5,278
"Allegany County, MD",MD,2016,32365,30416,1949,6.0,105
"Allegany County, MD",MD,2015,32260,30051,2209,6.8,-992
"Allegany County, MD",MD,2014,33252,30763,2489,7.5,-362
"Allegany County, MD",MD,2013,33614,30785,2829,8.4,-236
"Allegany County, MD",MD,2012,33850,30875,2975,8.8,-252
"Allegany County, MD",MD,2011,34102,30990,3112,9.1,-375
"Allegany County, MD",MD,2010,34477,31189,3288,9.5,0
"Allegany County, NY",NY,2021,19042,18098,944,5.0,-346
"Allegany County, NY",NY,2020,19388,17886,1502,7.7,-310
"Allegany County, NY",NY,2019,19698,18658,1040,5.3,-198
"Allegany County, NY",NY,2018,19896,18789,1107,5.6,-164
"Allegany County, NY",NY,2017,20060,18740,1320,6.6,-10
"Allegany County, NY",NY,2016,20070,18781,1289,6.4,-239
"Allegany County, NY",NY,2015,20309,18979,1330,6.5,-2983
"Allegany County, NY",NY,2014,23292,21833,1459,6.3,-481
"Allegany County, NY",NY,2013,23773,21945,1828,7.7,115
"Allegany County, NY",NY,2012,23658,21638,2020,8.5,-34
"Allegany County, NY",NY,2011,23692,21561,2131,9.0,-578
"Allegany County, NY",NY,2010,24270,22004,2266,9.3,0
"Alleghany County, NC",NC,2021,4224,4029,195,4.6,119
"Alleghany County, NC",NC,2020,4105,3814,291,7.1,-246
"Alleghany County, NC",NC,2019,4351,4149,202,4.6,98
"Alleghany County, NC",NC,2018,4253,4058,195,4.6,-48
"Alleghany County, NC",NC,2017,4301,4083,218,5.1,-112
"Alleghany County, NC",NC,2016,4413,4170,243,5.5,-49
"Alleghany County, NC",NC,2015,4462,4191,271,6.1,72
"Alleghany County, NC",NC,2014,4390,4099,291,6.6,-35
"Alleghany County, NC",NC,2013,4425,4047,378,8.5,-218
"Alleghany County, NC",NC,2012,4643,4148,495,10.7,-12
"Alleghany County, NC",NC,2011,4655,4086,569,12.2,-109
"Alleghany County, NC",NC,2010,4764,4199,565,11.9,0
"Alleghany County, VA",VA,2021,6512,6245,267,4.1,-298
"Alleghany County, VA",VA,2020,6810,6367,443,6.5,-248
"Alleghany County, VA",VA,2019,7058,6822,236,3.3,59
"Alleghany County, VA",VA,2018,6999,6742,257,3.7,-71
"Alleghany County, VA",VA,2017,7070,6749,321,4.5,129
"Alleghany County, VA",VA,2016,6941,6593,348,5.0,-134
"Alleghany County, VA",VA,2015,7075,6722,353,5.0,-146
"Alleghany County, VA",VA,2014,7221,6801,420,5.8,-294
"Alleghany County, VA",VA,2013,7515,7032,483,6.4,-273
"Alleghany County, VA",VA,2012,7788,7248,540,6.9,-105
"Alleghany County, VA",VA,2011,7893,7276,617,7.8,-71
"Alleghany County, VA",VA,2010,7964,7261,703,8.8,0
"Allegheny County, PA",PA,2021,630750,592281,38469,6.1,-13426
"Allegheny County, PA",PA,2020,644176,585953,58223,9.0,-12301
"Allegheny County, PA",PA,2019,656477,628729,27748,4.2,4863
"Allegheny County, PA",PA,2018,651614,624269,27345,4.2,-315
"Allegheny County, PA",PA,2017,651929,620570,31359,4.8,3440
"Allegheny County, PA",PA,2016,648489,615242,33247,5.1,756
"Allegheny County, PA",PA,2015,647733,615035,32698,5.0,1880
"Allegheny County, PA",PA,2014,645853,610848,35005,5.4,-3471
"Allegheny County, PA",PA,2013,649324,608249,41075,6.3,-2602
"Allegheny County, PA",PA,2012,651926,607613,44313,6.8,10100
"Allegheny County, PA",PA,2011,641826,597224,44602,6.9,7630
"Allegheny County, PA",PA,2010,634196,587632,46564,7.3,0
"Allen County, IN",IN,2021,184097,177326,6771,3.7,-1345
"Allen County, IN",IN,2020,185442,170981,14461,7.8,-2293
"Allen County, IN",IN,2019,187735,181889,5846,3.1,2866
"Allen County, IN",IN,2018,184869,179078,5791,3.1,3685
"Allen County, IN",IN,2017,181184,175203,5981,3.3,141
"Allen County, IN",IN,2016,181043,173422,7621,4.2,3039
"Allen County, IN",IN,2015,178004,169861,8143,4.6,2252
"Allen County, IN",IN,2014,175752,165714,10038,5.7,1294
"Allen County, IN",IN,2013,174458,161561,12897,7.4,477
"Allen County, IN",IN,2012,173981,159595,14386,8.3,-2637
"Allen County, IN",IN,2011,176618,160474,16144,9.1,596
"Allen County, IN",IN,2010,176022,157623,18399,10.5,0
"Allen County, KS",KS,2021,6524,6326,198,3.0,130
"Allen County, KS",KS,2020,6394,6061,333,5.2,-92
"Allen County, KS",KS,2019,6486,6260,226,3.5,119
"Allen County, KS",KS,2018,6367,6119,248,3.9,45
"Allen County, KS",KS,2017,6322,6017,305,4.8,-145
"Allen County, KS",KS,2016,6467,6108,359,5.6,-156
"Allen County, KS",KS,2015,6623,6284,339,5.1,-194
"Allen County, KS",KS,2014,6817,6473,344,5.0,-89
"Allen County, KS",KS,2013,6906,6486,420,6.1,18
"Allen County, KS",KS,2012,6888,6397,491,7.1,-174
"Allen County, KS",KS,2011,7062,6505,557,7.9,59
"Allen County, KS",KS,2010,7003,6434,569,8.1,0
"Allen County, KY",KY,2021,8894,8534,360,4.0,230
"Allen County, KY",KY,2020,8664,8200,464,5.4,-420
"Allen County, KY",KY,2019,9084,8725,359,4.0,170
"Allen County, KY",KY,2018,8914,8587,327,3.7,-66
"Allen County, KY",KY,2017,8980,8618,362,4.0,127
"Allen County, KY",KY,2016,8853,8477,376,4.2,185
"Allen County, KY",KY,2015,8668,8250,418,4.8,-2
"Allen County, KY",KY,2014,8670,8160,510,5.9,-283
"Allen County, KY",KY,2013,8953,8292,661,7.4,-75
"Allen County, KY",KY,2012,9028,8302,726,8.0,-105
"Allen County, KY",KY,2011,9133,8238,895,9.8,-42
"Allen County, KY",KY,2010,9175,8089,1086,11.8,0
"Allen County, OH",OH,2021,47538,44818,2720,5.7,-248
"Allen County, OH",OH,2020,47786,43690,4096,8.6,-454
"Allen County, OH",OH,2019,48240,46274,1966,4.1,111
"Allen County, OH",OH,2018,48129,45984,2145,4.5,-747
"Allen County, OH",OH,2017,48876,46443,2433,5.0,426
"Allen County, OH",OH,2016,48450,46006,2444,5.0,451
"Allen County, OH",OH,2015,47999,45647,2352,4.9,-479
"Allen County, OH",OH,2014,48478,45671,2807,5.8,-959
"Allen County, OH",OH,2013,49437,45572,3865,7.8,-530
"Allen County, OH",OH,2012,49967,46117,3850,7.7,-845
"Allen County, OH",OH,2011,50812,45984,4828,9.5,-1273
"Allen County, OH",OH,2010,52085,46498,5587,10.7,0
"Allen Parish, LA",LA,2021,8137,7687,450,5.5,-255
"Allen Parish, LA",LA,2020,8392,7574,818,9.7,-445
"Allen Parish, LA",LA,2019,8837,8357,480,5.4,43
"Allen Parish, LA",LA,2018,8794,8301,493,5.6,-194
"Allen Parish, LA",LA,2017,8988,8515,473,5.3,78
"Allen Parish, LA",LA,2016,8910,8337,573,6.4,122
"Allen Parish, LA",LA,2015,8788,8181,607,6.9,-71
"Allen Parish, LA",LA,2014,8859,8234,625,7.1,116
"Allen Parish, LA",LA,2013,8743,8111,632,7.2,-393
"Allen Parish, LA",LA,2012,9136,8439,697,7.6,-106
"Allen Parish, LA",LA,2011,9242,8440,802,8.7,-138
"Allen Parish, LA",LA,2010,9380,8506,874,9.3,0
"Allendale County, SC",SC,2021,2445,2255,190,7.8,-102
"Allendale County, SC",SC,2020,2547,2310,237,9.3,-47
"Allendale County, SC",SC,2019,2594,2458,136,5.2,-108
"Allendale County, SC",SC,2018,2702,2550,152,5.6,56
"Allendale County, SC",SC,2017,2646,2466,180,6.8,-5
"Allendale County, SC",SC,2016,2651,2429,222,8.4,-95
"Allendale County, SC",SC,2015,2746,2438,308,11.2,-117
"Allendale County, SC",SC,2014,2863,2523,340,11.9,-233
"Allendale County, SC",SC,2013,3096,2672,424,13.7,-36
"Allendale County, SC",SC,2012,3132,2612,520,16.6,-158
"Allendale County, SC",SC,2011,3290,2693,597,18.1,-62
"Allendale County, SC",SC,2010,3352,2704,648,19.3,0
"Alpena County, MI",MI,2021,13183,12458,725,5.5,-28
"Alpena County, MI",MI,2020,13211,12143,1068,8.1,5
"Alpena County, MI",MI,2019,13206,12568,638,4.8,-153
"Alpena County, MI",MI,2018,13359,12670,689,5.2,-256
"Alpena County, MI",MI,2017,13615,12846,769,5.6,-74
"Alpena County, MI",MI,2016,13689,12867,822,6.0,3
"Alpena County, MI",MI,2015,13686,12820,866,6.3,115
"Alpena County, MI",MI,2014,13571,12483,1088,8.0,153
"Alpena County, MI",MI,2013,13418,12134,1284,9.6,-18
"Alpena County, MI",MI,2012,13436,12146,1290,9.6,-212
"Alpena County, MI",MI,2011,13648,12228,1420,10.4,-482
"Alpena County, MI",MI,2010,14130,12328,1802,12.8,0
"Alpine County, CA",CA,2021,519,477,42,8.1,6
"Alpine County, CA",CA,2020,513,453,60,11.7,-29
"Alpine County, CA",CA,2019,542,514,28,5.2,-5
"Alpine County, CA",CA,2018,547,522,25,4.6,-1
"Alpine County, CA",CA,2017,548,514,34,6.2,-6
"Alpine County, CA",CA,2016,554,518,36,6.5,5
"Alpine County, CA",CA,2015,549,508,41,7.5,40
"Alpine County, CA",CA,2014,509,467,42,8.3,-14
"Alpine County, CA",CA,2013,523,472,51,9.8,-20
"Alpine County, CA",CA,2012,543,482,61,11.2,-48
"Alpine County, CA",CA,2011,591,515,76,12.9,49
"Alpine County, CA",CA,2010,542,471,71,13.1,0
"Amador County, CA",CA,2021,14342,13345,997,7.0,-109
"Amador County, CA",CA,2020,14451,13084,1367,9.5,-377
"Amador County, CA",CA,2019,14828,14243,585,3.9,156
"Amador County, CA",CA,2018,14672,14066,606,4.1,-22
"Amador County, CA",CA,2017,14694,13958,736,5.0,169
"Amador County, CA",CA,2016,14525,13658,867,6.0,208
"Amador County, CA",CA,2015,14317,13366,951,6.6,-4
"Amador County, CA",CA,2014,14321,13118,1203,8.4,-79
"Amador County, CA",CA,2013,14400,12897,1503,10.4,-246
"Amador County, CA",CA,2012,14646,12822,1824,12.5,-429
"Amador County, CA",CA,2011,15075,12988,2087,13.8,-448
"Amador County, CA",CA,2010,15523,13291,2232,14.4,0
"Amelia County, VA",VA,2021,5984,5771,213,3.6,-148
"Amelia County, VA",VA,2020,6132,5777,355,5.8,-272
"Amelia County, VA",VA,2019,6404,6205,199,3.1,136
"Amelia County, VA",VA,2018,6268,6066,202,3.2,0
"Amelia County, VA",VA,2017,6268,6021,247,3.9,61
"Amelia County, VA",VA,2016,6207,5947,260,4.2,-8
"Amelia County, VA",VA,2015,6215,5941,274,4.4,-15
"Amelia County, VA",VA,2014,6230,5908,322,5.2,57
"Amelia County, VA",VA,2013,6173,5816,357,5.8,-35
"Amelia County, VA",VA,2012,6208,5811,397,6.4,-43
"Amelia County, VA",VA,2011,6251,5785,466,7.5,13
"Amelia County, VA",VA,2010,6238,5697,541,8.7,0
"Amherst County, VA",VA,2021,14340,13812,528,3.7,-423
"Amherst County, VA",VA,2020,14763,13944,819,5.5,-490
"Amherst County, VA",VA,2019,15253,14772,481,3.2,160
"Amherst County, VA",VA,2018,15093,14601,492,3.3,-53
"Amherst County, VA",VA,2017,15146,14533,613,4.0,136
"Amherst County, VA",VA,2016,15010,14364,646,4.3,-330
"Amherst County, VA",VA,2015,15340,14618,722,4.7,-342
"Amherst County, VA",VA,2014,15682,14847,835,5.3,-119
"Amherst County, VA",VA,2013,15801,14856,945,6.0,-242
"Amherst County, VA",VA,2012,16043,14990,1053,6.6,-110
"Amherst County, VA",VA,2011,16153,14983,1170,7.2,-219
"Amherst County, VA",VA,2010,16372,15022,1350,8.2,0
"Amite County, MS",MS,2021,4398,4079,319,7.3,23
"Amite County, MS",MS,2020,4375,4016,359,8.2,-63
"Amite County, MS",MS,2019,4438,4129,309,7.0,57
"Amite County, MS",MS,2018,4381,4103,278,6.3,-73
"Amite County, MS",MS,2017,4454,4144,310,7.0,-35
"Amite County, MS",MS,2016,4489,4153,336,7.5,-12
"Amite County, MS",MS,2015,4501,4156,345,7.7,66
"Amite County, MS",MS,2014,4435,4076,359,8.1,-117
"Amite County, MS",MS,2013,4552,4138,414,9.1,-260
"Amite County, MS",MS,2012,4812,4338,474,9.9,-191
"Amite County, MS",MS,2011,5003,4443,560,11.2,16
"Amite County, MS",MS,2010,4987,4408,579,11.6,0
"Anasco Municipio, PR",PR,2021,9704,8940,764,7.9,
"Anasco Municipio, PR",PR,2020,N.A.,N.A.,N.A.,N.A.,
"Anasco Municipio, PR",PR,2019,8885,8137,748,8.4,73
"Anasco Municipio, PR",PR,2018,8812,7966,846,9.6,-140
"Anasco Municipio, PR",PR,2017,8952,7831,1121,12.5,59
"Anasco Municipio, PR",PR,2016,8893,7749,1144,12.9,36
"Anasco Municipio, PR",PR,2015,8857,7702,1155,13.0,-102
"Anasco Municipio, PR",PR,2014,8959,7489,1470,16.4,-300
"Anasco Municipio, PR",PR,2013,9259,7554,1705,18.4,-96
"Anasco Municipio, PR",PR,2012,9355,7765,1590,17.0,-253
"Anasco Municipio, PR",PR,2011,9608,7828,1780,18.5,-389
"Anasco Municipio, PR",PR,2010,9997,8064,1933,19.3,0
"Anchorage Borough/municipality, AK",AK,2021,150276,141539,8737,5.8,3053
"Anchorage Borough/municipality, AK",AK,2020,147223,135682,11541,7.8,-1432
"Anchorage Borough/municipality, AK",AK,2019,148655,141968,6687,4.5,-2090
"Anchorage Borough/municipality, AK",AK,2018,150745,143226,7519,5.0,-3029
"Anchorage Borough/municipality, AK",AK,2017,153774,145406,8368,5.4,-1697
"Anchorage Borough/municipality, AK",AK,2016,155471,147254,8217,5.3,-1005
"Anchorage Borough/municipality, AK",AK,2015,156476,148856,7620,4.9,-1174
"Anchorage Borough/municipality, AK",AK,2014,157650,149591,8059,5.1,13
"Anchorage Borough/municipality, AK",AK,2013,157637,149423,8214,5.2,-111
"Anchorage Borough/municipality, AK",AK,2012,157748,149177,8571,5.4,-634
"Anchorage Borough/municipality, AK",AK,2011,158382,148731,9651,6.1,639
"Anchorage Borough/municipality, AK",AK,2010,157743,146993,10750,6.8,0
"Anderson County, KS",KS,2021,4655,4540,115,2.5,372
"Anderson County, KS",KS,2020,4283,4114,169,3.9,77
"Anderson County, KS",KS,2019,4206,4070,136,3.2,65
"Anderson County, KS",KS,2018,4141,4001,140,3.4,-37
"Anderson County, KS",KS,2017,4178,4015,163,3.9,-15
"Anderson County, KS",KS,2016,4193,4014,179,4.3,49
"Anderson County, KS",KS,2015,4144,3945,199,4.8,-49
"Anderson County, KS",KS,2014,4193,3978,215,5.1,-56
"Anderson County, KS",KS,2013,4249,4002,247,5.8,-67
"Anderson County, KS",KS,2012,4316,4035,281,6.5,-194
"Anderson County, KS",KS,2011,4510,4172,338,7.5,-62
"Anderson County, KS",KS,2010,4572,4224,348,7.6,0
"Anderson County, KY",KY,2021,11983,11508,475,4.0,218
"Anderson County, KY",KY,2020,11765,11073,692,5.9,-265
"Anderson County, KY",KY,2019,12030,11605,425,3.5,128
"Anderson County, KY",KY,2018,11902,11486,416,3.5,65
"Anderson County, KY",KY,2017,11837,11365,472,4.0,376
"Anderson County, KY",KY,2016,11461,11006,455,4.0,122
"Anderson County, KY",KY,2015,11339,10877,462,4.1,-93
"Anderson County, KY",KY,2014,11432,10839,593,5.2,-104
"Anderson County, KY",KY,2013,11536,10799,737,6.4,-7
"Anderson County, KY",KY,2012,11543,10743,800,6.9,-53
"Anderson County, KY",KY,2011,11596,10633,963,8.3,-41
"Anderson County, KY",KY,2010,11637,10509,1128,9.7,0
"Anderson County, SC",SC,2021,90029,86686,3343,3.7,1589
"Anderson County, SC",SC,2020,88440,83340,5100,5.8,-495
"Anderson County, SC",SC,2019,88935,86575,2360,2.7,841
"Anderson County, SC",SC,2018,88094,85287,2807,3.2,518
"Anderson County, SC",SC,2017,87576,84199,3377,3.9,-1067
"Anderson County, SC",SC,2016,88643,84665,3978,4.5,224
"Anderson County, SC",SC,2015,88419,83693,4726,5.3,1739
"Anderson County, SC",SC,2014,86680,81652,5028,5.8,598
"Anderson County, SC",SC,2013,86082,80126,5956,6.9,365
"Anderson County, SC",SC,2012,85717,78287,7430,8.7,-568
"Anderson County, SC",SC,2011,86285,77496,8789,10.2,293
"Anderson County, SC",SC,2010,85992,75908,10084,11.7,0
"Anderson County, TN",TN,2021,34816,33483,1333,3.8,488
"Anderson County, TN",TN,2020,34328,32035,2293,6.7,-475
"Anderson County, TN",TN,2019,34803,33563,1240,3.6,523
"Anderson County, TN",TN,2018,34280,32989,1291,3.8,364
"Anderson County, TN",TN,2017,33916,32580,1336,3.9,223
"Anderson County, TN",TN,2016,33693,32045,1648,4.9,342
"Anderson County, TN",TN,2015,33351,31423,1928,5.8,197
"Anderson County, TN",TN,2014,33154,30889,2265,6.8,-644
"Anderson County, TN",TN,2013,33798,31128,2670,7.9,-667
"Anderson County, TN",TN,2012,34465,31690,2775,8.1,-618
"Anderson County, TN",TN,2011,35083,31965,3118,8.9,133
"Anderson County, TN",TN,2010,34950,31642,3308,9.5,0
"Anderson County, TX",TX,2021,23234,22109,1125,4.8,365
"Anderson County, TX",TX,2020,22869,21569,1300,5.7,-319
"Anderson County, TX",TX,2019,23188,22508,680,2.9,19
"Anderson County, TX",TX,2018,23169,22444,725,3.1,84
"Anderson County, TX",TX,2017,23085,22238,847,3.7,-433
"Anderson County, TX",TX,2016,23518,22499,1019,4.3,665
"Anderson County, TX",TX,2015,22853,21948,905,4.0,1093
"Anderson County, TX",TX,2014,21760,20732,1028,4.7,-237
"Anderson County, TX",TX,2013,21997,20711,1286,5.8,-337
"Anderson County, TX",TX,2012,22334,20932,1402,6.3,156
"Anderson County, TX",TX,2011,22178,20506,1672,7.5,434
"Anderson County, TX",TX,2010,21744,19975,1769,8.1,0
"Andrew County, MO",MO,2021,9656,9364,292,3.0,-56
"Andrew County, MO",MO,2020,9712,9324,388,4.0,-119
"Andrew County, MO",MO,2019,9831,9574,257,2.6,129
"Andrew County, MO",MO,2018,9702,9450,252,2.6,-80
"Andrew County, MO",MO,2017,9782,9471,311,3.2,-239
"Andrew County, MO",MO,2016,10021,9649,372,3.7,161
"Andrew County, MO",MO,2015,9860,9442,418,4.2,44
"Andrew County, MO",MO,2014,9816,9308,508,5.2,-48
"Andrew County, MO",MO,2013,9864,9331,533,5.4,29
"Andrew County, MO",MO,2012,9835,9291,544,5.5,132
"Andrew County, MO",MO,2011,9703,9017,686,7.1,-154
"Andrew County, MO",MO,2010,9857,9046,811,8.2,0
"Andrews County, TX",TX,2021,8992,8465,527,5.9,-135
"Andrews County, TX",TX,2020,9127,8378,749,8.2,-667
"Andrews County, TX",TX,2019,9794,9570,224,2.3,473
"Andrews County, TX",TX,2018,9321,9095,226,2.4,387
"Andrews County, TX",TX,2017,8934,8656,278,3.1,241
"Andrews County, TX",TX,2016,8693,8282,411,4.7,-610
"Andrews County, TX",TX,2015,9303,8977,326,3.5,-209
"Andrews County, TX",TX,2014,9512,9223,289,3.0,360
"Andrews County, TX",TX,2013,9152,8800,352,3.8,628
"Andrews County, TX",TX,2012,8524,8186,338,4.0,740
"Andrews County, TX",TX,2011,7784,7382,402,5.2,654
"Andrews County, TX",TX,2010,7130,6687,443,6.2,0
"Androscoggin County, ME",ME,2021,54219,51576,2643,4.9,-68
"Androscoggin County, ME",ME,2020,54287,51543,2744,5.1,-1495
"Androscoggin County, ME",ME,2019,55782,54273,1509,2.7,-55
"Androscoggin County, ME",ME,2018,55837,54140,1697,3.0,-167
"Androscoggin County, ME",ME,2017,56004,54211,1793,3.2,522
"Androscoggin County, ME",ME,2016,55482,53500,1982,3.6,316
"Androscoggin County, ME",ME,2015,55166,52859,2307,4.2,-875
"Androscoggin County, ME",ME,2014,56041,53019,3022,5.4,-326
"Androscoggin County, ME",ME,2013,56367,52579,3788,6.7,136
"Androscoggin County, ME",ME,2012,56231,52037,4194,7.5,214
"Androscoggin County, ME",ME,2011,56017,51570,4447,7.9,-113
"Androscoggin County, ME",ME,2010,56130,51144,4986,8.9,0
"Angelina County, TX",TX,2021,35754,33431,2323,6.5,569
"Angelina County, TX",TX,2020,35185,32500,2685,7.6,-152
"Angelina County, TX",TX,2019,35337,33922,1415,4.0,-365
"Angelina County, TX",TX,2018,35702,34134,1568,4.4,-677
"Angelina County, TX",TX,2017,36379,34514,1865,5.1,-702
"Angelina County, TX",TX,2016,37081,34888,2193,5.9,-331
"Angelina County, TX",TX,2015,37412,35306,2106,5.6,-276
"Angelina County, TX",TX,2014,37688,35688,2000,5.3,-204
"Angelina County, TX",TX,2013,37892,35420,2472,6.5,114
"Angelina County, TX",TX,2012,37778,35187,2591,6.9,-325
"Angelina County, TX",TX,2011,38103,34997,3106,8.2,-16
"Angelina County, TX",TX,2010,38119,34858,3261,8.6,0
"Anne Arundel County, MD",MD,2021,312621,297777,14844,4.7,-4782
"Anne Arundel County, MD",MD,2020,317403,299113,18290,5.8,-9277
"Anne Arundel County, MD",MD,2019,326680,317125,9555,2.9,8709
"Anne Arundel County, MD",MD,2018,317971,308136,9835,3.1,4286
"Anne Arundel County, MD",MD,2017,313685,302969,10716,3.4,10451
"Anne Arundel County, MD",MD,2016,303234,292085,11149,3.7,2435
"Anne Arundel County, MD",MD,2015,300799,287823,12976,4.3,3396
"Anne Arundel County, MD",MD,2014,297403,282564,14839,5.0,869
"Anne Arundel County, MD",MD,2013,296534,279785,16749,5.6,2655
"Anne Arundel County, MD",MD,2012,293879,276469,17410,5.9,4473
"Anne Arundel County, MD",MD,2011,289406,270942,18464,6.4,2933
"Anne Arundel County, MD",MD,2010,286473,266214,20259,7.1,0
"Anoka County, MN",MN,2021,195027,188434,6593,3.4,-6012
"Anoka County, MN",MN,2020,201039,187963,13076,6.5,-75
"Anoka County, MN",MN,2019,201114,194536,6578,3.3,3520
"Anoka County, MN",MN,2018,197594,191702,5892,3.0,1391
"Anoka County, MN",MN,2017,196203,189568,6635,3.4,4416
"Anoka County, MN",MN,2016,191787,184641,7146,3.7,1489
"Anoka County, MN",MN,2015,190298,183267,7031,3.7,841
"Anoka County, MN",MN,2014,189457,181414,8043,4.2,886
"Anoka County, MN",MN,2013,188571,178948,9623,5.1,1095
"Anoka County, MN",MN,2012,187476,176355,11121,5.9,58
"Anoka County, MN",MN,2011,187418,174542,12876,6.9,-89
"Anoka County, MN",MN,2010,187507,172432,15075,8.0,0
"Anson County, NC",NC,2021,10111,9469,642,6.3,11
"Anson County, NC",NC,2020,10100,9351,749,7.4,-526
"Anson County, NC",NC,2019,10626,10192,434,4.1,355
"Anson County, NC",NC,2018,10271,9807,464,4.5,-106
"Anson County, NC",NC,2017,10377,9841,536,5.2,-250
"Anson County, NC",NC,2016,10627,10011,616,5.8,-190
"Anson County, NC",NC,2015,10817,10119,698,6.5,-101
"Anson County, NC",NC,2014,10918,10166,752,6.9,-16
"Anson County, NC",NC,2013,10934,9928,1006,9.2,-224
"Anson County, NC",NC,2012,11158,9910,1248,11.2,1
"Anson County, NC",NC,2011,11157,9787,1370,12.3,-60
"Anson County, NC",NC,2010,11217,9649,1568,14.0,0
"Antelope County, NE",NE,2021,3693,3632,61,1.7,-239
"Antelope County, NE",NE,2020,3932,3847,85,2.2,301
"Antelope County, NE",NE,2019,3631,3540,91,2.5,26
"Antelope County, NE",NE,2018,3605,3516,89,2.5,10
"Antelope County, NE",NE,2017,3595,3505,90,2.5,-18
"Antelope County, NE",NE,2016,3613,3519,94,2.6,3
"Antelope County, NE",NE,2015,3610,3517,93,2.6,16
"Antelope County, NE",NE,2014,3594,3497,97,2.7,-13
"Antelope County, NE",NE,2013,3607,3494,113,3.1,34
"Antelope County, NE",NE,2012,3573,3460,113,3.2,-26
"Antelope County, NE",NE,2011,3599,3468,131,3.6,77
"Antelope County, NE",NE,2010,3522,3393,129,3.7,0
"Antrim County, MI",MI,2021,9865,9172,693,7.0,-247
"Antrim County, MI",MI,2020,10112,9081,1031,10.2,-202
"Antrim County, MI",MI,2019,10314,9773,541,5.2,240
"Antrim County, MI",MI,2018,10074,9500,574,5.7,0
"Antrim County, MI",MI,2017,10074,9421,653,6.5,-24
"Antrim County, MI",MI,2016,10098,9378,720,7.1,57
"Antrim County, MI",MI,2015,10041,9282,759,7.6,-49
"Antrim County, MI",MI,2014,10090,9129,961,9.5,77
"Antrim County, MI",MI,2013,10013,8879,1134,11.3,-25
"Antrim County, MI",MI,2012,10038,8894,1144,11.4,-92
"Antrim County, MI",MI,2011,10130,8838,1292,12.8,-318
"Antrim County, MI",MI,2010,10448,8826,1622,15.5,0
"Apache County, AZ",AZ,2021,18700,16995,1705,9.1,-802
"Apache County, AZ",AZ,2020,19502,17058,2444,12.5,-311
"Apache County, AZ",AZ,2019,19813,17823,1990,10.0,-122
"Apache County, AZ",AZ,2018,19935,17963,1972,9.9,51
"Apache County, AZ",AZ,2017,19884,17808,2076,10.4,-534
"Apache County, AZ",AZ,2016,20418,18042,2376,11.6,-312
"Apache County, AZ",AZ,2015,20730,17966,2764,13.3,-615
"Apache County, AZ",AZ,2014,21345,17994,3351,15.7,-759
"Apache County, AZ",AZ,2013,22104,18009,4095,18.5,-897
"Apache County, AZ",AZ,2012,23001,18637,4364,19.0,-136
"Apache County, AZ",AZ,2011,23137,18893,4244,18.3,-338
"Apache County, AZ",AZ,2010,23475,19645,3830,16.3,0
"Appanoose County, IA",IA,2021,5961,5706,255,4.3,27
"Appanoose County, IA",IA,2020,5934,5625,309,5.2,-141
"Appanoose County, IA",IA,2019,6075,5869,206,3.4,103
"Appanoose County, IA",IA,2018,5972,5774,198,3.3,-120
"Appanoose County, IA",IA,2017,6092,5865,227,3.7,-98
"Appanoose County, IA",IA,2016,6190,5900,290,4.7,-30
"Appanoose County, IA",IA,2015,6220,5919,301,4.8,71
"Appanoose County, IA",IA,2014,6149,5799,350,5.7,214
"Appanoose County, IA",IA,2013,5935,5556,379,6.4,-78
"Appanoose County, IA",IA,2012,6013,5619,394,6.6,-67
"Appanoose County, IA",IA,2011,6080,5652,428,7.0,-109
"Appanoose County, IA",IA,2010,6189,5728,461,7.4,0
"Appling County, GA",GA,2021,9288,8956,332,3.6,91
"Appling County, GA",GA,2020,9197,8767,430,4.7,-88
"Appling County, GA",GA,2019,9285,8906,379,4.1,209
"Appling County, GA",GA,2018,9076,8679,397,4.4,-278
"Appling County, GA",GA,2017,9354,8837,517,5.5,163
"Appling County, GA",GA,2016,9191,8596,595,6.5,613
"Appling County, GA",GA,2015,8578,7940,638,7.4,-75
"Appling County, GA",GA,2014,8653,7886,767,8.9,-8
"Appling County, GA",GA,2013,8661,7736,925,10.7,-286
"Appling County, GA",GA,2012,8947,7959,988,11.0,93
"Appling County, GA",GA,2011,8854,7770,1084,12.2,83
"Appling County, GA",GA,2010,8771,7720,1051,12.0,0
"Appomattox County, VA",VA,2021,6915,6648,267,3.9,-206
"Appomattox County, VA",VA,2020,7121,6713,408,5.7,-189
"Appomattox County, VA",VA,2019,7310,7060,250,3.4,121
"Appomattox County, VA",VA,2018,7189,6929,260,3.6,38
"Appomattox County, VA",VA,2017,7151,6842,309,4.3,145
"Appomattox County, VA",VA,2016,7006,6684,322,4.6,-60
"Appomattox County, VA",VA,2015,7066,6725,341,4.8,-73
"Appomattox County, VA",VA,2014,7139,6739,400,5.6,-19
"Appomattox County, VA",VA,2013,7158,6707,451,6.3,-53
"Appomattox County, VA",VA,2012,7211,6684,527,7.3,-39
"Appomattox County, VA",VA,2011,7250,6675,575,7.9,-104
"Appomattox County, VA",VA,2010,7354,6707,647,8.8,0
"Aransas County, TX",TX,2021,9256,8584,672,7.3,153
"Aransas County, TX",TX,2020,9103,8342,761,8.4,-70
"Aransas County, TX",TX,2019,9173,8780,393,4.3,-305
"Aransas County, TX",TX,2018,9478,8910,568,6.0,-780
"Aransas County, TX",TX,2017,10258,9553,705,6.9,17
"Aransas County, TX",TX,2016,10241,9669,572,5.6,176
"Aransas County, TX",TX,2015,10065,9551,514,5.1,-122
"Aransas County, TX",TX,2014,10187,9616,571,5.6,138
"Aransas County, TX",TX,2013,10049,9384,665,6.6,130
"Aransas County, TX",TX,2012,9919,9233,686,6.9,105
"Aransas County, TX",TX,2011,9814,8926,888,9.0,113
"Aransas County, TX",TX,2010,9701,8805,896,9.2,0
"Arapahoe County, CO",CO,2021,367171,345949,21222,5.8,7194
"Arapahoe County, CO",CO,2020,359977,333136,26841,7.5,-1819
"Arapahoe County, CO",CO,2019,361796,352585,9211,2.5,5271
"Arapahoe County, CO",CO,2018,356525,345984,10541,3.0,9002
"Arapahoe County, CO",CO,2017,347523,338561,8962,2.6,6900
"Arapahoe County, CO",CO,2016,340623,330532,10091,3.0,6243
"Arapahoe County, CO",CO,2015,334380,322380,12000,3.6,3240
"Arapahoe County, CO",CO,2014,331140,314951,16189,4.9,4976
"Arapahoe County, CO",CO,2013,326164,304991,21173,6.5,4237
"Arapahoe County, CO",CO,2012,321927,296756,25171,7.8,3332
"Arapahoe County, CO",CO,2011,318595,291255,27340,8.6,2767
"Arapahoe County, CO",CO,2010,315828,287454,28374,9.0,0
"Archer County, TX",TX,2021,3975,3808,167,4.2,33
"Archer County, TX",TX,2020,3942,3735,207,5.3,-18
"Archer County, TX",TX,2019,3960,3848,112,2.8,-141
"Archer County, TX",TX,2018,4101,3975,126,3.1,-9
"Archer County, TX",TX,2017,4110,3971,139,3.4,19
"Archer County, TX",TX,2016,4091,3914,177,4.3,-34
"Archer County, TX",TX,2015,4125,3941,184,4.5,-111
"Archer County, TX",TX,2014,4236,4042,194,4.6,14
"Archer County, TX",TX,2013,4222,3999,223,5.3,-139
"Archer County, TX",TX,2012,4361,4123,238,5.5,-119
"Archer County, TX",TX,2011,4480,4199,281,6.3,-127
"Archer County, TX",TX,2010,4607,4299,308,6.7,0
"Archuleta County, CO",CO,2021,7300,6943,357,4.9,258
"Archuleta County, CO",CO,2020,7042,6537,505,7.2,197
"Archuleta County, CO",CO,2019,6845,6641,204,3.0,47
"Archuleta County, CO",CO,2018,6798,6582,216,3.2,238
"Archuleta County, CO",CO,2017,6560,6375,185,2.8,195
"Archuleta County, CO",CO,2016,6365,6165,200,3.1,354
"Archuleta County, CO",CO,2015,6011,5777,234,3.9,289
"Archuleta County, CO",CO,2014,5722,5381,341,6.0,26
"Archuleta County, CO",CO,2013,5696,5204,492,8.6,-26
"Archuleta County, CO",CO,2012,5722,5140,582,10.2,-17
"Archuleta County, CO",CO,2011,5739,5140,599,10.4,-32
"Archuleta County, CO",CO,2010,5771,5129,642,11.1,0
"Arecibo Municipio, PR",PR,2021,25670,23507,2163,8.4,
"Arecibo Municipio, PR",PR,2020,N.A.,N.A.,N.A.,N.A.,
"Arecibo Municipio, PR",PR,2019,23907,21618,2289,9.6,639
"Arecibo Municipio, PR",PR,2018,23268,20853,2415,10.4,-264
"Arecibo Municipio, PR",PR,2017,23532,20772,2760,11.7,-465
"Arecibo Municipio, PR",PR,2016,23997,20832,3165,13.2,70
"Arecibo Municipio, PR",PR,2015,23927,20600,3327,13.9,-426
"Arecibo Municipio, PR",PR,2014,24353,20564,3789,15.6,-928
"Arecibo Municipio, PR",PR,2013,25281,21338,3943,15.6,-258
"Arecibo Municipio, PR",PR,2012,25539,21489,4050,15.9,-1074
"Arecibo Municipio, PR",PR,2011,26613,21888,4725,17.8,-1296
"Arecibo Municipio, PR",PR,2010,27909,22893,5016,18.0,0
"Arenac County, MI",MI,2021,5709,5234,475,8.3,-234
"Arenac County, MI",MI,2020,5943,5243,700,11.8,-114
"Arenac County, MI",MI,2019,6057,5652,405,6.7,81
"Arenac County, MI",MI,2018,5976,5550,426,7.1,-47
"Arenac County, MI",MI,2017,6023,5543,480,8.0,-117
"Arenac County, MI",MI,2016,6140,5627,513,8.4,-119
"Arenac County, MI",MI,2015,6259,5691,568,9.1,-151
"Arenac County, MI",MI,2014,6410,5699,711,11.1,-97
"Arenac County, MI",MI,2013,6507,5669,838,12.9,-44
"Arenac County, MI",MI,2012,6551,5723,828,12.6,-111
"Arenac County, MI",MI,2011,6662,5761,901,13.5,-219
"Arenac County, MI",MI,2010,6881,5778,1103,16.0,0
"Arkansas County, AR",AR,2021,9424,9108,316,3.4,-12
"Arkansas County, AR",AR,2020,9436,9058,378,4.0,-45
"Arkansas County, AR",AR,2019,9481,9204,277,2.9,412
"Arkansas County, AR",AR,2018,9069,8770,299,3.3,102
"Arkansas County, AR",AR,2017,8967,8673,294,3.3,-317
"Arkansas County, AR",AR,2016,9284,8967,317,3.4,-250
"Arkansas County, AR",AR,2015,9534,9142,392,4.1,-11
"Arkansas County, AR",AR,2014,9545,9045,500,5.2,-102
"Arkansas County, AR",AR,2013,9647,8959,688,7.1,-311
"Arkansas County, AR",AR,2012,9958,9120,838,8.4,-551
"Arkansas County, AR",AR,2011,10509,9286,1223,11.6,-764
"Arkansas County, AR",AR,2010,11273,9251,2022,17.9,0
"Arlington County, VA",VA,2021,150721,146210,4511,3.0,-1829
"Arlington County, VA",VA,2020,152550,145804,6746,4.4,-3708
"Arlington County, VA",VA,2019,156258,153294,2964,1.9,2472
"Arlington County, VA",VA,2018,153786,150729,3057,2.0,2421
"Arlington County, VA",VA,2017,151365,147637,3728,2.5,4737
"Arlington County, VA",VA,2016,146628,142857,3771,2.6,1726
"Arlington County, VA",VA,2015,144902,140880,4022,2.8,-196
"Arlington County, VA",VA,2014,145098,140437,4661,3.2,-71
"Arlington County, VA",VA,2013,145169,140275,4894,3.4,1294
"Arlington County, VA",VA,2012,143875,138982,4893,3.4,2231
"Arlington County, VA",VA,2011,141644,136334,5310,3.7,4191
"Arlington County, VA",VA,2010,137453,131635,5818,4.2,0
"Armstrong County, PA",PA,2021,31268,28903,2365,7.6,-455
"Armstrong County, PA",PA,2020,31723,28603,3120,9.8,-729
"Armstrong County, PA",PA,2019,32452,30760,1692,5.2,39
"Armstrong County, PA",PA,2018,32413,30722,1691,5.2,-230
"Armstrong County, PA",PA,2017,32643,30597,2046,6.3,-490
"Armstrong County, PA",PA,2016,33133,30674,2459,7.4,82
"Armstrong County, PA",PA,2015,33051,30813,2238,6.8,-69
"Armstrong County, PA",PA,2014,33120,30958,2162,6.5,-374
"Armstrong County, PA",PA,2013,33494,31005,2489,7.4,-336
"Armstrong County, PA",PA,2012,33830,31171,2659,7.9,270
"Armstrong County, PA",PA,2011,33560,30864,2696,8.0,38
"Armstrong County, PA",PA,2010,33522,30565,2957,8.8,0
"Armstrong County, TX",TX,2021,920,887,33,3.6,29
"Armstrong County, TX",TX,2020,891,853,38,4.3,-28
"Armstrong County, TX",TX,2019,919,894,25,2.7,6
"Armstrong County, TX",TX,2018,913,888,25,2.7,2
"Armstrong County, TX",TX,2017,911,887,24,2.6,-23
"Armstrong County, TX",TX,2016,934,908,26,2.8,-42
"Armstrong County, TX",TX,2015,976,950,26,2.7,-27
"Armstrong County, TX",TX,2014,1003,970,33,3.3,-1
"Armstrong County, TX",TX,2013,1004,964,40,4.0,-21
"Armstrong County, TX",TX,2012,1025,980,45,4.4,-10
"Armstrong County, TX",TX,2011,1035,984,51,4.9,22
"Armstrong County, TX",TX,2010,1013,963,50,4.9,0
"Aroostook County, ME",ME,2021,29056,27408,1648,5.7,-143
"Aroostook County, ME",ME,2020,29199,27715,1484,5.1,-1357
"Aroostook County, ME",ME,2019,30556,29277,1279,4.2,-620
"Aroostook County, ME",ME,2018,31176,29795,1381,4.4,-603
"Aroostook County, ME",ME,2017,31779,30220,1559,4.9,231
"Aroostook County, ME",ME,2016,31548,29842,1706,5.4,-367
"Aroostook County, ME",ME,2015,31915,30022,1893,5.9,-1106
"Aroostook County, ME",ME,2014,33021,30530,2491,7.5,-798
"Aroostook County, ME",ME,2013,33819,30887,2932,8.7,-258
"Aroostook County, ME",ME,2012,34077,31019,3058,9.0,-429
"Aroostook County, ME",ME,2011,34506,31191,3315,9.6,-365
"Aroostook County, ME",ME,2010,34871,31361,3510,10.1,0
"Arroyo Municipio, PR",PR,2021,4967,4514,453,9.1,
"Arroyo Municipio, PR",PR,2020,N.A.,N.A.,N.A.,N.A.,
"Arroyo Municipio, PR",PR,2019,4716,4086,630,13.4,87
"Arroyo Municipio, PR",PR,2018,4629,3995,634,13.7,-371
"Arroyo Municipio, PR",PR,2017,5000,4113,887,17.7,-140
"Arroyo Municipio, PR",PR,2016,5140,4187,953,18.5,-51
"Arroyo Municipio, PR",PR,2015,5191,4213,978,18.8,-114
"Arroyo Municipio, PR",PR,2014,5305,4074,1231,23.2,-356
"Arroyo Municipio, PR",PR,2013,5661,4227,1434,25.3,-63
"Arroyo Municipio, PR",PR,2012,5724,4428,1296,22.6,-221
"Arroyo Municipio, PR",PR,2011,5945,4561,1384,23.3,-244
"Arroyo Municipio, PR",PR,2010,6189,4766,1423,23.0,0
"Arthur County, NE",NE,2021,234,228,6,2.6,0
"Arthur County, NE",NE,2020,234,222,12,5.1,3
"Arthur County, NE",NE,2019,231,218,13,5.6,8
"Arthur County, NE",NE,2018,223,212,11,4.9,0
"Arthur County, NE",NE,2017,223,210,13,5.8,-5
"Arthur County, NE",NE,2016,228,215,13,5.7,3
"Arthur County, NE",NE,2015,225,215,10,4.4,1
"Arthur County, NE",NE,2014,224,212,12,5.4,5
"Arthur County, NE",NE,2013,219,203,16,7.3,-11
"Arthur County, NE",NE,2012,230,215,15,6.5,-1
"Arthur County, NE",NE,2011,231,217,14,6.1,6
"Arthur County, NE",NE,2010,225,207,18,8.0,0
"Ascension Parish, LA",LA,2021,64756,62050,2706,4.2,473
"Ascension Parish, LA",LA,2020,64283,59710,4573,7.1,-920
"Ascension Parish, LA",LA,2019,65203,62617,2586,4.0,757
"Ascension Parish, LA",LA,2018,64446,61833,2613,4.1,1562
"Ascension Parish, LA",LA,2017,62884,60202,2682,4.3,824
"Ascension Parish, LA",LA,2016,62060,59019,3041,4.9,659
"Ascension Parish, LA",LA,2015,61401,58319,3082,5.0,1970
"Ascension Parish, LA",LA,2014,59431,56324,3107,5.2,2609
"Ascension Parish, LA",LA,2013,56822,53778,3044,5.4,1703
"Ascension Parish, LA",LA,2012,55119,51915,3204,5.8,965
"Ascension Parish, LA",LA,2011,54154,50536,3618,6.7,789
"Ascension Parish, LA",LA,2010,53365,49616,3749,7.0,0
"Ashe County, NC",NC,2021,12614,12113,501,4.0,369
"Ashe County, NC",NC,2020,12245,11501,744,6.1,-514
"Ashe County, NC",NC,2019,12759,12297,462,3.6,238
"Ashe County, NC",NC,2018,12521,12063,458,3.7,38
"Ashe County, NC",NC,2017,12483,11970,513,4.1,15
"Ashe County, NC",NC,2016,12468,11870,598,4.8,171
"Ashe County, NC",NC,2015,12297,11566,731,5.9,-115
"Ashe County, NC",NC,2014,12412,11586,826,6.7,-465
"Ashe County, NC",NC,2013,12877,11725,1152,8.9,-425
"Ashe County, NC",NC,2012,13302,11881,1421,10.7,-16
"Ashe County, NC",NC,2011,13318,11859,1459,11.0,-453
"Ashe County, NC",NC,2010,13771,12159,1612,11.7,0
"Ashland County, OH",OH,2021,26333,25190,1143,4.3,68
"Ashland County, OH",OH,2020,26265,24564,1701,6.5,-749
"Ashland County, OH",OH,2019,27014,25884,1130,4.2,712
"Ashland County, OH",OH,2018,26302,25105,1197,4.6,-88
"Ashland County, OH",OH,2017,26390,25094,1296,4.9,25
"Ashland County, OH",OH,2016,26365,25018,1347,5.1,301
"Ashland County, OH",OH,2015,26064,24739,1325,5.1,448
"Ashland County, OH",OH,2014,25616,24091,1525,6.0,110
"Ashland County, OH",OH,2013,25506,23448,2058,8.1,-326
"Ashland County, OH",OH,2012,25832,23760,2072,8.0,-235
"Ashland County, OH",OH,2011,26067,23497,2570,9.9,-599
"Ashland County, OH",OH,2010,26666,23489,3177,11.9,0
"Ashland County, WI",WI,2021,7713,7324,389,5.0,13
"Ashland County, WI",WI,2020,7700,7037,663,8.6,-204
"Ashland County, WI",WI,2019,7904,7544,360,4.6,-28
"Ashland County, WI",WI,2018,7932,7597,335,4.2,15
"Ashland County, WI",WI,2017,7917,7559,358,4.5,-12
"Ashland County, WI",WI,2016,7929,7510,419,5.3,28
"Ashland County, WI",WI,2015,7901,7418,483,6.1,-140
"Ashland County, WI",WI,2014,8041,7447,594,7.4,-115
"Ashland County, WI",WI,2013,8156,7416,740,9.1,-65
"Ashland County, WI",WI,2012,8221,7473,748,9.1,-60
"Ashland County, WI",WI,2011,8281,7463,818,9.9,-128
"Ashland County, WI",WI,2010,8409,7495,914,10.9,0
"Ashley County, AR",AR,2021,6801,6301,500,7.4,-377
"Ashley County, AR",AR,2020,7178,6506,672,9.4,-529
"Ashley County, AR",AR,2019,7707,7300,407,5.3,-119
"Ashley County, AR",AR,2018,7826,7417,409,5.2,-39
"Ashley County, AR",AR,2017,7865,7424,441,5.6,-101
"Ashley County, AR",AR,2016,7966,7477,489,6.1,-431
"Ashley County, AR",AR,2015,8397,7771,626,7.5,-339
"Ashley County, AR",AR,2014,8736,7962,774,8.9,-418
"Ashley County, AR",AR,2013,9154,8204,950,10.4,-336
"Ashley County, AR",AR,2012,9490,8394,1096,11.5,-514
"Ashley County, AR",AR,2011,10004,8953,1051,10.5,108
"Ashley County, AR",AR,2010,9896,8949,947,9.6,0
"Ashtabula County, OH",OH,2021,43322,40944,2378,5.5,-325
"Ashtabula County, OH",OH,2020,43647,40010,3637,8.3,-1215
"Ashtabula County, OH",OH,2019,44862,42699,2163,4.8,231
"Ashtabula County, OH",OH,2018,44631,42299,2332,5.2,229
"Ashtabula County, OH",OH,2017,44402,41788,2614,5.9,3
"Ashtabula County, OH",OH,2016,44399,41673,2726,6.1,-105
"Ashtabula County, OH",OH,2015,44504,41816,2688,6.0,-545
"Ashtabula County, OH",OH,2014,45049,41823,3226,7.2,-939
"Ashtabula County, OH",OH,2013,45988,41634,4354,9.5,-467
"Ashtabula County, OH",OH,2012,46455,42089,4366,9.4,-987
"Ashtabula County, OH",OH,2011,47442,42292,5150,10.9,-1036
"Ashtabula County, OH",OH,2010,48478,42190,6288,13.0,0
"Asotin County, WA",WA,2021,10630,10235,395,3.7,299
"Asotin County, WA",WA,2020,10331,9799,532,5.1,-136
"Asotin County, WA",WA,2019,10467,10029,438,4.2,217
"Asotin County, WA",WA,2018,10250,9811,439,4.3,-43
"Asotin County, WA",WA,2017,10293,9868,425,4.1,321
"Asotin County, WA",WA,2016,9972,9483,489,4.9,290
"Asotin County, WA",WA,2015,9682,9234,448,4.6,-12
"Asotin County, WA",WA,2014,9694,9190,504,5.2,-91
"Asotin County, WA",WA,2013,9785,9151,634,6.5,52
"Asotin County, WA",WA,2012,9733,9038,695,7.1,-231
"Asotin County, WA",WA,2011,9964,9166,798,8.0,-169
"Asotin County, WA",WA,2010,10133,9269,864,8.5,0
"Assumption Parish, LA",LA,2021,8713,8088,625,7.2,-59
"Assumption Parish, LA",LA,2020,8772,7834,938,10.7,-149
"Assumption Parish, LA",LA,2019,8921,8402,519,5.8,-71
"Assumption Parish, LA",LA,2018,8992,8401,591,6.6,38
"Assumption Parish, LA",LA,2017,8954,8297,657,7.3,-264
"Assumption Parish, LA",LA,2016,9218,8443,775,8.4,-542
"Assumption Parish, LA",LA,2015,9760,8997,763,7.8,-256
"Assumption Parish, LA",LA,2014,10016,9259,757,7.6,106
"Assumption Parish, LA",LA,2013,9910,9119,791,8.0,-74
"Assumption Parish, LA",LA,2012,9984,9059,925,9.3,-7
"Assumption Parish, LA",LA,2011,9991,8839,1152,11.5,-47
"Assumption Parish, LA",LA,2010,10038,8938,1100,11.0,0
"Atascosa County, TX",TX,2021,21901,20550,1351,6.2,421
"Atascosa County, TX",TX,2020,21480,19645,1835,8.5,-3
"Atascosa County, TX",TX,2019,21483,20710,773,3.6,276
"Atascosa County, TX",TX,2018,21207,20401,806,3.8,420
"Atascosa County, TX",TX,2017,20787,19895,892,4.3,-244
"Atascosa County, TX",TX,2016,21031,19906,1125,5.3,485
"Atascosa County, TX",TX,2015,20546,19560,986,4.8,203
"Atascosa County, TX",TX,2014,20343,19323,1020,5.0,137
"Atascosa County, TX",TX,2013,20206,18937,1269,6.3,184
"Atascosa County, TX",TX,2012,20022,18681,1341,6.7,138
"Atascosa County, TX",TX,2011,19884,18246,1638,8.2,223
"Atascosa County, TX",TX,2010,19661,18047,1614,8.2,0
"Atchison County, KS",KS,2021,6742,6485,257,3.8,-109
"Atchison County, KS",KS,2020,6851,6400,451,6.6,-184
"Atchison County, KS",KS,2019,7035,6676,359,5.1,-9
"Atchison County, KS",KS,2018,7044,6728,316,4.5,-30
"Atchison County, KS",KS,2017,7074,6708,366,5.2,-4
"Atchison County, KS",KS,2016,7078,6639,439,6.2,-412
"Atchison County, KS",KS,2015,7490,7031,459,6.1,-153
"Atchison County, KS",KS,2014,7643,7150,493,6.5,-151
"Atchison County, KS",KS,2013,7794,7126,668,8.6,-70
"Atchison County, KS",KS,2012,7864,7257,607,7.7,-96
"Atchison County, KS",KS,2011,7960,7251,709,8.9,27
"Atchison County, KS",KS,2010,7933,7160,773,9.7,0
"Atchison County, MO",MO,2021,2655,2569,86,3.2,-60
"Atchison County, MO",MO,2020,2715,2606,109,4.0,35
"Atchison County, MO",MO,2019,2680,2586,94,3.5,-81
"Atchison County, MO",MO,2018,2761,2694,67,2.4,-87
"Atchison County, MO",MO,2017,2848,2749,99,3.5,10
"Atchison County, MO",MO,2016,2838,2709,129,4.5,23
"Atchison County, MO",MO,2015,2815,2687,128,4.5,-47
"Atchison County, MO",MO,2014,2862,2707,155,5.4,-10
"Atchison County, MO",MO,2013,2872,2703,169,5.9,14
"Atchison County, MO",MO,2012,2858,2670,188,6.6,-22
"Atchison County, MO",MO,2011,2880,2639,241,8.4,-107
"Atchison County, MO",MO,2010,2987,2732,255,8.5,0
"Athens County, OH",OH,2021,25533,24107,1426,5.6,-810
"Athens County, OH",OH,2020,26343,24334,2009,7.6,-1752
"Athens County, OH",OH,2019,28095,26605,1490,5.3,102
"Athens County, OH",OH,2018,27993,26414,1579,5.6,-504
"Athens County, OH",OH,2017,28497,26775,1722,6.0,368
"Athens County, OH",OH,2016,28129,26318,1811,6.4,123
"Athens County, OH",OH,2015,28006,26244,1762,6.3,330
"Athens County, OH",OH,2014,27676,25780,1896,6.9,190
"Athens County, OH",OH,2013,27486,25014,2472,9.0,-116
"Athens County, OH",OH,2012,27602,25250,2352,8.5,-178
"Athens County, OH",OH,2011,27780,25022,2758,9.9,-896
"Athens County, OH",OH,2010,28676,25621,3055,10.7,0
"Atkinson County, GA",GA,2021,4503,4372,131,2.9,50
"Atkinson County, GA",GA,2020,4453,4280,173,3.9,-113
"Atkinson County, GA",GA,2019,4566,4416,150,3.3,198
"Atkinson County, GA",GA,2018,4368,4212,156,3.6,161
"Atkinson County, GA",GA,2017,4207,4017,190,4.5,231
"Atkinson County, GA",GA,2016,3976,3765,211,5.3,155
"Atkinson County, GA",GA,2015,3821,3598,223,5.8,211
"Atkinson County, GA",GA,2014,3610,3335,275,7.6,130
"Atkinson County, GA",GA,2013,3480,3157,323,9.3,47
"Atkinson County, GA",GA,2012,3433,3042,391,11.4,-54
"Atkinson County, GA",GA,2011,3487,3044,443,12.7,24
"Atkinson County, GA",GA,2010,3463,2929,534,15.4,0
"Atlantic County, NJ",NJ,2021,123181,111516,11665,9.5,-999
"Atlantic County, NJ",NJ,2020,124180,102874,21306,17.2,-1995
"Atlantic County, NJ",NJ,2019,126175,120115,6060,4.8,2655
"Atlantic County, NJ",NJ,2018,123520,116516,7004,5.7,833
"Atlantic County, NJ",NJ,2017,122687,113992,8695,7.1,-168
"Atlantic County, NJ",NJ,2016,122855,113793,9062,7.4,-3384
"Atlantic County, NJ",NJ,2015,126239,114279,11960,9.5,-5417
"Atlantic County, NJ",NJ,2014,131656,117800,13856,10.5,-5316
"Atlantic County, NJ",NJ,2013,136972,120654,16318,11.9,-3189
"Atlantic County, NJ",NJ,2012,140161,122261,17900,12.8,958
"Atlantic County, NJ",NJ,2011,139203,121730,17473,12.6,-1324
"Atlantic County, NJ",NJ,2010,140527,122988,17539,12.5,0
"Atoka County, OK",OK,2021,5021,4784,237,4.7,-92
"Atoka County, OK",OK,2020,5113,4745,368,7.2,217
"Atoka County, OK",OK,2019,4896,4694,202,4.1,-153
"Atoka County, OK",OK,2018,5049,4848,201,4.0,-118
"Atoka County, OK",OK,2017,5167,4907,260,5.0,115
"Atoka County, OK",OK,2016,5052,4731,321,6.4,196
"Atoka County, OK",OK,2015,4856,4548,308,6.3,61
"Atoka County, OK",OK,2014,4795,4510,285,5.9,-108
"Atoka County, OK",OK,2013,4903,4576,327,6.7,-74
"Atoka County, OK",OK,2012,4977,4650,327,6.6,-14
"Atoka County, OK",OK,2011,4991,4585,406,8.1,-108
"Atoka County, OK",OK,2010,5099,4608,491,9.6,0
"Attala County, MS",MS,2021,6882,6469,413,6.0,42
"Attala County, MS",MS,2020,6840,6280,560,8.2,-180
"Attala County, MS",MS,2019,7020,6578,442,6.3,68
"Attala County, MS",MS,2018,6952,6550,402,5.8,7
"Attala County, MS",MS,2017,6945,6514,431,6.2,-39
"Attala County, MS",MS,2016,6984,6506,478,6.8,20
"Attala County, MS",MS,2015,6964,6427,537,7.7,-58
"Attala County, MS",MS,2014,7022,6403,619,8.8,-231
"Attala County, MS",MS,2013,7253,6578,675,9.3,-411
"Attala County, MS",MS,2012,7664,6927,737,9.6,-335
"Attala County, MS",MS,2011,7999,7124,875,10.9,33
"Attala County, MS",MS,2010,7966,6994,972,12.2,0
"Audrain County, MO",MO,2021,10246,9870,376,3.7,-30
"Audrain County, MO",MO,2020,10276,9683,593,5.8,-328
"Audrain County, MO",MO,2019,10604,10266,338,3.2,-169
"Audrain County, MO",MO,2018,10773,10445,328,3.0,-293
"Audrain County, MO",MO,2017,11066,10681,385,3.5,-54
"Audrain County, MO",MO,2016,11120,10649,471,4.2,-122
"Audrain County, MO",MO,2015,11242,10712,530,4.7,47
"Audrain County, MO",MO,2014,11195,10567,628,5.6,-8
"Audrain County, MO",MO,2013,11203,10487,716,6.4,-72
"Audrain County, MO",MO,2012,11275,10517,758,6.7,34
"Audrain County, MO",MO,2011,11241,10299,942,8.4,151
"Audrain County, MO",MO,2010,11090,10032,1058,9.5,0
"Audubon County, IA",IA,2021,3034,2938,96,3.2,8
"Audubon County, IA",IA,2020,3026,2924,102,3.4,-151
"Audubon County, IA",IA,2019,3177,3102,75,2.4,42
"Audubon County, IA",IA,2018,3135,3058,77,2.5,-52
"Audubon County, IA",IA,2017,3187,3090,97,3.0,-106
"Audubon County, IA",IA,2016,3293,3185,108,3.3,56
"Audubon County, IA",IA,2015,3237,3110,127,3.9,-21
"Audubon County, IA",IA,2014,3258,3118,140,4.3,17
"Audubon County, IA",IA,2013,3241,3083,158,4.9,12
"Audubon County, IA",IA,2012,3229,3074,155,4.8,-149
"Audubon County, IA",IA,2011,3378,3181,197,5.8,-91
"Audubon County, IA",IA,2010,3469,3272,197,5.7,0
"Auglaize County, OH",OH,2021,24365,23465,900,3.7,-136
"Auglaize County, OH",OH,2020,24501,22818,1683,6.9,-645
"Auglaize County, OH",OH,2019,25146,24384,762,3.0,389
"Auglaize County, OH",OH,2018,24757,23948,809,3.3,-76
"Auglaize County, OH",OH,2017,24833,23919,914,3.7,117
"Auglaize County, OH",OH,2016,24716,23789,927,3.8,186
"Auglaize County, OH",OH,2015,24530,23619,911,3.7,328
"Auglaize County, OH",OH,2014,24202,23155,1047,4.3,254
"Auglaize County, OH",OH,2013,23948,22537,1411,5.9,-10
"Auglaize County, OH",OH,2012,23958,22479,1479,6.2,-102
"Auglaize County, OH",OH,2011,24060,22116,1944,8.1,-536
"Auglaize County, OH",OH,2010,24596,22126,2470,10.0,0
"Augusta County, VA",VA,2021,36312,35201,1111,3.1,-861
"Augusta County, VA",VA,2020,37173,35471,1702,4.6,-836
"Augusta County, VA",VA,2019,38009,37089,920,2.4,841
"Augusta County, VA",VA,2018,37168,36170,998,2.7,96
"Augusta County, VA",VA,2017,37072,35823,1249,3.4,174
"Augusta County, VA",VA,2016,36898,35570,1328,3.6,107
"Augusta County, VA",VA,2015,36791,35304,1487,4.0,-186
"Augusta County, VA",VA,2014,36977,35275,1702,4.6,72
"Augusta County, VA",VA,2013,36905,35024,1881,5.1,-85
"Augusta County, VA",VA,2012,36990,34890,2100,5.7,-385
"Augusta County, VA",VA,2011,37375,35012,2363,6.3,191
"Augusta County, VA",VA,2010,37184,34464,2720,7.3,0
"Aurora County, SD",SD,2021,1478,1443,35,2.4,15
"Aurora County, SD",SD,2020,1463,1419,44,3.0,-42
"Aurora County, SD",SD,2019,1505,1470,35,2.3,-49
"Aurora County, SD",SD,2018,1554,1512,42,2.7,33
"Aurora County, SD",SD,2017,1521,1481,40,2.6,-7
"Aurora County, SD",SD,2016,1528,1494,34,2.2,-53
"Aurora County, SD",SD,2015,1581,1547,34,2.2,-38
"Aurora County, SD",SD,2014,1619,1578,41,2.5,-38
"Aurora County, SD",SD,2013,1657,1613,44,2.7,-44
"Aurora County, SD",SD,2012,1701,1654,47,2.8,16
"Aurora County, SD",SD,2011,1685,1634,51,3.0,0
"Aurora County, SD",SD,2010,1685,1627,58,3.4,0
"Austin County, TX",TX,2021,13696,12940,756,5.5,334
"Austin County, TX",TX,2020,13362,12474,888,6.6,-447
"Austin County, TX",TX,2019,13809,13333,476,3.4,79
"Austin County, TX",TX,2018,13730,13223,507,3.7,27
"Austin County, TX",TX,2017,13703,13094,609,4.4,-333
"Austin County, TX",TX,2016,14036,13287,749,5.3,-11
"Austin County, TX",TX,2015,14047,13397,650,4.6,-69
"Austin County, TX",TX,2014,14116,13433,683,4.8,6
"Austin County, TX",TX,2013,14110,13274,836,5.9,50
"Austin County, TX",TX,2012,14060,13166,894,6.4,-87
"Austin County, TX",TX,2011,14147,12995,1152,8.1,208
"Austin County, TX",TX,2010,13939,12813,1126,8.1,0
"Autauga County, AL",AL,2021,26341,25599,742,2.8,-64
"Autauga County, AL",AL,2020,26405,24985,1420,5.4,-279
"Autauga County, AL",AL,2019,26684,25920,764,2.9,209
"Autauga County, AL",AL,2018,26475,25524,951,3.6,206
"Autauga County, AL",AL,2017,26269,25224,1045,4.0,559
"Autauga County, AL",AL,2016,25710,24395,1315,5.1,169
"Autauga County, AL",AL,2015,25541,24206,1335,5.2,-98
"Autauga County, AL",AL,2014,25639,24150,1489,5.8,-144
"Autauga County, AL",AL,2013,25783,24155,1628,6.3,21
"Autauga County, AL",AL,2012,25762,23932,1830,7.1,-83
"Autauga County, AL",AL,2011,25845,23688,2157,8.3,96
"Autauga County, AL",AL,2010,25749,23481,2268,8.8,0
"Avery County, NC",NC,2021,7380,7089,291,3.9,285
"Avery County, NC",NC,2020,7095,6660,435,6.1,-366
"Avery County, NC",NC,2019,7461,7189,272,3.6,-30
"Avery County, NC",NC,2018,7491,7213,278,3.7,-39
"Avery County, NC",NC,2017,7530,7208,322,4.3,-21
"Avery County, NC",NC,2016,7551,7171,380,5.0,27
"Avery County, NC",NC,2015,7524,7082,442,5.9,-127
"Avery County, NC",NC,2014,7651,7165,486,6.4,-48
"Avery County, NC",NC,2013,7699,7029,670,8.7,-113
"Avery County, NC",NC,2012,7812,6962,850,10.9,4
"Avery County, NC",NC,2011,7808,6941,867,11.1,-166
"Avery County, NC",NC,2010,7974,7124,850,10.7,0
"Avoyelles Parish, LA",LA,2021,14753,13982,771,5.2,-172
"Avoyelles Parish, LA",LA,2020,14925,13656,1269,8.5,-303
"Avoyelles Parish, LA",LA,2019,15228,14376,852,5.6,-131
"Avoyelles Parish, LA",LA,2018,15359,14496,863,5.6,-279
"Avoyelles Parish, LA",LA,2017,15638,14681,957,6.1,-64
"Avoyelles Parish, LA",LA,2016,15702,14591,1111,7.1,-194
"Avoyelles Parish, LA",LA,2015,15896,14710,1186,7.5,-163
"Avoyelles Parish, LA",LA,2014,16059,14921,1138,7.1,59
"Avoyelles Parish, LA",LA,2013,16000,14855,1145,7.2,-437
"Avoyelles Parish, LA",LA,2012,16437,15250,1187,7.2,-254
"Avoyelles Parish, LA",LA,2011,16691,15360,1331,8.0,-161
"Avoyelles Parish, LA",LA,2010,16852,15516,1336,7.9,0
"Baca County, CO",CO,2021,2118,2073,45,2.1,35
"Baca County, CO",CO,2020,2083,2036,47,2.3,-56
"Baca County, CO",CO,2019,2139,2105,34,1.6,-11
"Baca County, CO",CO,2018,2150,2114,36,1.7,45
"Baca County, CO",CO,2017,2105,2073,32,1.5,12
"Baca County, CO",CO,2016,2093,2059,34,1.6,122
"Baca County, CO",CO,2015,1971,1932,39,2.0,46
"Baca County, CO",CO,2014,1925,1872,53,2.8,30
"Baca County, CO",CO,2013,1895,1818,77,4.1,-113
"Baca County, CO",CO,2012,2008,1916,92,4.6,-53
"Baca County, CO",CO,2011,2061,1958,103,5.0,-13
"Baca County, CO",CO,2010,2074,1967,107,5.2,0
"Bacon County, GA",GA,2021,4837,4680,157,3.2,-10
"Bacon County, GA",GA,2020,4847,4622,225,4.6,-116
"Bacon County, GA",GA,2019,4963,4776,187,3.8,-85
"Bacon County, GA",GA,2018,5048,4853,195,3.9,-56
"Bacon County, GA",GA,2017,5104,4874,230,4.5,123
"Bacon County, GA",GA,2016,4981,4717,264,5.3,141
"Bacon County, GA",GA,2015,4840,4557,283,5.8,0
"Bacon County, GA",GA,2014,4840,4501,339,7.0,218
"Bacon County, GA",GA,2013,4622,4234,388,8.4,80
"Bacon County, GA",GA,2012,4542,4108,434,9.6,43
"Bacon County, GA",GA,2011,4499,4030,469,10.4,-55
"Bacon County, GA",GA,2010,4554,4064,490,10.8,0
"Bailey County, TX",TX,2021,2411,2292,119,4.9,42
"Bailey County, TX",TX,2020,2369,2256,113,4.8,-101
"Bailey County, TX",TX,2019,2470,2379,91,3.7,-124
"Bailey County, TX",TX,2018,2594,2479,115,4.4,-47
"Bailey County, TX",TX,2017,2641,2527,114,4.3,-78
"Bailey County, TX",TX,2016,2719,2600,119,4.4,-82
"Bailey County, TX",TX,2015,2801,2680,121,4.3,-153
"Bailey County, TX",TX,2014,2954,2803,151,5.1,-88
"Bailey County, TX",TX,2013,3042,2823,219,7.2,-133
"Bailey County, TX",TX,2012,3175,2957,218,6.9,-112
"Bailey County, TX",TX,2011,3287,3034,253,7.7,25
"Bailey County, TX",TX,2010,3262,3004,258,7.9,0
"Baker County, FL",FL,2021,12089,11640,449,3.7,434
"Baker County, FL",FL,2020,11655,11020,635,5.4,-258
"Baker County, FL",FL,2019,11913,11533,380,3.2,360
"Baker County, FL",FL,2018,11553,11144,409,3.5,-8
"Baker County, FL",FL,2017,11561,11070,491,4.2,105
"Baker County, FL",FL,2016,11456,10892,564,4.9,239
"Baker County, FL",FL,2015,11217,10584,633,5.6,25
"Baker County, FL",FL,2014,11192,10454,738,6.6,-54
"Baker County, FL",FL,2013,11246,10377,869,7.7,-29
"Baker County, FL",FL,2012,11275,10277,998,8.9,-166
"Baker County, FL",FL,2011,11441,10274,1167,10.2,-12
"Baker County, FL",FL,2010,11453,10197,1256,11.0,0
"Baker County, GA",GA,2021,1135,1079,56,4.9,9
"Baker County, GA",GA,2020,1126,1059,67,6.0,-34
"Baker County, GA",GA,2019,1160,1104,56,4.8,-6
"Baker County, GA",GA,2018,1166,1104,62,5.3,-83
"Baker County, GA",GA,2017,1249,1171,78,6.2,68
"Baker County, GA",GA,2016,1181,1089,92,7.8,70
"Baker County, GA",GA,2015,1111,1029,82,7.4,-2
"Baker County, GA",GA,2014,1113,1012,101,9.1,-15
"Baker County, GA",GA,2013,1128,1010,118,10.5,-40
"Baker County, GA",GA,2012,1168,1041,127,10.9,-2
"Baker County, GA",GA,2011,1170,1035,135,11.5,-67
"Baker County, GA",GA,2010,1237,1084,153,12.4,0
"Baker County, OR",OR,2021,7467,7083,384,5.1,198
"Baker County, OR",OR,2020,7269,6747,522,7.2,159
"Baker County, OR",OR,2019,7110,6788,322,4.5,44
"Baker County, OR",OR,2018,7066,6699,367,5.2,106
"Baker County, OR",OR,2017,6960,6586,374,5.4,27
"Baker County, OR",OR,2016,6933,6504,429,6.2,258
"Baker County, OR",OR,2015,6675,6235,440,6.6,-77
"Baker County, OR",OR,2014,6752,6199,553,8.2,-94
"Baker County, OR",OR,2013,6846,6194,652,9.5,-290
"Baker County, OR",OR,2012,7136,6384,752,10.5,-190
"Baker County, OR",OR,2011,7326,6523,803,11.0,-63
"Baker County, OR",OR,2010,7389,6625,764,10.3,0
"Baldwin County, AL",AL,2021,99427,96481,2946,3.0,517
"Baldwin County, AL",AL,2020,98910,92751,6159,6.2,-11
"Baldwin County, AL",AL,2019,98921,96044,2877,2.9,2669
"Baldwin County, AL",AL,2018,96252,92769,3483,3.6,3100
"Baldwin County, AL",AL,2017,93152,89286,3866,4.2,3374
"Baldwin County, AL",AL,2016,89778,84972,4806,5.4,2285
"Baldwin County, AL",AL,2015,87493,82619,4874,5.6,947
"Baldwin County, AL",AL,2014,86546,81265,5281,6.1,1340
"Baldwin County, AL",AL,2013,85206,79466,5740,6.7,699
"Baldwin County, AL",AL,2012,84507,77973,6534,7.7,-570
"Baldwin County, AL",AL,2011,85077,77459,7618,9.0,1526
"Baldwin County, AL",AL,2010,83551,75283,8268,9.9,0
"Baldwin County, GA",GA,2021,17731,16885,846,4.8,65
"Baldwin County, GA",GA,2020,17666,16453,1213,6.9,-63
"Baldwin County, GA",GA,2019,17729,16946,783,4.4,4
"Baldwin County, GA",GA,2018,17725,16837,888,5.0,-45
"Baldwin County, GA",GA,2017,17770,16720,1050,5.9,133
"Baldwin County, GA",GA,2016,17637,16414,1223,6.9,83
"Baldwin County, GA",GA,2015,17554,16186,1368,7.8,-897
"Baldwin County, GA",GA,2014,18451,16836,1615,8.8,-51
"Baldwin County, GA",GA,2013,18502,16637,1865,10.1,-304
"Baldwin County, GA",GA,2012,18806,16655,2151,11.4,234
"Baldwin County, GA",GA,2011,18572,16037,2535,13.6,-689
"Baldwin County, GA",GA,2010,19261,16264,2997,15.6,0
"Ballard County, KY",KY,2021,3447,3274,173,5.0,123
"Ballard County, KY",KY,2020,3324,3113,211,6.3,-154
"Ballard County, KY",KY,2019,3478,3289,189,5.4,-53
"Ballard County, KY",KY,2018,3531,3291,240,6.8,-104
"Ballard County, KY",KY,2017,3635,3362,273,7.5,-6
"Ballard County, KY",KY,2016,3641,3320,321,8.8,41
"Ballard County, KY",KY,2015,3600,3355,245,6.8,-76
"Ballard County, KY",KY,2014,3676,3383,293,8.0,-149
"Ballard County, KY",KY,2013,3825,3477,348,9.1,-58
"Ballard County, KY",KY,2012,3883,3527,356,9.2,-11
"Ballard County, KY",KY,2011,3894,3507,387,9.9,34
"Ballard County, KY",KY,2010,3860,3460,400,10.4,0
"Baltimore city, MD",MD,2021,277525,256302,21223,7.6,-4682
"Baltimore city, MD",MD,2020,282207,257578,24629,8.7,-10470
"Baltimore city, MD",MD,2019,292677,278237,14440,4.9,1297
"Baltimore city, MD",MD,2018,291380,275863,15517,5.3,-2969
"Baltimore city, MD",MD,2017,294349,276896,17453,5.9,5278
"Baltimore city, MD",MD,2016,289071,270665,18406,6.4,-4287
"Baltimore city, MD",MD,2015,293358,271643,21715,7.4,-374
"Baltimore city, MD",MD,2014,293732,268993,24739,8.4,-2690
"Baltimore city, MD",MD,2013,296422,267999,28423,9.6,-731
"Baltimore city, MD",MD,2012,297153,267396,29757,10.0,1584
"Baltimore city, MD",MD,2011,295569,264036,31533,10.7,-511
"Baltimore city, MD",MD,2010,296080,262216,33864,11.4,0
"Baltimore County, MD",MD,2021,444930,419727,25203,5.7,-7315
"Baltimore County, MD",MD,2020,452245,421646,30599,6.8,-14802
"Baltimore County, MD",MD,2019,467047,450509,16538,3.5,9246
"Baltimore County, MD",MD,2018,457801,440676,17125,3.7,1269
"Baltimore County, MD",MD,2017,456532,437550,18982,4.2,11849
"Baltimore County, MD",MD,2016,444683,424736,19947,4.5,-24
"Baltimore County, MD",MD,2015,444707,421631,23076,5.2,3387
"Baltimore County, MD",MD,2014,441320,414836,26484,6.0,-822
"Baltimore County, MD",MD,2013,442142,411999,30143,6.8,1730
"Baltimore County, MD",MD,2012,440412,408491,31921,7.2,4734
"Baltimore County, MD",MD,2011,435678,401906,33772,7.8,3567
"Baltimore County, MD",MD,2010,432111,395705,36406,8.4,0
"Bamberg County, SC",SC,2021,4691,4341,350,7.5,-51
"Bamberg County, SC",SC,2020,4742,4327,415,8.8,-89
"Bamberg County, SC",SC,2019,4831,4569,262,5.4,-67
"Bamberg County, SC",SC,2018,4898,4584,314,6.4,-133
"Bamberg County, SC",SC,2017,5031,4661,370,7.4,-264
"Bamberg County, SC",SC,2016,5295,4827,468,8.8,-160
"Bamberg County, SC",SC,2015,5455,4888,567,10.4,-100
"Bamberg County, SC",SC,2014,5555,4929,626,11.3,-34
"Bamberg County, SC",SC,2013,5589,4853,736,13.2,-210
"Bamberg County, SC",SC,2012,5799,4895,904,15.6,-539
"Bamberg County, SC",SC,2011,6338,5322,1016,16.0,-235
"Bamberg County, SC",SC,2010,6573,5499,1074,16.3,0
"Bandera County, TX",TX,2021,10227,9745,482,4.7,355
"Bandera County, TX",TX,2020,9872,9298,574,5.8,-57
"Bandera County, TX",TX,2019,9929,9602,327,3.3,86
"Bandera County, TX",TX,2018,9843,9505,338,3.4,175
"Bandera County, TX",TX,2017,9668,9316,352,3.6,161
"Bandera County, TX",TX,2016,9507,9116,391,4.1,325
"Bandera County, TX",TX,2015,9182,8814,368,4.0,70
"Bandera County, TX",TX,2014,9112,8672,440,4.8,58
"Bandera County, TX",TX,2013,9054,8504,550,6.1,-52
"Bandera County, TX",TX,2012,9106,8513,593,6.5,-70
"Bandera County, TX",TX,2011,9176,8465,711,7.7,-12
"Bandera County, TX",TX,2010,9188,8468,720,7.8,0
"Banks County, GA",GA,2021,10116,9854,262,2.6,291
"Banks County, GA",GA,2020,9825,9407,418,4.3,18
"Banks County, GA",GA,2019,9807,9528,279,2.8,241
"Banks County, GA",GA,2018,9566,9261,305,3.2,203
"Banks County, GA",GA,2017,9363,8995,368,3.9,547
"Banks County, GA",GA,2016,8816,8382,434,4.9,689
"Banks County, GA",GA,2015,8127,7666,461,5.7,-10
"Banks County, GA",GA,2014,8137,7595,542,6.7,152
"Banks County, GA",GA,2013,7985,7360,625,7.8,-577
"Banks County, GA",GA,2012,8562,7869,693,8.1,72
"Banks County, GA",GA,2011,8490,7712,778,9.2,11
"Banks County, GA",GA,2010,8479,7649,830,9.8,0
"Banner County, NE",NE,2021,389,381,8,2.1,-3
"Banner County, NE",NE,2020,392,381,11,2.8,8
"Banner County, NE",NE,2019,384,370,14,3.6,0
"Banner County, NE",NE,2018,384,370,14,3.6,-9
"Banner County, NE",NE,2017,393,379,14,3.6,-27
"Banner County, NE",NE,2016,420,405,15,3.6,-22
"Banner County, NE",NE,2015,442,427,15,3.4,5
"Banner County, NE",NE,2014,437,421,16,3.7,2
"Banner County, NE",NE,2013,435,416,19,4.4,-1
"Banner County, NE",NE,2012,436,417,19,4.4,3
"Banner County, NE",NE,2011,433,413,20,4.6,20
"Banner County, NE",NE,2010,413,395,18,4.4,0
"Bannock County, ID",ID,2021,42735,41215,1520,3.6,421
"Bannock County, ID",ID,2020,42314,40211,2103,5.0,-636
"Bannock County, ID",ID,2019,42950,41720,1230,2.9,956
"Bannock County, ID",ID,2018,41994,40820,1174,2.8,209
"Bannock County, ID",ID,2017,41785,40502,1283,3.1,719
"Bannock County, ID",ID,2016,41066,39648,1418,3.5,-862
"Bannock County, ID",ID,2015,41928,40372,1556,3.7,561
"Bannock County, ID",ID,2014,41367,39661,1706,4.1,-398
"Bannock County, ID",ID,2013,41765,39047,2718,6.5,416
"Bannock County, ID",ID,2012,41349,38418,2931,7.1,339
"Bannock County, ID",ID,2011,41010,37992,3018,7.4,-141
"Bannock County, ID",ID,2010,41151,37947,3204,7.8,0
"Baraga County, MI",MI,2021,3006,2769,237,7.9,-141
"Baraga County, MI",MI,2020,3147,2759,388,12.3,-65
"Baraga County, MI",MI,2019,3212,3005,207,6.4,50
"Baraga County, MI",MI,2018,3162,2967,195,6.2,-17
"Baraga County, MI",MI,2017,3179,2936,243,7.6,-51
"Baraga County, MI",MI,2016,3230,2962,268,8.3,-84
"Baraga County, MI",MI,2015,3314,3008,306,9.2,-158
"Baraga County, MI",MI,2014,3472,3081,391,11.3,-80
"Baraga County, MI",MI,2013,3552,3043,509,14.3,7
"Baraga County, MI",MI,2012,3545,3052,493,13.9,-98
"Baraga County, MI",MI,2011,3643,3067,576,15.8,-215
"Baraga County, MI",MI,2010,3858,3132,726,18.8,0
"Barber County, KS",KS,2021,2301,2257,44,1.9,-11
"Barber County, KS",KS,2020,2312,2240,72,3.1,-18
"Barber County, KS",KS,2019,2330,2273,57,2.4,-64
"Barber County, KS",KS,2018,2394,2335,59,2.5,-69
"Barber County, KS",KS,2017,2463,2394,69,2.8,-75
"Barber County, KS",KS,2016,2538,2445,93,3.7,-131
"Barber County, KS",KS,2015,2669,2556,113,4.2,-51
"Barber County, KS",KS,2014,2720,2637,83,3.1,-48
"Barber County, KS",KS,2013,2768,2657,111,4.0,28
"Barber County, KS",KS,2012,2740,2634,106,3.9,-52
"Barber County, KS",KS,2011,2792,2682,110,3.9,22
"Barber County, KS",KS,2010,2770,2646,124,4.5,0
"Barbour County, AL",AL,2021,8197,7728,469,5.7,-483
"Barbour County, AL",AL,2020,8680,8004,676,7.8,43
"Barbour County, AL",AL,2019,8637,8292,345,4.0,132
"Barbour County, AL",AL,2018,8505,8071,434,5.1,90
"Barbour County, AL",AL,2017,8415,7914,501,6.0,81
"Barbour County, AL",AL,2016,8334,7638,696,8.4,-256
"Barbour County, AL",AL,2015,8590,7823,767,8.9,-269
"Barbour County, AL",AL,2014,8859,7930,929,10.5,-237
"Barbour County, AL",AL,2013,9096,8152,944,10.4,-281
"Barbour County, AL",AL,2012,9377,8273,1104,11.8,-466
"Barbour County, AL",AL,2011,9843,8716,1127,11.4,-376
"Barbour County, AL",AL,2010,10219,8978,1241,12.1,0
"Barbour County, WV",WV,2021,7165,6786,379,5.3,-31
"Barbour County, WV",WV,2020,7196,6611,585,8.1,-5
"Barbour County, WV",WV,2019,7201,6772,429,6.0,269
"Barbour County, WV",WV,2018,6932,6522,410,5.9,78
"Barbour County, WV",WV,2017,6854,6454,400,5.8,-129
"Barbour County, WV",WV,2016,6983,6508,475,6.8,4
"Barbour County, WV",WV,2015,6979,6476,503,7.2,91
"Barbour County, WV",WV,2014,6888,6432,456,6.6,172
"Barbour County, WV",WV,2013,6716,6242,474,7.1,-11
"Barbour County, WV",WV,2012,6727,6186,541,8.0,-44
"Barbour County, WV",WV,2011,6771,6153,618,9.1,-92
"Barbour County, WV",WV,2010,6863,6171,692,10.1,0
"Barceloneta Municipio, PR",PR,2021,6363,5718,645,10.1,
"Barceloneta Municipio, PR",PR,2020,N.A.,N.A.,N.A.,N.A.,
"Barceloneta Municipio, PR",PR,2019,5962,5291,671,11.3,133
"Barceloneta Municipio, PR",PR,2018,5829,5143,686,11.8,-55
"Barceloneta Municipio, PR",PR,2017,5884,5060,824,14.0,21
"Barceloneta Municipio, PR",PR,2016,5863,5034,829,14.1,-45
"Barceloneta Municipio, PR",PR,2015,5908,5010,898,15.2,-240
"Barceloneta Municipio, PR",PR,2014,6148,4926,1222,19.9,-173
"Barceloneta Municipio, PR",PR,2013,6321,4964,1357,21.5,128
"Barceloneta Municipio, PR",PR,2012,6193,4995,1198,19.3,-145
"Barceloneta Municipio, PR",PR,2011,6338,4909,1429,22.5,-294
"Barceloneta Municipio, PR",PR,2010,6632,5007,1625,24.5,0
"Barnes County, ND",ND,2021,5273,5111,162,3.1,62
"Barnes County, ND",ND,2020,5211,5010,201,3.9,-54
"Barnes County, ND",ND,2019,5265,5122,143,2.7,-63
"Barnes County, ND",ND,2018,5328,5198,130,2.4,-161
"Barnes County, ND",ND,2017,5489,5338,151,2.8,-120
"Barnes County, ND",ND,2016,5609,5430,179,3.2,9
"Barnes County, ND",ND,2015,5600,5420,180,3.2,67
"Barnes County, ND",ND,2014,5533,5365,168,3.0,-113
"Barnes County, ND",ND,2013,5646,5467,179,3.2,-73
"Barnes County, ND",ND,2012,5719,5531,188,3.3,-307
"Barnes County, ND",ND,2011,6026,5797,229,3.8,-172
"Barnes County, ND",ND,2010,6198,5927,271,4.4,0
"Barnstable County, MA",MA,2021,112478,104925,7553,6.7,2010
"Barnstable County, MA",MA,2020,110468,98545,11923,10.8,-5164
"Barnstable County, MA",MA,2019,115632,110921,4711,4.1,-614
"Barnstable County, MA",MA,2018,116246,111087,5159,4.4,1950
"Barnstable County, MA",MA,2017,114296,108844,5452,4.8,2619
"Barnstable County, MA",MA,2016,111677,106010,5667,5.1,42
"Barnstable County, MA",MA,2015,111635,104824,6811,6.1,-495
"Barnstable County, MA",MA,2014,112130,104101,8029,7.2,3523
"Barnstable County, MA",MA,2013,108607,99545,9062,8.3,-301
"Barnstable County, MA",MA,2012,108908,99648,9260,8.5,-1237
"Barnstable County, MA",MA,2011,110145,100197,9948,9.0,-920
"Barnstable County, MA",MA,2010,111065,100362,10703,9.6,0
"Barnwell County, SC",SC,2021,7572,7079,493,6.5,-178
"Barnwell County, SC",SC,2020,7750,7193,557,7.2,-228
"Barnwell County, SC",SC,2019,7978,7645,333,4.2,-149
"Barnwell County, SC",SC,2018,8127,7745,382,4.7,284
"Barnwell County, SC",SC,2017,7843,7378,465,5.9,-200
"Barnwell County, SC",SC,2016,8043,7462,581,7.2,-326
"Barnwell County, SC",SC,2015,8369,7624,745,8.9,-268
"Barnwell County, SC",SC,2014,8637,7822,815,9.4,-96
"Barnwell County, SC",SC,2013,8733,7700,1033,11.8,-230
"Barnwell County, SC",SC,2012,8963,7744,1219,13.6,-274
"Barnwell County, SC",SC,2011,9237,7848,1389,15.0,-345
"Barnwell County, SC",SC,2010,9582,7969,1613,16.8,0
"Barranquitas Municipio, PR",PR,2021,7712,7066,646,8.4,
"Barranquitas Municipio, PR",PR,2020,N.A.,N.A.,N.A.,N.A.,
"Barranquitas Municipio, PR",PR,2019,7418,6777,641,8.6,58
"Barranquitas Municipio, PR",PR,2018,7360,6612,748,10.2,-12
"Barranquitas Municipio, PR",PR,2017,7372,6535,837,11.4,-108
"Barranquitas Municipio, PR",PR,2016,7480,6521,959,12.8,58
"Barranquitas Municipio, PR",PR,2015,7422,6439,983,13.2,-118
"Barranquitas Municipio, PR",PR,2014,7540,6357,1183,15.7,-185
"Barranquitas Municipio, PR",PR,2013,7725,6527,1198,15.5,-138
"Barranquitas Municipio, PR",PR,2012,7863,6589,1274,16.2,-89
"Barranquitas Municipio, PR",PR,2011,7952,6574,1378,17.3,-185
"Barranquitas Municipio, PR",PR,2010,8137,6694,1443,17.7,0
"Barren County, KY",KY,2021,18032,17073,959,5.3,-41
"Barren County, KY",KY,2020,18073,16752,1321,7.3,-759
"Barren County, KY",KY,2019,18832,18028,804,4.3,-196
"Barren County, KY",KY,2018,19028,18206,822,4.3,14
"Barren County, KY",KY,2017,19014,18153,861,4.5,155
"Barren County, KY",KY,2016,18859,17985,874,4.6,430
"Barren County, KY",KY,2015,18429,17486,943,5.1,-296
"Barren County, KY",KY,2014,18725,17554,1171,6.3,-854
"Barren County, KY",KY,2013,19579,18088,1491,7.6,-263
"Barren County, KY",KY,2012,19842,18273,1569,7.9,-97
"Barren County, KY",KY,2011,19939,17991,1948,9.8,86
"Barren County, KY",KY,2010,19853,17613,2240,11.3,0
"Barron County, WI",WI,2021,24374,23434,940,3.9,204
"Barron County, WI",WI,2020,24170,22692,1478,6.1,-309
"Barron County, WI",WI,2019,24479,23554,925,3.8,-512
"Barron County, WI",WI,2018,24991,24157,834,3.3,217
"Barron County, WI",WI,2017,24774,23916,858,3.5,497
"Barron County, WI",WI,2016,24277,23203,1074,4.4,-119
"Barron County, WI",WI,2015,24396,23207,1189,4.9,353
"Barron County, WI",WI,2014,24043,22676,1367,5.7,410
"Barron County, WI",WI,2013,23633,21874,1759,7.4,-46
"Barron County, WI",WI,2012,23679,21838,1841,7.8,-11
"Barron County, WI",WI,2011,23690,21730,1960,8.3,-111
"Barron County, WI",WI,2010,23801,21635,2166,9.1,0
"Barrow County, GA",GA,2021,42115,40882,1233,2.9,1269
"Barrow County, GA",GA,2020,40846,38791,2055,5.0,-485
"Barrow County, GA",GA,2019,41331,40107,1224,3.0,1110
"Barrow County, GA",GA,2018,40221,38878,1343,3.3,644
"Barrow County, GA",GA,2017,39577,37959,1618,4.1,1878
"Barrow County, GA",GA,2016,37699,35894,1805,4.8,1995
"Barrow County, GA",GA,2015,35704,33793,1911,5.4,573
"Barrow County, GA",GA,2014,35131,32915,2216,6.3,493
"Barrow County, GA",GA,2013,34638,32095,2543,7.3,193
"Barrow County, GA",GA,2012,34445,31517,2928,8.5,-105
"Barrow County, GA",GA,2011,34550,31141,3409,9.9,-228
"Barrow County, GA",GA,2010,34778,30977,3801,10.9,0
"Barry County, MI",MI,2021,30851,29443,1408,4.6,-543
"Barry County, MI",MI,2020,31394,28982,2412,7.7,-481
"Barry County, MI",MI,2019,31875,30822,1053,3.3,185
"Barry County, MI",MI,2018,31690,30599,1091,3.4,399
"Barry County, MI",MI,2017,31291,30077,1214,3.9,462
"Barry County, MI",MI,2016,30829,29584,1245,4.0,469
"Barry County, MI",MI,2015,30360,29042,1318,4.3,345
"Barry County, MI",MI,2014,30015,28388,1627,5.4,651
"Barry County, MI",MI,2013,29364,27508,1856,6.3,292
"Barry County, MI",MI,2012,29072,27107,1965,6.8,236
"Barry County, MI",MI,2011,28836,26577,2259,7.8,-262
"Barry County, MI",MI,2010,29098,26171,2927,10.1,0
"Barry County, MO",MO,2021,15094,14406,688,4.6,-548
"Barry County, MO",MO,2020,15642,14628,1014,6.5,167
"Barry County, MO",MO,2019,15475,14964,511,3.3,-112
"Barry County, MO",MO,2018,15587,15133,454,2.9,126
"Barry County, MO",MO,2017,15461,14946,515,3.3,286
"Barry County, MO",MO,2016,15175,14495,680,4.5,353
"Barry County, MO",MO,2015,14822,14066,756,5.1,69
"Barry County, MO",MO,2014,14753,13843,910,6.2,-107
"Barry County, MO",MO,2013,14860,13837,1023,6.9,-165
"Barry County, MO",MO,2012,15025,13928,1097,7.3,-166
"Barry County, MO",MO,2011,15191,13802,1389,9.1,-358
"Barry County, MO",MO,2010,15549,14059,1490,9.6,0
"Bartholomew County, IN",IN,2021,42821,41594,1227,2.9,-852
"Bartholomew County, IN",IN,2020,43673,40792,2881,6.6,-1555
"Bartholomew County, IN",IN,2019,45228,44108,1120,2.5,47
"Bartholomew County, IN",IN,2018,45181,44002,1179,2.6,674
"Bartholomew County, IN",IN,2017,44507,43301,1206,2.7,10
"Bartholomew County, IN",IN,2016,44497,43010,1487,3.3,918
"Bartholomew County, IN",IN,2015,43579,42013,1566,3.6,950
"Bartholomew County, IN",IN,2014,42629,40766,1863,4.4,959
"Bartholomew County, IN",IN,2013,41670,39227,2443,5.9,213
"Bartholomew County, IN",IN,2012,41457,38847,2610,6.3,1334
"Bartholomew County, IN",IN,2011,40123,37140,2983,7.4,1717
"Bartholomew County, IN",IN,2010,38406,34840,3566,9.3,0
"Barton County, KS",KS,2021,13371,12983,388,2.9,-267
"Barton County, KS",KS,2020,13638,13032,606,4.4,-69
"Barton County, KS",KS,2019,13707,13288,419,3.1,105
"Barton County, KS",KS,2018,13602,13173,429,3.2,-530
"Barton County, KS",KS,2017,14132,13624,508,3.6,45
"Barton County, KS",KS,2016,14087,13457,630,4.5,-542
"Barton County, KS",KS,2015,14629,14013,616,4.2,-853
"Barton County, KS",KS,2014,15482,14936,546,3.5,349
"Barton County, KS",KS,2013,15133,14519,614,4.1,113
"Barton County, KS",KS,2012,15020,14345,675,4.5,-90
"Barton County, KS",KS,2011,15110,14335,775,5.1,108
"Barton County, KS",KS,2010,15002,14113,889,5.9,0
"Barton County, MO",MO,2021,5190,5014,176,3.4,36
"Barton County, MO",MO,2020,5154,4903,251,4.9,7
"Barton County, MO",MO,2019,5147,4982,165,3.2,-23
"Barton County, MO",MO,2018,5170,5013,157,3.0,-26
"Barton County, MO",MO,2017,5196,4981,215,4.1,-117
"Barton County, MO",MO,2016,5313,5036,277,5.2,18
"Barton County, MO",MO,2015,5295,5003,292,5.5,-171
"Barton County, MO",MO,2014,5466,5121,345,6.3,-8
"Barton County, MO",MO,2013,5474,5078,396,7.2,-33
"Barton County, MO",MO,2012,5507,5085,422,7.7,-102
"Barton County, MO",MO,2011,5609,5106,503,9.0,-123
"Barton County, MO",MO,2010,5732,5146,586,10.2,0
"Bartow County, GA",GA,2021,51257,49456,1801,3.5,1239
"Bartow County, GA",GA,2020,50018,46932,3086,6.2,-854
"Bartow County, GA",GA,2019,50872,49108,1764,3.5,504
"Bartow County, GA",GA,2018,50368,48427,1941,3.9,317
"Bartow County, GA",GA,2017,50051,47718,2333,4.7,1857
"Bartow County, GA",GA,2016,48194,45690,2504,5.2,1872
"Bartow County, GA",GA,2015,46322,43548,2774,6.0,-217
"Bartow County, GA",GA,2014,46539,43190,3349,7.2,-452
"Bartow County, GA",GA,2013,46991,42946,4045,8.6,-263
"Bartow County, GA",GA,2012,47254,42631,4623,9.8,-402
"Bartow County, GA",GA,2011,47656,42235,5421,11.4,-323
"Bartow County, GA",GA,2010,47979,42059,5920,12.3,0
"Bastrop County, TX",TX,2021,45101,43084,2017,4.5,2668
"Bastrop County, TX",TX,2020,42433,39877,2556,6.0,248
"Bastrop County, TX",TX,2019,42185,40894,1291,3.1,915
"Bastrop County, TX",TX,2018,41270,39866,1404,3.4,1375
"Bastrop County, TX",TX,2017,39895,38452,1443,3.6,849
"Bastrop County, TX",TX,2016,39046,37583,1463,3.7,1493
"Bastrop County, TX",TX,2015,37553,36083,1470,3.9,893
"Bastrop County, TX",TX,2014,36660,34852,1808,4.9,823
"Bastrop County, TX",TX,2013,35837,33615,2222,6.2,621
"Bastrop County, TX",TX,2012,35216,32878,2338,6.6,-489
"Bastrop County, TX",TX,2011,35705,32781,2924,8.2,367
"Bastrop County, TX",TX,2010,35338,32413,2925,8.3,0
"Bates County, MO",MO,2021,7647,7322,325,4.3,52
"Bates County, MO",MO,2020,7595,7191,404,5.3,-149
"Bates County, MO",MO,2019,7744,7445,299,3.9,-99
"Bates County, MO",MO,2018,7843,7544,299,3.8,-121
"Bates County, MO",MO,2017,7964,7610,354,4.4,-182
"Bates County, MO",MO,2016,8146,7711,435,5.3,43
"Bates County, MO",MO,2015,8103,7601,502,6.2,34
"Bates County, MO",MO,2014,8069,7496,573,7.1,91
"Bates County, MO",MO,2013,7978,7363,615,7.7,-152
"Bates County, MO",MO,2012,8130,7440,690,8.5,-216
"Bates County, MO",MO,2011,8346,7489,857,10.3,-11
"Bates County, MO",MO,2010,8357,7447,910,10.9,0
"Bath County, KY",KY,2021,4632,4365,267,5.8,95
"Bath County, KY",KY,2020,4537,4172,365,8.0,-115
"Bath County, KY",KY,2019,4652,4379,273,5.9,46
"Bath County, KY",KY,2018,4606,4302,304,6.6,-115
"Bath County, KY",KY,2017,4721,4355,366,7.8,-37
"Bath County, KY",KY,2016,4758,4412,346,7.3,74
"Bath County, KY",KY,2015,4684,4327,357,7.6,-38
"Bath County, KY",KY,2014,4722,4304,418,8.9,-107
"Bath County, KY",KY,2013,4829,4335,494,10.2,-65
"Bath County, KY",KY,2012,4894,4382,512,10.5,48
"Bath County, KY",KY,2011,4846,4236,610,12.6,-68
"Bath County, KY",KY,2010,4914,4189,725,14.8,0
"Bath County, VA",VA,2021,2219,2118,101,4.6,-90
"Bath County, VA",VA,2020,2309,2080,229,9.9,-196
"Bath County, VA",VA,2019,2505,2445,60,2.4,-34
"Bath County, VA",VA,2018,2539,2477,62,2.4,-46
"Bath County, VA",VA,2017,2585,2508,77,3.0,86
"Bath County, VA",VA,2016,2499,2408,91,3.6,-47
"Bath County, VA",VA,2015,2546,2444,102,4.0,-56
"Bath County, VA",VA,2014,2602,2488,114,4.4,24
"Bath County, VA",VA,2013,2578,2445,133,5.2,-4
"Bath County, VA",VA,2012,2582,2435,147,5.7,10
"Bath County, VA",VA,2011,2572,2410,162,6.3,59
"Bath County, VA",VA,2010,2513,2319,194,7.7,0
"Baxter County, AR",AR,2021,16287,15681,606,3.7,-289
"Baxter County, AR",AR,2020,16576,15584,992,6.0,246
"Baxter County, AR",AR,2019,16330,15690,640,3.9,-48
"Baxter County, AR",AR,2018,16378,15712,666,4.1,14
"Baxter County, AR",AR,2017,16364,15663,701,4.3,234
"Baxter County, AR",AR,2016,16130,15435,695,4.3,-158
"Baxter County, AR",AR,2015,16288,15407,881,5.4,184
"Baxter County, AR",AR,2014,16104,15052,1052,6.5,-54
"Baxter County, AR",AR,2013,16158,14890,1268,7.8,-288
"Baxter County, AR",AR,2012,16446,15116,1330,8.1,-77
"Baxter County, AR",AR,2011,16523,15057,1466,8.9,-73
"Baxter County, AR",AR,2010,16596,15088,1508,9.1,0
"Bay County, FL",FL,2021,85937,82604,3333,3.9,3257
"Bay County, FL",FL,2020,82680,77353,5327,6.4,-1092
"Bay County, FL",FL,2019,83772,80572,3200,3.8,-3548
"Bay County, FL",FL,2018,87320,83677,3643,4.2,-227
"Bay County, FL",FL,2017,87547,83855,3692,4.2,-662
"Bay County, FL",FL,2016,88209,83963,4246,4.8,325
"Bay County, FL",FL,2015,87884,83026,4858,5.5,458
"Bay County, FL",FL,2014,87426,81720,5706,6.5,1216
"Bay County, FL",FL,2013,86210,79650,6560,7.6,56
"Bay County, FL",FL,2012,86154,78467,7687,8.9,-573
"Bay County, FL",FL,2011,86727,77872,8855,10.2,1361
"Bay County, FL",FL,2010,85366,76683,8683,10.2,0
"Bay County, MI",MI,2021,47921,45003,2918,6.1,-1434
"Bay County, MI",MI,2020,49355,44622,4733,9.6,-840
"Bay County, MI",MI,2019,50195,47819,2376,4.7,-227
"Bay County, MI",MI,2018,50422,47988,2434,4.8,-522
"Bay County, MI",MI,2017,50944,48167,2777,5.5,-1095
"Bay County, MI",MI,2016,52039,49168,2871,5.5,-425
"Bay County, MI",MI,2015,52464,49397,3067,5.8,-768
"Bay County, MI",MI,2014,53232,49393,3839,7.2,15
"Bay County, MI",MI,2013,53217,48622,4595,8.6,160
"Bay County, MI",MI,2012,53057,48478,4579,8.6,-143
"Bay County, MI",MI,2011,53200,48174,5026,9.4,-952
"Bay County, MI",MI,2010,54152,48078,6074,11.2,0
"Bayamon Municipio, PR",PR,2021,69864,64650,5214,7.5,
"Bayamon Municipio, PR",PR,2020,N.A.,N.A.,N.A.,N.A.,
"Bayamon Municipio, PR",PR,2019,64580,60515,4065,6.3,400
"Bayamon Municipio, PR",PR,2018,64180,59816,4364,6.8,-666
"Bayamon Municipio, PR",PR,2017,64846,59877,4969,7.7,-1510
"Bayamon Municipio, PR",PR,2016,66356,60399,5957,9.0,-999
"Bayamon Municipio, PR",PR,2015,67355,61093,6262,9.3,-407
"Bayamon Municipio, PR",PR,2014,67762,60786,6976,10.3,-1891
"Bayamon Municipio, PR",PR,2013,69653,62613,7040,10.1,-2455
"Bayamon Municipio, PR",PR,2012,72108,64165,7943,11.0,-1689
"Bayamon Municipio, PR",PR,2011,73797,64479,9318,12.6,-3016
"Bayamon Municipio, PR",PR,2010,76813,66891,9922,12.9,0
"Bayfield County, WI",WI,2021,7606,7169,437,5.7,37
"Bayfield County, WI",WI,2020,7569,6871,698,9.2,-22
"Bayfield County, WI",WI,2019,7591,7187,404,5.3,-6
"Bayfield County, WI",WI,2018,7597,7230,367,4.8,-5
"Bayfield County, WI",WI,2017,7602,7211,391,5.1,95
"Bayfield County, WI",WI,2016,7507,7003,504,6.7,2
"Bayfield County, WI",WI,2015,7505,6894,611,8.1,-23
"Bayfield County, WI",WI,2014,7528,6817,711,9.4,-225
"Bayfield County, WI",WI,2013,7753,6908,845,10.9,-28
"Bayfield County, WI",WI,2012,7781,6955,826,10.6,61
"Bayfield County, WI",WI,2011,7720,6909,811,10.5,33
"Bayfield County, WI",WI,2010,7687,6852,835,10.9,0
"Baylor County, TX",TX,2021,1816,1755,61,3.4,60
"Baylor County, TX",TX,2020,1756,1696,60,3.4,25
"Baylor County, TX",TX,2019,1731,1692,39,2.3,191
"Baylor County, TX",TX,2018,1540,1491,49,3.2,-37
"Baylor County, TX",TX,2017,1577,1523,54,3.4,-29
"Baylor County, TX",TX,2016,1606,1548,58,3.6,-22
"Baylor County, TX",TX,2015,1628,1570,58,3.6,-22
"Baylor County, TX",TX,2014,1650,1579,71,4.3,-19
"Baylor County, TX",TX,2013,1669,1580,89,5.3,-193
"Baylor County, TX",TX,2012,1862,1767,95,5.1,1
"Baylor County, TX",TX,2011,1861,1746,115,6.2,125
"Baylor County, TX",TX,2010,1736,1613,123,7.1,0
"Beadle County, SD",SD,2021,9240,8978,262,2.8,-66
"Beadle County, SD",SD,2020,9306,8971,335,3.6,-223
"Beadle County, SD",SD,2019,9529,9274,255,2.7,10
"Beadle County, SD",SD,2018,9519,9286,233,2.4,144
"Beadle County, SD",SD,2017,9375,9129,246,2.6,-84
"Beadle County, SD",SD,2016,9459,9213,246,2.6,-72
"Beadle County, SD",SD,2015,9531,9284,247,2.6,46
"Beadle County, SD",SD,2014,9485,9198,287,3.0,-57
"Beadle County, SD",SD,2013,9542,9208,334,3.5,-129
"Beadle County, SD",SD,2012,9671,9353,318,3.3,77
"Beadle County, SD",SD,2011,9594,9241,353,3.7,117
"Beadle County, SD",SD,2010,9477,9086,391,4.1,0
"Bear Lake County, ID",ID,2021,3121,3027,94,3.0,33
"Bear Lake County, ID",ID,2020,3088,2956,132,4.3,89
"Bear Lake County, ID",ID,2019,2999,2910,89,3.0,126
"Bear Lake County, ID",ID,2018,2873,2790,83,2.9,24
"Bear Lake County, ID",ID,2017,2849,2758,91,3.2,41
"Bear Lake County, ID",ID,2016,2808,2684,124,4.4,-24
"Bear Lake County, ID",ID,2015,2832,2714,118,4.2,-18
"Bear Lake County, ID",ID,2014,2850,2733,117,4.1,-55
"Bear Lake County, ID",ID,2013,2905,2739,166,5.7,14
"Bear Lake County, ID",ID,2012,2891,2726,165,5.7,-28
"Bear Lake County, ID",ID,2011,2919,2745,174,6.0,32
"Bear Lake County, ID",ID,2010,2887,2679,208,7.2,0
"Beaufort County, NC",NC,2021,19472,18537,935,4.8,631
"Beaufort County, NC",NC,2020,18841,17684,1157,6.1,-543
"Beaufort County, NC",NC,2019,19384,18512,872,4.5,-21
"Beaufort County, NC",NC,2018,19405,18499,906,4.7,-303
"Beaufort County, NC",NC,2017,19708,18712,996,5.1,-536
"Beaufort County, NC",NC,2016,20244,19091,1153,5.7,150
"Beaufort County, NC",NC,2015,20094,18786,1308,6.5,7
"Beaufort County, NC",NC,2014,20087,18653,1434,7.1,-396
"Beaufort County, NC",NC,2013,20483,18592,1891,9.2,-754
"Beaufort County, NC",NC,2012,21237,18934,2303,10.8,-355
"Beaufort County, NC",NC,2011,21592,19189,2403,11.1,340
"Beaufort County, NC",NC,2010,21252,18783,2469,11.6,0
"Beaufort County, SC",SC,2021,76131,73502,2629,3.5,1442
"Beaufort County, SC",SC,2020,74689,70743,3946,5.3,-1057
"Beaufort County, SC",SC,2019,75746,73756,1990,2.6,1505
"Beaufort County, SC",SC,2018,74241,71877,2364,3.2,1466
"Beaufort County, SC",SC,2017,72775,69863,2912,4.0,481
"Beaufort County, SC",SC,2016,72294,68914,3380,4.7,681
"Beaufort County, SC",SC,2015,71613,67743,3870,5.4,2183
"Beaufort County, SC",SC,2014,69430,65598,3832,5.5,1958
"Beaufort County, SC",SC,2013,67472,63279,4193,6.2,1429
"Beaufort County, SC",SC,2012,66043,61164,4879,7.4,278
"Beaufort County, SC",SC,2011,65765,60131,5634,8.6,-116
"Beaufort County, SC",SC,2010,65881,60100,5781,8.8,0
"Beauregard Parish, LA",LA,2021,14628,14030,598,4.1,241
"Beauregard Parish, LA",LA,2020,14387,13355,1032,7.2,-299
"Beauregard Parish, LA",LA,2019,14686,13948,738,5.0,57
"Beauregard Parish, LA",LA,2018,14629,13860,769,5.3,-62
"Beauregard Parish, LA",LA,2017,14691,13906,785,5.3,-392
"Beauregard Parish, LA",LA,2016,15083,14169,914,6.1,-49
"Beauregard Parish, LA",LA,2015,15132,14179,953,6.3,399
"Beauregard Parish, LA",LA,2014,14733,13752,981,6.7,289
"Beauregard Parish, LA",LA,2013,14444,13423,1021,7.1,-31
"Beauregard Parish, LA",LA,2012,14475,13434,1041,7.2,161
"Beauregard Parish, LA",LA,2011,14314,13201,1113,7.8,-260
"Beauregard Parish, LA",LA,2010,14574,13484,1090,7.5,0
"Beaver County, OK",OK,2021,2625,2580,45,1.7,55
"Beaver County, OK",OK,2020,2570,2501,69,2.7,-290
"Beaver County, OK",OK,2019,2860,2805,55,1.9,-147
"Beaver County, OK",OK,2018,3007,2949,58,1.9,-19
"Beaver County, OK",OK,2017,3026,2952,74,2.4,141
"Beaver County, OK",OK,2016,2885,2798,87,3.0,-138
"Beaver County, OK",OK,2015,3023,2943,80,2.6,-75
"Beaver County, OK",OK,2014,3098,3015,83,2.7,75
"Beaver County, OK",OK,2013,3023,2924,99,3.3,-92
"Beaver County, OK",OK,2012,3115,3025,90,2.9,169
"Beaver County, OK",OK,2011,2946,2845,101,3.4,57
"Beaver County, OK",OK,2010,2889,2779,110,3.8,0
"Beaver County, PA",PA,2021,81745,75860,5885,7.2,-1943
"Beaver County, PA",PA,2020,83688,75060,8628,10.3,-1111
"Beaver County, PA",PA,2019,84799,80859,3940,4.6,273
"Beaver County, PA",PA,2018,84526,80523,4003,4.7,-715
"Beaver County, PA",PA,2017,85241,80434,4807,5.6,-202
"Beaver County, PA",PA,2016,85443,80207,5236,6.1,-393
"Beaver County, PA",PA,2015,85836,80545,5291,6.2,-7
"Beaver County, PA",PA,2014,85843,80212,5631,6.6,-406
"Beaver County, PA",PA,2013,86249,80214,6035,7.0,-464
"Beaver County, PA",PA,2012,86713,80320,6393,7.4,959
"Beaver County, PA",PA,2011,85754,79183,6571,7.7,405
"Beaver County, PA",PA,2010,85349,78228,7121,8.3,0
"Beaver County, UT",UT,2021,2826,2746,80,2.8,-12
"Beaver County, UT",UT,2020,2838,2724,114,4.0,-57
"Beaver County, UT",UT,2019,2895,2809,86,3.0,-137
"Beaver County, UT",UT,2018,3032,2931,101,3.3,-21
"Beaver County, UT",UT,2017,3053,2933,120,3.9,-12
"Beaver County, UT",UT,2016,3065,2918,147,4.8,-35
"Beaver County, UT",UT,2015,3100,2985,115,3.7,160
"Beaver County, UT",UT,2014,2940,2827,113,3.8,-39
"Beaver County, UT",UT,2013,2979,2851,128,4.3,132
"Beaver County, UT",UT,2012,2847,2694,153,5.4,-179
"Beaver County, UT",UT,2011,3026,2772,254,8.4,-119
"Beaver County, UT",UT,2010,3145,2827,318,10.1,0
"Beaverhead County, MT",MT,2021,5141,4999,142,2.8,53
"Beaverhead County, MT",MT,2020,5088,4888,200,3.9,-92
"Beaverhead County, MT",MT,2019,5180,5025,155,3.0,100
"Beaverhead County, MT",MT,2018,5080,4921,159,3.1,1
"Beaverhead County, MT",MT,2017,5079,4919,160,3.2,11
"Beaverhead County, MT",MT,2016,5068,4894,174,3.4,86
"Beaverhead County, MT",MT,2015,4982,4806,176,3.5,113
"Beaverhead County, MT",MT,2014,4869,4689,180,3.7,24
"Beaverhead County, MT",MT,2013,4845,4619,226,4.7,-63
"Beaverhead County, MT",MT,2012,4908,4651,257,5.2,-25
"Beaverhead County, MT",MT,2011,4933,4646,287,5.8,-81
"Beaverhead County, MT",MT,2010,5014,4721,293,5.8,0
"Becker County, MN",MN,2021,18683,18057,626,3.4,-354
"Becker County, MN",MN,2020,19037,17812,1225,6.4,29
"Becker County, MN",MN,2019,19008,18211,797,4.2,309
"Becker County, MN",MN,2018,18699,17986,713,3.8,49
"Becker County, MN",MN,2017,18650,17864,786,4.2,103
"Becker County, MN",MN,2016,18547,17699,848,4.6,102
"Becker County, MN",MN,2015,18445,17621,824,4.5,426
"Becker County, MN",MN,2014,18019,17140,879,4.9,30
"Becker County, MN",MN,2013,17989,16988,1001,5.6,95
"Becker County, MN",MN,2012,17894,16848,1046,5.8,141
"Becker County, MN",MN,2011,17753,16481,1272,7.2,139
"Becker County, MN",MN,2010,17614,16218,1396,7.9,0
"Beckham County, OK",OK,2021,9706,9286,420,4.3,-236
"Beckham County, OK",OK,2020,9942,9179,763,7.7,-497
"Beckham County, OK",OK,2019,10439,10126,313,3.0,-936
"Beckham County, OK",OK,2018,11375,11093,282,2.5,121
"Beckham County, OK",OK,2017,11254,10842,412,3.7,243
"Beckham County, OK",OK,2016,11011,10246,765,6.9,-1190
"Beckham County, OK",OK,2015,12201,11594,607,5.0,-554
"Beckham County, OK",OK,2014,12755,12408,347,2.7,173
"Beckham County, OK",OK,2013,12582,12181,401,3.2,75
"Beckham County, OK",OK,2012,12507,12140,367,2.9,1194
"Beckham County, OK",OK,2011,11313,10916,397,3.5,983
"Beckham County, OK",OK,2010,10330,9757,573,5.5,0
"Bedford County, PA",PA,2021,23723,22317,1406,5.9,-227
"Bedford County, PA",PA,2020,23950,21791,2159,9.0,70
"Bedford County, PA",PA,2019,23880,22732,1148,4.8,-44
"Bedford County, PA",PA,2018,23924,22808,1116,4.7,-59
"Bedford County, PA",PA,2017,23983,22722,1261,5.3,-99
"Bedford County, PA",PA,2016,24082,22687,1395,5.8,-56
"Bedford County, PA",PA,2015,24138,22646,1492,6.2,-102
"Bedford County, PA",PA,2014,24240,22618,1622,6.7,-382
"Bedford County, PA",PA,2013,24622,22624,1998,8.1,-398
"Bedford County, PA",PA,2012,25020,22907,2113,8.4,110
"Bedford County, PA",PA,2011,24910,22697,2213,8.9,-363
"Bedford County, PA",PA,2010,25273,22800,2473,9.8,0
"Bedford County, TN",TN,2021,21191,20320,871,4.1,148
"Bedford County, TN",TN,2020,21043,19377,1666,7.9,-104
"Bedford County, TN",TN,2019,21147,20354,793,3.7,349
"Bedford County, TN",TN,2018,20798,20017,781,3.8,245
"Bedford County, TN",TN,2017,20553,19743,810,3.9,718
"Bedford County, TN",TN,2016,19835,18846,989,5.0,387
"Bedford County, TN",TN,2015,19448,18203,1245,6.4,-76
"Bedford County, TN",TN,2014,19524,18057,1467,7.5,-556
"Bedford County, TN",TN,2013,20080,18241,1839,9.2,-195
"Bedford County, TN",TN,2012,20275,18260,2015,9.9,-587
"Bedford County, TN",TN,2011,20862,18479,2383,11.4,-251
"Bedford County, TN",TN,2010,21113,18417,2696,12.8,0
"Bedford County, VA",VA,2021,37256,35981,1275,3.4,-964
"Bedford County, VA",VA,2020,38220,36284,1936,5.1,-995
"Bedford County, VA",VA,2019,39215,38109,1106,2.8,561
"Bedford County, VA",VA,2018,38654,37484,1170,3.0,196
"Bedford County, VA",VA,2017,38458,36985,1473,3.8,446
"Bedford County, VA",VA,2016,38012,36486,1526,4.0,-369
"Bedford County, VA",VA,2015,38381,36703,1678,4.4,-195
"Bedford County, VA",VA,2014,38576,36641,1935,5.0,334
"Bedford County, VA",VA,2013,38242,36114,2128,5.6,-25
"Bedford County, VA",VA,2012,38267,36030,2237,5.8,-492
"Bedford County, VA",VA,2011,38759,36258,2501,6.5,-348
"Bedford County, VA",VA,2010,39107,36284,2823,7.2,0
"Bee County, TX",TX,2021,9293,8484,809,8.7,-455
"Bee County, TX",TX,2020,9748,8781,967,9.9,40
"Bee County, TX",TX,2019,9708,9280,428,4.4,-138
"Bee County, TX",TX,2018,9846,9342,504,5.1,-52
"Bee County, TX",TX,2017,9898,9252,646,6.5,-416
"Bee County, TX",TX,2016,10314,9537,777,7.5,-72
"Bee County, TX",TX,2015,10386,9740,646,6.2,-334
"Bee County, TX",TX,2014,10720,10089,631,5.9,-578
"Bee County, TX",TX,2013,11298,10550,748,6.6,471
"Bee County, TX",TX,2012,10827,10070,757,7.0,234
"Bee County, TX",TX,2011,10593,9652,941,8.9,50
"Bee County, TX",TX,2010,10543,9592,951,9.0,0
"Belknap County, NH",NH,2021,31024,29882,1142,3.7,102
"Belknap County, NH",NH,2020,30922,28750,2172,7.0,-774
"Belknap County, NH",NH,2019,31696,30879,817,2.6,233
"Belknap County, NH",NH,2018,31463,30638,825,2.6,196
"Belknap County, NH",NH,2017,31267,30407,860,2.8,-160
"Belknap County, NH",NH,2016,31427,30536,891,2.8,-219
"Belknap County, NH",NH,2015,31646,30580,1066,3.4,-42
"Belknap County, NH",NH,2014,31688,30359,1329,4.2,-378
"Belknap County, NH",NH,2013,32066,30410,1656,5.2,25
"Belknap County, NH",NH,2012,32041,30321,1720,5.4,-28
"Belknap County, NH",NH,2011,32069,30286,1783,5.6,-252
"Belknap County, NH",NH,2010,32321,30166,2155,6.7,0
"Bell County, KY",KY,2021,8225,7756,469,5.7,41
"Bell County, KY",KY,2020,8184,7567,617,7.5,-216
"Bell County, KY",KY,2019,8400,7891,509,6.1,-73
"Bell County, KY",KY,2018,8473,7956,517,6.1,-188
"Bell County, KY",KY,2017,8661,7989,672,7.8,7
"Bell County, KY",KY,2016,8654,7869,785,9.1,-65
"Bell County, KY",KY,2015,8719,7979,740,8.5,-592
"Bell County, KY",KY,2014,9311,8375,936,10.1,-552
"Bell County, KY",KY,2013,9863,8561,1302,13.2,-413
"Bell County, KY",KY,2012,10276,9043,1233,12.0,62
"Bell County, KY",KY,2011,10214,9001,1213,11.9,-38
"Bell County, KY",KY,2010,10252,8996,1256,12.3,0
"Bell County, TX",TX,2021,147526,139057,8469,5.7,3823
"Bell County, TX",TX,2020,143703,133640,10063,7.0,1614
"Bell County, TX",TX,2019,142089,136616,5473,3.9,852
"Bell County, TX",TX,2018,141237,135339,5898,4.2,174
"Bell County, TX",TX,2017,141063,135005,6058,4.3,1502
"Bell County, TX",TX,2016,139561,133264,6297,4.5,3221
"Bell County, TX",TX,2015,136340,129940,6400,4.7,1620
"Bell County, TX",TX,2014,134720,126763,7957,5.9,-358
"Bell County, TX",TX,2013,135078,125664,9414,7.0,1277
"Bell County, TX",TX,2012,133801,123945,9856,7.4,371
"Bell County, TX",TX,2011,133430,122377,11053,8.3,1399
"Bell County, TX",TX,2010,132031,121787,10244,7.8,0
"Belmont County, OH",OH,2021,27892,26187,1705,6.1,-611
"Belmont County, OH",OH,2020,28503,25610,2893,10.1,-1711
"Belmont County, OH",OH,2019,30214,28500,1714,5.7,-475
"Belmont County, OH",OH,2018,30689,29013,1676,5.5,158
"Belmont County, OH",OH,2017,30531,28600,1931,6.3,-606
"Belmont County, OH",OH,2016,31137,28798,2339,7.5,-122
"Belmont County, OH",OH,2015,31259,29255,2004,6.4,-649
"Belmont County, OH",OH,2014,31908,29766,2142,6.7,-30
"Belmont County, OH",OH,2013,31938,29315,2623,8.2,195
"Belmont County, OH",OH,2012,31743,29129,2614,8.2,-455
"Belmont County, OH",OH,2011,32198,29125,3073,9.5,-1319
"Belmont County, OH",OH,2010,33517,29717,3800,11.3,0
"Beltrami County, MN",MN,2021,23933,23050,883,3.7,-1079
"Beltrami County, MN",MN,2020,25012,23386,1626,6.5,342
"Beltrami County, MN",MN,2019,24670,23551,1119,4.5,386
"Beltrami County, MN",MN,2018,24284,23218,1066,4.4,518
"Beltrami County, MN",MN,2017,23766,22597,1169,4.9,104
"Beltrami County, MN",MN,2016,23662,22427,1235,5.2,97
"Beltrami County, MN",MN,2015,23565,22384,1181,5.0,196
"Beltrami County, MN",MN,2014,23369,22096,1273,5.4,314
"Beltrami County, MN",MN,2013,23055,21593,1462,6.3,183
"Beltrami County, MN",MN,2012,22872,21261,1611,7.0,329
"Beltrami County, MN",MN,2011,22543,20688,1855,8.2,-66
"Beltrami County, MN",MN,2010,22609,20748,1861,8.2,0
"Ben Hill County, GA",GA,2021,5568,5276,292,5.2,73
"Ben Hill County, GA",GA,2020,5495,5120,375,6.8,30
"Ben Hill County, GA",GA,2019,5465,5156,309,5.7,-33
"Ben Hill County, GA",GA,2018,5498,5171,327,5.9,-25
"Ben Hill County, GA",GA,2017,5523,5091,432,7.8,-27
"Ben Hill County, GA",GA,2016,5550,5089,461,8.3,132
"Ben Hill County, GA",GA,2015,5418,4922,496,9.2,-171
"Ben Hill County, GA",GA,2014,5589,5028,561,10.0,-178
"Ben Hill County, GA",GA,2013,5767,5052,715,12.4,-389
"Ben Hill County, GA",GA,2012,6156,5310,846,13.7,-81
"Ben Hill County, GA",GA,2011,6237,5273,964,15.5,-301
"Ben Hill County, GA",GA,2010,6538,5488,1050,16.1,0
"Benewah County, ID",ID,2021,4092,3864,228,5.6,-72
"Benewah County, ID",ID,2020,4164,3843,321,7.7,43
"Benewah County, ID",ID,2019,4121,3902,219,5.3,80
"Benewah County, ID",ID,2018,4041,3855,186,4.6,8
"Benewah County, ID",ID,2017,4033,3808,225,5.6,26
"Benewah County, ID",ID,2016,4007,3778,229,5.7,-24
"Benewah County, ID",ID,2015,4031,3786,245,6.1,91
"Benewah County, ID",ID,2014,3940,3649,291,7.4,-103
"Benewah County, ID",ID,2013,4043,3593,450,11.1,-137
"Benewah County, ID",ID,2012,4180,3660,520,12.4,40
"Benewah County, ID",ID,2011,4140,3601,539,13.0,-68
"Benewah County, ID",ID,2010,4208,3649,559,13.3,0
"Bennett County, SD",SD,2021,1054,1009,45,4.3,-16
"Bennett County, SD",SD,2020,1070,1019,51,4.8,0
"Bennett County, SD",SD,2019,1070,1020,50,4.7,-2
"Bennett County, SD",SD,2018,1072,1028,44,4.1,-38
"Bennett County, SD",SD,2017,1110,1065,45,4.1,-19
"Bennett County, SD",SD,2016,1129,1084,45,4.0,-8
"Bennett County, SD",SD,2015,1137,1081,56,4.9,-5
"Bennett County, SD",SD,2014,1142,1081,61,5.3,0
"Bennett County, SD",SD,2013,1142,1071,71,6.2,-67
"Bennett County, SD",SD,2012,1209,1132,77,6.4,19
"Bennett County, SD",SD,2011,1190,1106,84,7.1,-11
"Bennett County, SD",SD,2010,1201,1115,86,7.2,0
"Bennington County, VT",VT,2021,16919,16189,730,4.3,-816
"Bennington County, VT",VT,2020,17735,16580,1155,6.5,-1087
"Bennington County, VT",VT,2019,18822,18279,543,2.9,-75
"Bennington County, VT",VT,2018,18897,18315,582,3.1,117
"Bennington County, VT",VT,2017,18780,18095,685,3.6,277
"Bennington County, VT",VT,2016,18503,17830,673,3.6,-168
"Bennington County, VT",VT,2015,18671,17891,780,4.2,-88
"Bennington County, VT",VT,2014,18759,17886,873,4.7,-501
"Bennington County, VT",VT,2013,19260,18254,1006,5.2,-348
"Bennington County, VT",VT,2012,19608,18484,1124,5.7,-325
"Bennington County, VT",VT,2011,19933,18643,1290,6.5,-426
"Bennington County, VT",VT,2010,20359,18896,1463,7.2,0
"Benson County, ND",ND,2021,2300,2186,114,5.0,-21
"Benson County, ND",ND,2020,2321,2163,158,6.8,-3
"Benson County, ND",ND,2019,2324,2236,88,3.8,-16
"Benson County, ND",ND,2018,2340,2257,83,3.5,-80
"Benson County, ND",ND,2017,2420,2333,87,3.6,-9
"Benson County, ND",ND,2016,2429,2332,97,4.0,-31
"Benson County, ND",ND,2015,2460,2347,113,4.6,-23
"Benson County, ND",ND,2014,2483,2326,157,6.3,-35
"Benson County, ND",ND,2013,2518,2328,190,7.5,-235
"Benson County, ND",ND,2012,2753,2569,184,6.7,-165
"Benson County, ND",ND,2011,2918,2748,170,5.8,-1
"Benson County, ND",ND,2010,2919,2765,154,5.3,0
"Bent County, CO",CO,2021,1886,1771,115,6.1,113
"Bent County, CO",CO,2020,1773,1700,73,4.1,-78
"Bent County, CO",CO,2019,1851,1802,49,2.6,-37
"Bent County, CO",CO,2018,1888,1831,57,3.0,-21
"Bent County, CO",CO,2017,1909,1860,49,2.6,58
"Bent County, CO",CO,2016,1851,1797,54,2.9,119
"Bent County, CO",CO,2015,1732,1666,66,3.8,81
"Bent County, CO",CO,2014,1651,1564,87,5.3,6
"Bent County, CO",CO,2013,1645,1520,125,7.6,-72
"Bent County, CO",CO,2012,1717,1571,146,8.5,-208
"Bent County, CO",CO,2011,1925,1760,165,8.6,-75
"Bent County, CO",CO,2010,2000,1829,171,8.6,0
"Benton County, AR",AR,2021,141991,137993,3998,2.8,476
"Benton County, AR",AR,2020,141515,135182,6333,4.5,2320
"Benton County, AR",AR,2019,139195,135616,3579,2.6,4592
"Benton County, AR",AR,2018,134603,130752,3851,2.9,2162
"Benton County, AR",AR,2017,132441,128502,3939,3.0,4311
"Benton County, AR",AR,2016,128130,124390,3740,2.9,5782
"Benton County, AR",AR,2015,122348,117802,4546,3.7,6008
"Benton County, AR",AR,2014,116340,111104,5236,4.5,3792
"Benton County, AR",AR,2013,112548,106367,6181,5.5,1250
"Benton County, AR",AR,2012,111298,104879,6419,5.8,2171
"Benton County, AR",AR,2011,109127,102361,6766,6.2,2075
"Benton County, AR",AR,2010,107052,100219,6833,6.4,0
"Benton County, IA",IA,2021,12847,12274,573,4.5,-69
"Benton County, IA",IA,2020,12916,12274,642,5.0,-886
"Benton County, IA",IA,2019,13802,13415,387,2.8,272
"Benton County, IA",IA,2018,13530,13163,367,2.7,47
"Benton County, IA",IA,2017,13483,13049,434,3.2,-183
"Benton County, IA",IA,2016,13666,13179,487,3.6,-103
"Benton County, IA",IA,2015,13769,13239,530,3.8,-93
"Benton County, IA",IA,2014,13862,13224,638,4.6,121
"Benton County, IA",IA,2013,13741,13042,699,5.1,-89
"Benton County, IA",IA,2012,13830,13093,737,5.3,-349
"Benton County, IA",IA,2011,14179,13343,836,5.9,-115
"Benton County, IA",IA,2010,14294,13395,899,6.3,0
"Benton County, IN",IN,2021,4199,4085,114,2.7,37
"Benton County, IN",IN,2020,4162,3938,224,5.4,-377
"Benton County, IN",IN,2019,4539,4396,143,3.2,-28
"Benton County, IN",IN,2018,4567,4421,146,3.2,71
"Benton County, IN",IN,2017,4496,4344,152,3.4,-74
"Benton County, IN",IN,2016,4570,4379,191,4.2,-8
"Benton County, IN",IN,2015,4578,4374,204,4.5,103
"Benton County, IN",IN,2014,4475,4233,242,5.4,6
"Benton County, IN",IN,2013,4469,4160,309,6.9,-85
"Benton County, IN",IN,2012,4554,4220,334,7.3,-100
"Benton County, IN",IN,2011,4654,4295,359,7.7,-10
"Benton County, IN",IN,2010,4664,4246,418,9.0,0
"Benton County, MN",MN,2021,21312,20405,907,4.3,-875
"Benton County, MN",MN,2020,22187,20675,1512,6.8,-27
"Benton County, MN",MN,2019,22214,21293,921,4.1,269
"Benton County, MN",MN,2018,21945,21127,818,3.7,109
"Benton County, MN",MN,2017,21836,20943,893,4.1,72
"Benton County, MN",MN,2016,21764,20803,961,4.4,120
"Benton County, MN",MN,2015,21644,20662,982,4.5,-119
"Benton County, MN",MN,2014,21763,20638,1125,5.2,300
"Benton County, MN",MN,2013,21463,20172,1291,6.0,239
"Benton County, MN",MN,2012,21224,19859,1365,6.4,-74
"Benton County, MN",MN,2011,21298,19681,1617,7.6,179
"Benton County, MN",MN,2010,21119,19273,1846,8.7,0
"Benton County, MO",MO,2021,7322,6905,417,5.7,110
"Benton County, MO",MO,2020,7212,6687,525,7.3,82
"Benton County, MO",MO,2019,7130,6803,327,4.6,-23
"Benton County, MO",MO,2018,7153,6834,319,4.5,-123
"Benton County, MO",MO,2017,7276,6906,370,5.1,26
"Benton County, MO",MO,2016,7250,6811,439,6.1,99
"Benton County, MO",MO,2015,7151,6675,476,6.7,-2
"Benton County, MO",MO,2014,7153,6593,560,7.8,-84
"Benton County, MO",MO,2013,7237,6616,621,8.6,135
"Benton County, MO",MO,2012,7102,6438,664,9.3,-96
"Benton County, MO",MO,2011,7198,6396,802,11.1,-62
"Benton County, MO",MO,2010,7260,6384,876,12.1,0
"Benton County, MS",MS,2021,3041,2846,195,6.4,50
"Benton County, MS",MS,2020,2991,2748,243,8.1,-63
"Benton County, MS",MS,2019,3054,2864,190,6.2,27
"Benton County, MS",MS,2018,3027,2853,174,5.7,-1
"Benton County, MS",MS,2017,3028,2854,174,5.7,-6
"Benton County, MS",MS,2016,3034,2826,208,6.9,58
"Benton County, MS",MS,2015,2976,2735,241,8.1,5
"Benton County, MS",MS,2014,2971,2690,281,9.5,-167
"Benton County, MS",MS,2013,3138,2811,327,10.4,-186
"Benton County, MS",MS,2012,3324,2978,346,10.4,-70
"Benton County, MS",MS,2011,3394,2984,410,12.1,116
"Benton County, MS",MS,2010,3278,2880,398,12.1,0
"Benton County, OR",OR,2021,47556,45683,1873,3.9,903
"Benton County, OR",OR,2020,46653,44036,2617,5.6,-772
"Benton County, OR",OR,2019,47425,46015,1410,3.0,-417
"Benton County, OR",OR,2018,47842,46370,1472,3.1,-148
"Benton County, OR",OR,2017,47990,46456,1534,3.2,1295
"Benton County, OR",OR,2016,46695,44891,1804,3.9,1216
"Benton County, OR",OR,2015,45479,43607,1872,4.1,851
"Benton County, OR",OR,2014,44628,42410,2218,5.0,431
"Benton County, OR",OR,2013,44197,41705,2492,5.6,-1027
"Benton County, OR",OR,2012,45224,42512,2712,6.0,-762
"Benton County, OR",OR,2011,45986,43019,2967,6.5,757
"Benton County, OR",OR,2010,45229,41990,3239,7.2,0
"Benton County, TN",TN,2021,6786,6462,324,4.8,4
"Benton County, TN",TN,2020,6782,6248,534,7.9,-144
"Benton County, TN",TN,2019,6926,6617,309,4.5,21
"Benton County, TN",TN,2018,6905,6568,337,4.9,179
"Benton County, TN",TN,2017,6726,6363,363,5.4,-18
"Benton County, TN",TN,2016,6744,6262,482,7.1,-34
"Benton County, TN",TN,2015,6778,6261,517,7.6,41
"Benton County, TN",TN,2014,6737,6144,593,8.8,-168
"Benton County, TN",TN,2013,6905,6232,673,9.7,-51
"Benton County, TN",TN,2012,6956,6262,694,10.0,-160
"Benton County, TN",TN,2011,7116,6294,822,11.6,-94
"Benton County, TN",TN,2010,7210,6308,902,12.5,0
"Benton County, WA",WA,2021,104773,98915,5858,5.6,-791
"Benton County, WA",WA,2020,105564,97191,8373,7.9,1411
"Benton County, WA",WA,2019,104153,98586,5567,5.3,4578
"Benton County, WA",WA,2018,99575,94389,5186,5.2,2182
"Benton County, WA",WA,2017,97393,92105,5288,5.4,3031
"Benton County, WA",WA,2016,94362,88504,5858,6.2,2629
"Benton County, WA",WA,2015,91733,85797,5936,6.5,1993
"Benton County, WA",WA,2014,89740,83220,6520,7.3,-434
"Benton County, WA",WA,2013,90174,82314,7860,8.7,-1437
"Benton County, WA",WA,2012,91611,83800,7811,8.5,-499
"Benton County, WA",WA,2011,92110,85344,6766,7.3,-454
"Benton County, WA",WA,2010,92564,85997,6567,7.1,0
"Benzie County, MI",MI,2021,8453,7949,504,6.0,-207
"Benzie County, MI",MI,2020,8660,7812,848,9.8,-179
"Benzie County, MI",MI,2019,8839,8381,458,5.2,44
"Benzie County, MI",MI,2018,8795,8307,488,5.5,-47
"Benzie County, MI",MI,2017,8842,8276,566,6.4,-22
"Benzie County, MI",MI,2016,8864,8276,588,6.6,145
"Benzie County, MI",MI,2015,8719,8103,616,7.1,-26
"Benzie County, MI",MI,2014,8745,7986,759,8.7,120
"Benzie County, MI",MI,2013,8625,7745,880,10.2,70
"Benzie County, MI",MI,2012,8555,7670,885,10.3,-112
"Benzie County, MI",MI,2011,8667,7664,1003,11.6,-203
"Benzie County, MI",MI,2010,8870,7712,1158,13.1,0
"Bergen County, NJ",NJ,2021,493303,463475,29828,6.0,-1180
"Bergen County, NJ",NJ,2020,494483,448791,45692,9.2,-7883
"Bergen County, NJ",NJ,2019,502366,488445,13921,2.8,8472
"Bergen County, NJ",NJ,2018,493894,477681,16213,3.3,934
"Bergen County, NJ",NJ,2017,492960,474208,18752,3.8,12044
"Bergen County, NJ",NJ,2016,480916,460970,19946,4.1,643
"Bergen County, NJ",NJ,2015,480273,457997,22276,4.6,1526
"Bergen County, NJ",NJ,2014,478747,452867,25880,5.4,-936
"Bergen County, NJ",NJ,2013,479683,446896,32787,6.8,-4457
"Bergen County, NJ",NJ,2012,484140,446819,37321,7.7,1888
"Bergen County, NJ",NJ,2011,482252,445121,37131,7.7,1888
"Bergen County, NJ",NJ,2010,480364,441308,39056,8.1,0
"Berkeley County, SC",SC,2021,107149,103265,3884,3.6,3076
"Berkeley County, SC",SC,2020,104073,98469,5604,5.4,692
"Berkeley County, SC",SC,2019,103381,100812,2569,2.5,4084
"Berkeley County, SC",SC,2018,99297,96329,2968,3.0,1506
"Berkeley County, SC",SC,2017,97791,94119,3672,3.8,1086
"Berkeley County, SC",SC,2016,96705,92384,4321,4.5,3274
"Berkeley County, SC",SC,2015,93431,88352,5079,5.4,2568
"Berkeley County, SC",SC,2014,90863,85561,5302,5.8,1683
"Berkeley County, SC",SC,2013,89180,83118,6062,6.8,624
"Berkeley County, SC",SC,2012,88556,81276,7280,8.2,2366
"Berkeley County, SC",SC,2011,86190,78035,8155,9.5,2735
"Berkeley County, SC",SC,2010,83455,74974,8481,10.2,0
"Berkeley County, WV",WV,2021,60140,57999,2141,3.6,2030
"Berkeley County, WV",WV,2020,58110,54586,3524,6.1,-938
"Berkeley County, WV",WV,2019,59048,56939,2109,3.6,1019
"Berkeley County, WV",WV,2018,58029,55703,2326,4.0,1497
"Berkeley County, WV",WV,2017,56532,54471,2061,3.6,2272
"Berkeley County, WV",WV,2016,54260,52110,2150,4.0,-318
"Berkeley County, WV",WV,2015,54578,51968,2610,4.8,1525
"Berkeley County, WV",WV,2014,53053,50199,2854,5.4,432
"Berkeley County, WV",WV,2013,52621,49687,2934,5.6,338
"Berkeley County, WV",WV,2012,52283,48918,3365,6.4,1112
"Berkeley County, WV",WV,2011,51171,47346,3825,7.5,213
"Berkeley County, WV",WV,2010,50958,46578,4380,8.6,0
"Berks County, PA",PA,2021,211376,197487,13889,6.6,-3591
"Berks County, PA",PA,2020,214967,194595,20372,9.5,-2980
"Berks County, PA",PA,2019,217947,208196,9751,4.5,2719
"Berks County, PA",PA,2018,215228,205903,9325,4.3,815
"Berks County, PA",PA,2017,214413,204385,10028,4.7,874
"Berks County, PA",PA,2016,213539,203031,10508,4.9,964
"Berks County, PA",PA,2015,212575,201893,10682,5.0,1810
"Berks County, PA",PA,2014,210765,199054,11711,5.6,158
"Berks County, PA",PA,2013,210607,196083,14524,6.9,-729
"Berks County, PA",PA,2012,211336,195497,15839,7.5,1683
"Berks County, PA",PA,2011,209653,193517,16136,7.7,176
"Berks County, PA",PA,2010,209477,191835,17642,8.4,0
"Berkshire County, MA",MA,2021,62666,58491,4175,6.7,296
"Berkshire County, MA",MA,2020,62370,56266,6104,9.8,-2477
"Berkshire County, MA",MA,2019,64847,62434,2413,3.7,-748
"Berkshire County, MA",MA,2018,65595,62827,2768,4.2,167
"Berkshire County, MA",MA,2017,65428,62468,2960,4.5,1032
"Berkshire County, MA",MA,2016,64396,61392,3004,4.7,-731
"Berkshire County, MA",MA,2015,65127,61612,3515,5.4,-494
"Berkshire County, MA",MA,2014,65621,61314,4307,6.6,0
"Berkshire County, MA",MA,2013,65621,60802,4819,7.3,-876
"Berkshire County, MA",MA,2012,66497,61587,4910,7.4,-489
"Berkshire County, MA",MA,2011,66986,61735,5251,7.8,-616
"Berkshire County, MA",MA,2010,67602,61862,5740,8.5,0
"Bernalillo County, NM",NM,2021,334378,313598,20780,6.2,5676
"Bernalillo County, NM",NM,2020,328702,303245,25457,7.7,-8201
"Bernalillo County, NM",NM,2019,336903,321688,15215,4.5,4459
"Bernalillo County, NM",NM,2018,332444,317570,14874,4.5,402
"Bernalillo County, NM",NM,2017,332042,314092,17950,5.4,2760
"Bernalillo County, NM",NM,2016,329282,309914,19368,5.9,4846
"Bernalillo County, NM",NM,2015,324436,305108,19328,6.0,2310
"Bernalillo County, NM",NM,2014,322126,302407,19719,6.1,587
"Bernalillo County, NM",NM,2013,321539,300844,20695,6.4,207
"Bernalillo County, NM",NM,2012,321332,300007,21325,6.6,-562
"Bernalillo County, NM",NM,2011,321894,299644,22250,6.9,-2248
"Bernalillo County, NM",NM,2010,324142,300114,24028,7.4,0
"Berrien County, GA",GA,2021,7648,7363,285,3.7,223
"Berrien County, GA",GA,2020,7425,7000,425,5.7,-176
"Berrien County, GA",GA,2019,7601,7283,318,4.2,110
"Berrien County, GA",GA,2018,7491,7174,317,4.2,29
"Berrien County, GA",GA,2017,7462,7077,385,5.2,242
"Berrien County, GA",GA,2016,7220,6772,448,6.2,254
"Berrien County, GA",GA,2015,6966,6458,508,7.3,-259
"Berrien County, GA",GA,2014,7225,6605,620,8.6,-175
"Berrien County, GA",GA,2013,7400,6698,702,9.5,-430
"Berrien County, GA",GA,2012,7830,7040,790,10.1,-20
"Berrien County, GA",GA,2011,7850,6879,971,12.4,-163
"Berrien County, GA",GA,2010,8013,6959,1054,13.2,0
"Berrien County, MI",MI,2021,69898,65843,4055,5.8,-2521
"Berrien County, MI",MI,2020,72419,65825,6594,9.1,-1570
"Berrien County, MI",MI,2019,73989,70966,3023,4.1,620
"Berrien County, MI",MI,2018,73369,70190,3179,4.3,-700
"Berrien County, MI",MI,2017,74069,70539,3530,4.8,65
"Berrien County, MI",MI,2016,74004,70297,3707,5.0,256
"Berrien County, MI",MI,2015,73748,69862,3886,5.3,198
"Berrien County, MI",MI,2014,73550,68569,4981,6.8,849
"Berrien County, MI",MI,2013,72701,66456,6245,8.6,-873
"Berrien County, MI",MI,2012,73574,67007,6567,8.9,-809
"Berrien County, MI",MI,2011,74383,67126,7257,9.8,-1515
"Berrien County, MI",MI,2010,75898,67041,8857,11.7,0
"Bertie County, NC",NC,2021,7203,6778,425,5.9,-174
"Bertie County, NC",NC,2020,7377,6922,455,6.2,-365
"Bertie County, NC",NC,2019,7742,7381,361,4.7,16
"Bertie County, NC",NC,2018,7726,7340,386,5.0,-240
"Bertie County, NC",NC,2017,7966,7495,471,5.9,-445
"Bertie County, NC",NC,2016,8411,7854,557,6.6,-181
"Bertie County, NC",NC,2015,8592,7979,613,7.1,74
"Bertie County, NC",NC,2014,8518,7865,653,7.7,48
"Bertie County, NC",NC,2013,8470,7641,829,9.8,-276
"Bertie County, NC",NC,2012,8746,7726,1020,11.7,-369
"Bertie County, NC",NC,2011,9115,8019,1096,12.0,-110
"Bertie County, NC",NC,2010,9225,8148,1077,11.7,0
"Bethel Census Area, AK",AK,2021,6956,6046,910,13.1,-31
"Bethel Census Area, AK",AK,2020,6987,6136,851,12.2,-99
"Bethel Census Area, AK",AK,2019,7086,6260,826,11.7,-45
"Bethel Census Area, AK",AK,2018,7131,6290,841,11.8,-192
"Bethel Census Area, AK",AK,2017,7323,6393,930,12.7,104
"Bethel Census Area, AK",AK,2016,7219,6230,989,13.7,-106
"Bethel Census Area, AK",AK,2015,7325,6304,1021,13.9,55
"Bethel Census Area, AK",AK,2014,7270,6120,1150,15.8,-120
"Bethel Census Area, AK",AK,2013,7390,6193,1197,16.2,197
"Bethel Census Area, AK",AK,2012,7193,6074,1119,15.6,-15
"Bethel Census Area, AK",AK,2011,7208,6104,1104,15.3,34
"Bethel Census Area, AK",AK,2010,7174,6091,1083,15.1,0
"Bexar County, TX",TX,2021,945855,895189,50666,5.4,18298
"Bexar County, TX",TX,2020,927557,856813,70744,7.6,-4622
"Bexar County, TX",TX,2019,932179,902782,29397,3.2,4996
"Bexar County, TX",TX,2018,927183,895880,31303,3.4,9860
"Bexar County, TX",TX,2017,917323,884586,32737,3.6,11477
"Bexar County, TX",TX,2016,905846,871855,33991,3.8,26683
"Bexar County, TX",TX,2015,879163,845395,33768,3.8,14013
"Bexar County, TX",TX,2014,865150,824137,41013,4.7,12253
"Bexar County, TX",TX,2013,852897,802913,49984,5.9,14540
"Bexar County, TX",TX,2012,838357,785636,52721,6.3,9025
"Bexar County, TX",TX,2011,829332,767720,61612,7.4,15684
"Bexar County, TX",TX,2010,813648,754040,59608,7.3,0
"Bibb County, AL",AL,2021,8560,8262,298,3.5,-152
"Bibb County, AL",AL,2020,8712,8073,639,7.3,-60
"Bibb County, AL",AL,2019,8772,8488,284,3.2,74
"Bibb County, AL",AL,2018,8698,8354,344,4.0,50
"Bibb County, AL",AL,2017,8648,8261,387,4.5,109
"Bibb County, AL",AL,2016,8539,7986,553,6.5,-13
"Bibb County, AL",AL,2015,8552,7983,569,6.7,-21
"Bibb County, AL",AL,2014,8573,7959,614,7.2,-126
"Bibb County, AL",AL,2013,8699,8000,699,8.0,-109
"Bibb County, AL",AL,2012,8808,8037,771,8.8,-124
"Bibb County, AL",AL,2011,8932,8000,932,10.4,-4
"Bibb County, AL",AL,2010,8936,7931,1005,11.2,0
"Bibb County, GA",GA,2021,67875,64471,3404,5.0,643
"Bibb County, GA",GA,2020,67232,62222,5010,7.5,-826
"Bibb County, GA",GA,2019,68058,65256,2802,4.1,-1230
"Bibb County, GA",GA,2018,69288,66111,3177,4.6,-949
"Bibb County, GA",GA,2017,70237,66475,3762,5.4,1578
"Bibb County, GA",GA,2016,68659,64517,4142,6.0,1492
"Bibb County, GA",GA,2015,67167,62617,4550,6.8,-1751
"Bibb County, GA",GA,2014,68918,63364,5554,8.1,-878
"Bibb County, GA",GA,2013,69796,63362,6434,9.2,-1673
"Bibb County, GA",GA,2012,71469,64047,7422,10.4,406
"Bibb County, GA",GA,2011,71063,62969,8094,11.4,642
"Bibb County, GA",GA,2010,70421,62130,8291,11.8,0
"Bienville Parish, LA",LA,2021,5244,4945,299,5.7,-130
"Bienville Parish, LA",LA,2020,5374,4933,441,8.2,-158
"Bienville Parish, LA",LA,2019,5532,5218,314,5.7,-126
"Bienville Parish, LA",LA,2018,5658,5332,326,5.8,17
"Bienville Parish, LA",LA,2017,5641,5304,337,6.0,-30
"Bienville Parish, LA",LA,2016,5671,5239,432,7.6,-108
"Bienville Parish, LA",LA,2015,5779,5302,477,8.3,-125
"Bienville Parish, LA",LA,2014,5904,5445,459,7.8,-38
"Bienville Parish, LA",LA,2013,5942,5448,494,8.3,-32
"Bienville Parish, LA",LA,2012,5974,5460,514,8.6,99
"Bienville Parish, LA",LA,2011,5875,5307,568,9.7,-31
"Bienville Parish, LA",LA,2010,5906,5345,561,9.5,0
"Big Horn County, MT",MT,2021,4669,4306,363,7.8,-199
"Big Horn County, MT",MT,2020,4868,4519,349,7.2,-82
"Big Horn County, MT",MT,2019,4950,4578,372,7.5,-195
"Big Horn County, MT",MT,2018,5145,4649,496,9.6,-421
"Big Horn County, MT",MT,2017,5566,4811,755,13.6,27
"Big Horn County, MT",MT,2016,5539,5123,416,7.5,-16
"Big Horn County, MT",MT,2015,5555,5175,380,6.8,-38
"Big Horn County, MT",MT,2014,5593,5036,557,10.0,-107
"Big Horn County, MT",MT,2013,5700,4908,792,13.9,182
"Big Horn County, MT",MT,2012,5518,4871,647,11.7,-106
"Big Horn County, MT",MT,2011,5624,4976,648,11.5,99
"Big Horn County, MT",MT,2010,5525,4928,597,10.8,0
"Big Horn County, WY",WY,2021,5316,5081,235,4.4,23
"Big Horn County, WY",WY,2020,5293,5028,265,5.0,67
"Big Horn County, WY",WY,2019,5226,4993,233,4.5,-64
"Big Horn County, WY",WY,2018,5290,5040,250,4.7,-85
"Big Horn County, WY",WY,2017,5375,5140,235,4.4,-165
"Big Horn County, WY",WY,2016,5540,5263,277,5.0,27
"Big Horn County, WY",WY,2015,5513,5272,241,4.4,-4
"Big Horn County, WY",WY,2014,5517,5257,260,4.7,15
"Big Horn County, WY",WY,2013,5502,5214,288,5.2,-71
"Big Horn County, WY",WY,2012,5573,5250,323,5.8,-96
"Big Horn County, WY",WY,2011,5669,5303,366,6.5,63
"Big Horn County, WY",WY,2010,5606,5203,403,7.2,0
"Big Stone County, MN",MN,2021,2395,2312,83,3.5,-161
"Big Stone County, MN",MN,2020,2556,2430,126,4.9,41
"Big Stone County, MN",MN,2019,2515,2404,111,4.4,1
"Big Stone County, MN",MN,2018,2514,2412,102,4.1,-68
"Big Stone County, MN",MN,2017,2582,2467,115,4.5,-120
"Big Stone County, MN",MN,2016,2702,2572,130,4.8,13
"Big Stone County, MN",MN,2015,2689,2567,122,4.5,90
"Big Stone County, MN",MN,2014,2599,2481,118,4.5,39
"Big Stone County, MN",MN,2013,2560,2420,140,5.5,-274
"Big Stone County, MN",MN,2012,2834,2684,150,5.3,-75
"Big Stone County, MN",MN,2011,2909,2721,188,6.5,-3
"Big Stone County, MN",MN,2010,2912,2723,189,6.5,0
"Billings County, ND",ND,2021,444,431,13,2.9,5
"Billings County, ND",ND,2020,439,423,16,3.6,-7
"Billings County, ND",ND,2019,446,436,10,2.2,14
"Billings County, ND",ND,2018,432,421,11,2.5,-13
"Billings County, ND",ND,2017,445,432,13,2.9,8
"Billings County, ND",ND,2016,437,424,13,3.0,-27
"Billings County, ND",ND,2015,464,450,14,3.0,-22
"Billings County, ND",ND,2014,486,472,14,2.9,17
"Billings County, ND",ND,2013,469,456,13,2.8,-2
"Billings County, ND",ND,2012,471,456,15,3.2,33
"Billings County, ND",ND,2011,438,422,16,3.7,12
"Billings County, ND",ND,2010,426,413,13,3.1,0
"Bingham County, ID",ID,2021,24278,23503,775,3.2,355
"Bingham County, ID",ID,2020,23923,22984,939,3.9,-56
"Bingham County, ID",ID,2019,23979,23330,649,2.7,532
"Bingham County, ID",ID,2018,23447,22798,649,2.8,258
"Bingham County, ID",ID,2017,23189,22496,693,3.0,406
"Bingham County, ID",ID,2016,22783,22007,776,3.4,711
"Bingham County, ID",ID,2015,22072,21234,838,3.8,95
"Bingham County, ID",ID,2014,21977,21079,898,4.1,-511
"Bingham County, ID",ID,2013,22488,21020,1468,6.5,-361
"Bingham County, ID",ID,2012,22849,21357,1492,6.5,33
"Bingham County, ID",ID,2011,22816,21226,1590,7.0,-59
"Bingham County, ID",ID,2010,22875,21276,1599,7.0,0
"Black Hawk County, IA",IA,2021,67282,64194,3088,4.6,-532
"Black Hawk County, IA",IA,2020,67814,63732,4082,6.0,-2957
"Black Hawk County, IA",IA,2019,70771,68621,2150,3.0,1243
"Black Hawk County, IA",IA,2018,69528,67585,1943,2.8,463
"Black Hawk County, IA",IA,2017,69065,66516,2549,3.7,-559
"Black Hawk County, IA",IA,2016,69624,66425,3199,4.6,-859
"Black Hawk County, IA",IA,2015,70483,67292,3191,4.5,-1671
"Black Hawk County, IA",IA,2014,72154,68621,3533,4.9,312
"Black Hawk County, IA",IA,2013,71842,68173,3669,5.1,326
"Black Hawk County, IA",IA,2012,71516,67615,3901,5.5,282
"Black Hawk County, IA",IA,2011,71234,67006,4228,5.9,424
"Black Hawk County, IA",IA,2010,70810,66355,4455,6.3,0
"Blackford County, IN",IN,2021,4685,4512,173,3.7,-144
"Blackford County, IN",IN,2020,4829,4440,389,8.1,-184
"Blackford County, IN",IN,2019,5013,4820,193,3.8,-314
"Blackford County, IN",IN,2018,5327,5124,203,3.8,-13
"Blackford County, IN",IN,2017,5340,5127,213,4.0,-1
"Blackford County, IN",IN,2016,5341,5059,282,5.3,100
"Blackford County, IN",IN,2015,5241,4927,314,6.0,-25
"Blackford County, IN",IN,2014,5266,4877,389,7.4,-181
"Blackford County, IN",IN,2013,5447,4918,529,9.7,-16
"Blackford County, IN",IN,2012,5463,4847,616,11.3,-169
"Blackford County, IN",IN,2011,5632,4954,678,12.0,-209
"Blackford County, IN",IN,2010,5841,5023,818,14.0,0
"Bladen County, NC",NC,2021,14223,13397,826,5.8,167
"Bladen County, NC",NC,2020,14056,13069,987,7.0,-384
"Bladen County, NC",NC,2019,14440,13766,674,4.7,263
"Bladen County, NC",NC,2018,14177,13418,759,5.4,-42
"Bladen County, NC",NC,2017,14219,13389,830,5.8,-305
"Bladen County, NC",NC,2016,14524,13519,1005,6.9,-197
"Bladen County, NC",NC,2015,14721,13563,1158,7.9,437
"Bladen County, NC",NC,2014,14284,12981,1303,9.1,-72
"Bladen County, NC",NC,2013,14356,12746,1610,11.2,-231
"Bladen County, NC",NC,2012,14587,12691,1896,13.0,-354
"Bladen County, NC",NC,2011,14941,12941,2000,13.4,-303
"Bladen County, NC",NC,2010,15244,13233,2011,13.2,0
"Blaine County, ID",ID,2021,12885,12416,469,3.6,85
"Blaine County, ID",ID,2020,12800,11790,1010,7.9,353
"Blaine County, ID",ID,2019,12447,12116,331,2.7,36
"Blaine County, ID",ID,2018,12411,12111,300,2.4,101
"Blaine County, ID",ID,2017,12310,11992,318,2.6,467
"Blaine County, ID",ID,2016,11843,11482,361,3.0,4
"Blaine County, ID",ID,2015,11839,11449,390,3.3,421
"Blaine County, ID",ID,2014,11418,10954,464,4.1,-266
"Blaine County, ID",ID,2013,11684,10940,744,6.4,-86
"Blaine County, ID",ID,2012,11770,10922,848,7.2,-100
"Blaine County, ID",ID,2011,11870,10850,1020,8.6,-102
"Blaine County, ID",ID,2010,11972,10846,1126,9.4,0
"Blaine County, MT",MT,2021,2237,2151,86,3.8,-34
"Blaine County, MT",MT,2020,2271,2164,107,4.7,-44
"Blaine County, MT",MT,2019,2315,2223,92,4.0,-2
"Blaine County, MT",MT,2018,2317,2216,101,4.4,-51
"Blaine County, MT",MT,2017,2368,2269,99,4.2,-1
"Blaine County, MT",MT,2016,2369,2257,112,4.7,-29
"Blaine County, MT",MT,2015,2398,2275,123,5.1,-36
"Blaine County, MT",MT,2014,2434,2293,141,5.8,-39
"Blaine County, MT",MT,2013,2473,2323,150,6.1,-11
"Blaine County, MT",MT,2012,2484,2331,153,6.2,1
"Blaine County, MT",MT,2011,2483,2316,167,6.7,-40
"Blaine County, MT",MT,2010,2523,2358,165,6.5,0
"Blaine County, NE",NE,2021,248,242,6,2.4,-7
"Blaine County, NE",NE,2020,255,246,9,3.5,-4
"Blaine County, NE",NE,2019,259,246,13,5.0,-4
"Blaine County, NE",NE,2018,263,251,12,4.6,-1
"Blaine County, NE",NE,2017,264,252,12,4.5,-3
"Blaine County, NE",NE,2016,267,255,12,4.5,-2
"Blaine County, NE",NE,2015,269,257,12,4.5,-6
"Blaine County, NE",NE,2014,275,263,12,4.4,3
"Blaine County, NE",NE,2013,272,258,14,5.1,-11
"Blaine County, NE",NE,2012,283,268,15,5.3,3
"Blaine County, NE",NE,2011,280,265,15,5.4,23
"Blaine County, NE",NE,2010,257,244,13,5.1,0
"Blaine County, OK",OK,2021,4402,4272,130,3.0,27
"Blaine County, OK",OK,2020,4375,4110,265,6.1,-345
"Blaine County, OK",OK,2019,4720,4630,90,1.9,253
"Blaine County, OK",OK,2018,4467,4381,86,1.9,-138
"Blaine County, OK",OK,2017,4605,4483,122,2.6,217
"Blaine County, OK",OK,2016,4388,4232,156,3.6,-96
"Blaine County, OK",OK,2015,4484,4316,168,3.7,1
"Blaine County, OK",OK,2014,4483,4334,149,3.3,168
"Blaine County, OK",OK,2013,4315,4147,168,3.9,-43
"Blaine County, OK",OK,2012,4358,4194,164,3.8,16
"Blaine County, OK",OK,2011,4342,4122,220,5.1,-125
"Blaine County, OK",OK,2010,4467,4192,275,6.2,0
"Blair County, PA",PA,2021,59237,55701,3536,6.0,-805
"Blair County, PA",PA,2020,60042,54823,5219,8.7,-248
"Blair County, PA",PA,2019,60290,57507,2783,4.6,220
"Blair County, PA",PA,2018,60070,57445,2625,4.4,-627
"Blair County, PA",PA,2017,60697,57720,2977,4.9,-162
"Blair County, PA",PA,2016,60859,57677,3182,5.2,-152
"Blair County, PA",PA,2015,61011,57810,3201,5.2,131
"Blair County, PA",PA,2014,60880,57348,3532,5.8,-440
"Blair County, PA",PA,2013,61320,57184,4136,6.7,-395
"Blair County, PA",PA,2012,61715,57229,4486,7.3,317
"Blair County, PA",PA,2011,61398,57020,4378,7.1,-186
"Blair County, PA",PA,2010,61584,56807,4777,7.8,0
"Blanco County, TX",TX,2021,6866,6638,228,3.3,336
"Blanco County, TX",TX,2020,6530,6279,251,3.8,96
"Blanco County, TX",TX,2019,6434,6277,157,2.4,245
"Blanco County, TX",TX,2018,6189,6026,163,2.6,8
"Blanco County, TX",TX,2017,6181,6009,172,2.8,244
"Blanco County, TX",TX,2016,5937,5753,184,3.1,168
"Blanco County, TX",TX,2015,5769,5587,182,3.2,99
"Blanco County, TX",TX,2014,5670,5460,210,3.7,142
"Blanco County, TX",TX,2013,5528,5267,261,4.7,48
"Blanco County, TX",TX,2012,5480,5199,281,5.1,66
"Blanco County, TX",TX,2011,5414,5096,318,5.9,-12
"Blanco County, TX",TX,2010,5426,5101,325,6.0,0
"Bland County, VA",VA,2021,2720,2627,93,3.4,-91
"Bland County, VA",VA,2020,2811,2653,158,5.6,-66
"Bland County, VA",VA,2019,2877,2798,79,2.7,15
"Bland County, VA",VA,2018,2862,2772,90,3.1,-32
"Bland County, VA",VA,2017,2894,2777,117,4.0,152
"Bland County, VA",VA,2016,2742,2601,141,5.1,-50
"Bland County, VA",VA,2015,2792,2635,157,5.6,-84
"Bland County, VA",VA,2014,2876,2706,170,5.9,-1
"Bland County, VA",VA,2013,2877,2687,190,6.6,6
"Bland County, VA",VA,2012,2871,2673,198,6.9,17
"Bland County, VA",VA,2011,2854,2644,210,7.4,-45
"Bland County, VA",VA,2010,2899,2645,254,8.8,0
"Bleckley County, GA",GA,2021,4622,4393,229,5.0,113
"Bleckley County, GA",GA,2020,4509,4218,291,6.5,-91
"Bleckley County, GA",GA,2019,4600,4356,244,5.3,-25
"Bleckley County, GA",GA,2018,4625,4355,270,5.8,-1
"Bleckley County, GA",GA,2017,4626,4313,313,6.8,122
"Bleckley County, GA",GA,2016,4504,4143,361,8.0,181
"Bleckley County, GA",GA,2015,4323,3948,375,8.7,-302
"Bleckley County, GA",GA,2014,4625,4103,522,11.3,-155
"Bleckley County, GA",GA,2013,4780,4115,665,13.9,-480
"Bleckley County, GA",GA,2012,5260,4608,652,12.4,-218
"Bleckley County, GA",GA,2011,5478,4754,724,13.2,-12
"Bleckley County, GA",GA,2010,5490,4798,692,12.6,0
"Bledsoe County, TN",TN,2021,4311,4086,225,5.2,21
"Bledsoe County, TN",TN,2020,4290,3931,359,8.4,-47
"Bledsoe County, TN",TN,2019,4337,4100,237,5.5,101
"Bledsoe County, TN",TN,2018,4236,3985,251,5.9,-65
"Bledsoe County, TN",TN,2017,4301,4048,253,5.9,-24
"Bledsoe County, TN",TN,2016,4325,4023,302,7.0,68
"Bledsoe County, TN",TN,2015,4257,3922,335,7.9,-42
"Bledsoe County, TN",TN,2014,4299,3910,389,9.0,-57
"Bledsoe County, TN",TN,2013,4356,3899,457,10.5,49
"Bledsoe County, TN",TN,2012,4307,3851,456,10.6,-180
"Bledsoe County, TN",TN,2011,4487,3973,514,11.5,10
"Bledsoe County, TN",TN,2010,4477,3875,602,13.4,0
"Blount County, AL",AL,2021,25127,24529,598,2.4,11
"Blount County, AL",AL,2020,25116,23973,1143,4.6,-466
"Blount County, AL",AL,2019,25582,24861,721,2.8,245
"Blount County, AL",AL,2018,25337,24454,883,3.5,328
"Blount County, AL",AL,2017,25009,23979,1030,4.1,629
"Blount County, AL",AL,2016,24380,23061,1319,5.4,-36
"Blount County, AL",AL,2015,24416,23089,1327,5.4,-155
"Blount County, AL",AL,2014,24571,23074,1497,6.1,-289
"Blount County, AL",AL,2013,24860,23277,1583,6.4,-118
"Blount County, AL",AL,2012,24978,23216,1762,7.1,-146
"Blount County, AL",AL,2011,25124,22951,2173,8.6,196
"Blount County, AL",AL,2010,24928,22509,2419,9.7,0
"Blount County, TN",TN,2021,64582,62359,2223,3.4,837
"Blount County, TN",TN,2020,63745,59710,4035,6.3,-523
"Blount County, TN",TN,2019,64268,62219,2049,3.2,1512
"Blount County, TN",TN,2018,62756,60734,2022,3.2,1064
"Blount County, TN",TN,2017,61692,59519,2173,3.5,820
"Blount County, TN",TN,2016,60872,58202,2670,4.4,1218
"Blount County, TN",TN,2015,59654,56591,3063,5.1,661
"Blount County, TN",TN,2014,58993,55444,3549,6.0,-476
"Blount County, TN",TN,2013,59469,55351,4118,6.9,-872
"Blount County, TN",TN,2012,60341,56001,4340,7.2,-1242
"Blount County, TN",TN,2011,61583,56476,5107,8.3,144
"Blount County, TN",TN,2010,61439,55766,5673,9.2,0
"Blue Earth County, MN",MN,2021,39179,37981,1198,3.1,-1641
"Blue Earth County, MN",MN,2020,40820,38576,2244,5.5,-259
"Blue Earth County, MN",MN,2019,41079,39868,1211,2.9,599
"Blue Earth County, MN",MN,2018,40480,39389,1091,2.7,273
"Blue Earth County, MN",MN,2017,40207,39023,1184,2.9,612
"Blue Earth County, MN",MN,2016,39595,38325,1270,3.2,129
"Blue Earth County, MN",MN,2015,39466,38277,1189,3.0,848
"Blue Earth County, MN",MN,2014,38618,37258,1360,3.5,-37
"Blue Earth County, MN",MN,2013,38655,37026,1629,4.2,295
"Blue Earth County, MN",MN,2012,38360,36507,1853,4.8,-38
"Blue Earth County, MN",MN,2011,38398,36313,2085,5.4,256
"Blue Earth County, MN",MN,2010,38142,35705,2437,6.4,0
"Boise County, ID",ID,2021,3734,3532,202,5.4,87
"Boise County, ID",ID,2020,3647,3353,294,8.1,97
"Boise County, ID",ID,2019,3550,3395,155,4.4,141
"Boise County, ID",ID,2018,3409,3264,145,4.3,182
"Boise County, ID",ID,2017,3227,3072,155,4.8,135
"Boise County, ID",ID,2016,3092,2935,157,5.1,43
"Boise County, ID",ID,2015,3049,2870,179,5.9,146
"Boise County, ID",ID,2014,2903,2730,173,6.0,-51
"Boise County, ID",ID,2013,2954,2687,267,9.0,-26
"Boise County, ID",ID,2012,2980,2690,290,9.7,-79
"Boise County, ID",ID,2011,3059,2749,310,10.1,5
"Boise County, ID",ID,2010,3054,2736,318,10.4,0
"Bolivar County, MS",MS,2021,11364,10578,786,6.9,14
"Bolivar County, MS",MS,2020,11350,10386,964,8.5,-595
"Bolivar County, MS",MS,2019,11945,11100,845,7.1,-439
"Bolivar County, MS",MS,2018,12384,11609,775,6.3,-487
"Bolivar County, MS",MS,2017,12871,12023,848,6.6,-475
"Bolivar County, MS",MS,2016,13346,12360,986,7.4,-5
"Bolivar County, MS",MS,2015,13351,12288,1063,8.0,81
"Bolivar County, MS",MS,2014,13270,11989,1281,9.7,-530
"Bolivar County, MS",MS,2013,13800,12332,1468,10.6,-745
"Bolivar County, MS",MS,2012,14545,13033,1512,10.4,-506
"Bolivar County, MS",MS,2011,15051,13413,1638,10.9,121
"Bolivar County, MS",MS,2010,14930,13280,1650,11.1,0
"Bollinger County, MO",MO,2021,5349,5127,222,4.2,-15
"Bollinger County, MO",MO,2020,5364,5064,300,5.6,-61
"Bollinger County, MO",MO,2019,5425,5225,200,3.7,3
"Bollinger County, MO",MO,2018,5422,5228,194,3.6,-67
"Bollinger County, MO",MO,2017,5489,5249,240,4.4,35
"Bollinger County, MO",MO,2016,5454,5169,285,5.2,-67
"Bollinger County, MO",MO,2015,5521,5206,315,5.7,-102
"Bollinger County, MO",MO,2014,5623,5241,382,6.8,-112
"Bollinger County, MO",MO,2013,5735,5325,410,7.1,50
"Bollinger County, MO",MO,2012,5685,5273,412,7.2,-45
"Bollinger County, MO",MO,2011,5730,5204,526,9.2,-87
"Bollinger County, MO",MO,2010,5817,5236,581,10.0,0
"Bon Homme County, SD",SD,2021,2820,2740,80,2.8,-17
"Bon Homme County, SD",SD,2020,2837,2729,108,3.8,-8
"Bon Homme County, SD",SD,2019,2845,2770,75,2.6,-14
"Bon Homme County, SD",SD,2018,2859,2792,67,2.3,-51
"Bon Homme County, SD",SD,2017,2910,2831,79,2.7,-50
"Bon Homme County, SD",SD,2016,2960,2879,81,2.7,-69
"Bon Homme County, SD",SD,2015,3029,2950,79,2.6,5
"Bon Homme County, SD",SD,2014,3024,2941,83,2.7,0
"Bon Homme County, SD",SD,2013,3024,2928,96,3.2,-45
"Bon Homme County, SD",SD,2012,3069,2955,114,3.7,-80
"Bon Homme County, SD",SD,2011,3149,2997,152,4.8,-57
"Bon Homme County, SD",SD,2010,3206,3073,133,4.1,0
"Bond County, IL",IL,2021,7425,7084,341,4.6,29
"Bond County, IL",IL,2020,7396,6876,520,7.0,-387
"Bond County, IL",IL,2019,7783,7498,285,3.7,-35
"Bond County, IL",IL,2018,7818,7480,338,4.3,-112
"Bond County, IL",IL,2017,7930,7579,351,4.4,19
"Bond County, IL",IL,2016,7911,7506,405,5.1,116
"Bond County, IL",IL,2015,7795,7381,414,5.3,-97
"Bond County, IL",IL,2014,7892,7371,521,6.6,-136
"Bond County, IL",IL,2013,8028,7334,694,8.6,-214
"Bond County, IL",IL,2012,8242,7499,743,9.0,-246
"Bond County, IL",IL,2011,8488,7694,794,9.4,-37
"Bond County, IL",IL,2010,8525,7657,868,10.2,0
"Bonner County, ID",ID,2021,21552,20519,1033,4.8,378
"Bonner County, ID",ID,2020,21174,19536,1638,7.7,921
"Bonner County, ID",ID,2019,20253,19390,863,4.3,461
"Bonner County, ID",ID,2018,19792,18969,823,4.2,405
"Bonner County, ID",ID,2017,19387,18510,877,4.5,516
"Bonner County, ID",ID,2016,18871,17879,992,5.3,354
"Bonner County, ID",ID,2015,18517,17493,1024,5.5,401
"Bonner County, ID",ID,2014,18116,16937,1179,6.5,-381
"Bonner County, ID",ID,2013,18497,16695,1802,9.7,-199
"Bonner County, ID",ID,2012,18696,16691,2005,10.7,-316
"Bonner County, ID",ID,2011,19012,16700,2312,12.2,-509
"Bonner County, ID",ID,2010,19521,17040,2481,12.7,0
"Bonneville County, ID",ID,2021,60471,58722,1749,2.9,1966
"Bonneville County, ID",ID,2020,58505,56095,2410,4.1,930
"Bonneville County, ID",ID,2019,57575,56173,1402,2.4,2034
"Bonneville County, ID",ID,2018,55541,54180,1361,2.5,1620
"Bonneville County, ID",ID,2017,53921,52459,1462,2.7,1544
"Bonneville County, ID",ID,2016,52377,50762,1615,3.1,1314
"Bonneville County, ID",ID,2015,51063,49414,1649,3.2,1645
"Bonneville County, ID",ID,2014,49418,47550,1868,3.8,72
"Bonneville County, ID",ID,2013,49346,46351,2995,6.1,56
"Bonneville County, ID",ID,2012,49290,46104,3186,6.5,16
"Bonneville County, ID",ID,2011,49274,45938,3336,6.8,115
"Bonneville County, ID",ID,2010,49159,45843,3316,6.7,0
"Boone County, AR",AR,2021,15782,15313,469,3.0,-75
"Boone County, AR",AR,2020,15857,15019,838,5.3,-213
"Boone County, AR",AR,2019,16070,15570,500,3.1,177
"Boone County, AR",AR,2018,15893,15345,548,3.4,99
"Boone County, AR",AR,2017,15794,15249,545,3.5,-163
"Boone County, AR",AR,2016,15957,15370,587,3.7,48
"Boone County, AR",AR,2015,15909,15145,764,4.8,129
"Boone County, AR",AR,2014,15780,14858,922,5.8,-360
"Boone County, AR",AR,2013,16140,15037,1103,6.8,-450
"Boone County, AR",AR,2012,16590,15376,1214,7.3,-23
"Boone County, AR",AR,2011,16613,15354,1259,7.6,111
"Boone County, AR",AR,2010,16502,15259,1243,7.5,0
"Boone County, IA",IA,2021,14563,14056,507,3.5,-17
"Boone County, IA",IA,2020,14580,14002,578,4.0,-655
"Boone County, IA",IA,2019,15235,14892,343,2.3,177
"Boone County, IA",IA,2018,15058,14737,321,2.1,80
"Boone County, IA",IA,2017,14978,14618,360,2.4,-215
"Boone County, IA",IA,2016,15193,14772,421,2.8,-120
"Boone County, IA",IA,2015,15313,14855,458,3.0,120
"Boone County, IA",IA,2014,15193,14677,516,3.4,291
"Boone County, IA",IA,2013,14902,14298,604,4.1,272
"Boone County, IA",IA,2012,14630,13994,636,4.3,-90
"Boone County, IA",IA,2011,14720,13977,743,5.0,-86
"Boone County, IA",IA,2010,14806,13946,860,5.8,0
"Boone County, IL",IL,2021,24982,22849,2133,8.5,-336
"Boone County, IL",IL,2020,25318,22421,2897,11.4,-1079
"Boone County, IL",IL,2019,26397,24983,1414,5.4,-266
"Boone County, IL",IL,2018,26663,25147,1516,5.7,461
"Boone County, IL",IL,2017,26202,24445,1757,6.7,-235
"Boone County, IL",IL,2016,26437,24753,1684,6.4,94
"Boone County, IL",IL,2015,26343,24621,1722,6.5,62
"Boone County, IL",IL,2014,26281,24210,2071,7.9,-70
"Boone County, IL",IL,2013,26351,23689,2662,10.1,-370
"Boone County, IL",IL,2012,26721,23921,2800,10.5,-407
"Boone County, IL",IL,2011,27128,23924,3204,11.8,-218
"Boone County, IL",IL,2010,27346,23540,3806,13.9,0
"Boone County, IN",IN,2021,36964,36190,774,2.1,858
"Boone County, IN",IN,2020,36106,34547,1559,4.3,-651
"Boone County, IN",IN,2019,36757,35861,896,2.4,516
"Boone County, IN",IN,2018,36241,35270,971,2.7,846
"Boone County, IN",IN,2017,35395,34398,997,2.8,499
"Boone County, IN",IN,2016,34896,33733,1163,3.3,1404
"Boone County, IN",IN,2015,33492,32264,1228,3.7,1288
"Boone County, IN",IN,2014,32204,30795,1409,4.4,1060
"Boone County, IN",IN,2013,31144,29402,1742,5.6,882
"Boone County, IN",IN,2012,30262,28450,1812,6.0,366
"Boone County, IN",IN,2011,29896,27932,1964,6.6,475
"Boone County, IN",IN,2010,29421,27251,2170,7.4,0
"Boone County, KY",KY,2021,71482,68781,2701,3.8,926
"Boone County, KY",KY,2020,70556,66874,3682,5.2,-1859
"Boone County, KY",KY,2019,72415,70102,2313,3.2,1799
"Boone County, KY",KY,2018,70616,68301,2315,3.3,724
"Boone County, KY",KY,2017,69892,67247,2645,3.8,2609
"Boone County, KY",KY,2016,67283,64755,2528,3.8,1664
"Boone County, KY",KY,2015,65619,62983,2636,4.0,346
"Boone County, KY",KY,2014,65273,61910,3363,5.2,-771
"Boone County, KY",KY,2013,66044,61712,4332,6.6,621
"Boone County, KY",KY,2012,65423,60922,4501,6.9,1043
"Boone County, KY",KY,2011,64380,59345,5035,7.8,801
"Boone County, KY",KY,2010,63579,57900,5679,8.9,0
"Boone County, MO",MO,2021,99004,96049,2955,3.0,3152
"Boone County, MO",MO,2020,95852,91790,4062,4.2,-2268
"Boone County, MO",MO,2019,98120,95904,2216,2.3,683
"Boone County, MO",MO,2018,97437,95255,2182,2.2,212
"Boone County, MO",MO,2017,97225,94687,2538,2.6,-817
"Boone County, MO",MO,2016,98042,94825,3217,3.3,-196
"Boone County, MO",MO,2015,98238,94717,3521,3.6,970
"Boone County, MO",MO,2014,97268,93196,4072,4.2,38
"Boone County, MO",MO,2013,97230,92812,4418,4.5,1535
"Boone County, MO",MO,2012,95695,91218,4477,4.7,2102
"Boone County, MO",MO,2011,93593,88143,5450,5.8,1407
"Boone County, MO",MO,2010,92186,86285,5901,6.4,0
"Boone County, NE",NE,2021,2964,2916,48,1.6,10
"Boone County, NE",NE,2020,2954,2882,72,2.4,-40
"Boone County, NE",NE,2019,2994,2913,81,2.7,52
"Boone County, NE",NE,2018,2942,2875,67,2.3,-14
"Boone County, NE",NE,2017,2956,2883,73,2.5,-65
"Boone County, NE",NE,2016,3021,2942,79,2.6,-3
"Boone County, NE",NE,2015,3024,2950,74,2.4,-1
"Boone County, NE",NE,2014,3025,2947,78,2.6,-24
"Boone County, NE",NE,2013,3049,2952,97,3.2,13
"Boone County, NE",NE,2012,3036,2945,91,3.0,-5
"Boone County, NE",NE,2011,3041,2930,111,3.7,86
"Boone County, NE",NE,2010,2955,2849,106,3.6,0
"Boone County, WV",WV,2021,7259,6818,441,6.1,-102
"Boone County, WV",WV,2020,7361,6606,755,10.3,-26
"Boone County, WV",WV,2019,7387,6982,405,5.5,-133
"Boone County, WV",WV,2018,7520,7067,453,6.0,-80
"Boone County, WV",WV,2017,7600,7112,488,6.4,-414
"Boone County, WV",WV,2016,8014,7284,730,9.1,-263
"Boone County, WV",WV,2015,8277,7490,787,9.5,-222
"Boone County, WV",WV,2014,8499,7725,774,9.1,-163
"Boone County, WV",WV,2013,8662,7842,820,9.5,-252
"Boone County, WV",WV,2012,8914,8018,896,10.1,238
"Boone County, WV",WV,2011,8676,7995,681,7.8,-124
"Boone County, WV",WV,2010,8800,8024,776,8.8,0
"Borden County, TX",TX,2021,581,567,14,2.4,143
"Borden County, TX",TX,2020,438,423,15,3.4,38
"Borden County, TX",TX,2019,400,390,10,2.5,60
"Borden County, TX",TX,2018,340,329,11,3.2,20
"Borden County, TX",TX,2017,320,309,11,3.4,-46
"Borden County, TX",TX,2016,366,353,13,3.6,-46
"Borden County, TX",TX,2015,412,400,12,2.9,-11
"Borden County, TX",TX,2014,423,410,13,3.1,7
"Borden County, TX",TX,2013,416,399,17,4.1,-1
"Borden County, TX",TX,2012,417,400,17,4.1,29
"Borden County, TX",TX,2011,388,367,21,5.4,29
"Borden County, TX",TX,2010,359,335,24,6.7,0
"Bosque County, TX",TX,2021,8429,8044,385,4.6,244
"Bosque County, TX",TX,2020,8185,7738,447,5.5,-29
"Bosque County, TX",TX,2019,8214,7933,281,3.4,77
"Bosque County, TX",TX,2018,8137,7833,304,3.7,2
"Bosque County, TX",TX,2017,8135,7808,327,4.0,-56
"Bosque County, TX",TX,2016,8191,7838,353,4.3,127
"Bosque County, TX",TX,2015,8064,7699,365,4.5,-64
"Bosque County, TX",TX,2014,8128,7703,425,5.2,63
"Bosque County, TX",TX,2013,8065,7539,526,6.5,-104
"Bosque County, TX",TX,2012,8169,7583,586,7.2,-237
"Bosque County, TX",TX,2011,8406,7685,721,8.6,-56
"Bosque County, TX",TX,2010,8462,7714,748,8.8,0
"Bossier Parish, LA",LA,2021,57066,54867,2199,3.9,315
"Bossier Parish, LA",LA,2020,56751,52939,3812,6.7,-1429
"Bossier Parish, LA",LA,2019,58180,55768,2412,4.1,2
"Bossier Parish, LA",LA,2018,58178,55729,2449,4.2,465
"Bossier Parish, LA",LA,2017,57713,55141,2572,4.5,64
"Bossier Parish, LA",LA,2016,57649,54581,3068,5.3,-296
"Bossier Parish, LA",LA,2015,57945,54695,3250,5.6,35
"Bossier Parish, LA",LA,2014,57910,54652,3258,5.6,1010
"Bossier Parish, LA",LA,2013,56900,53608,3292,5.8,-712
"Bossier Parish, LA",LA,2012,57612,54441,3171,5.5,450
"Bossier Parish, LA",LA,2011,57162,53981,3181,5.6,567
"Bossier Parish, LA",LA,2010,56595,53369,3226,5.7,0
"Botetourt County, VA",VA,2021,16976,16463,513,3.0,-345
"Botetourt County, VA",VA,2020,17321,16543,778,4.5,-475
"Botetourt County, VA",VA,2019,17796,17351,445,2.5,339
"Botetourt County, VA",VA,2018,17457,16993,464,2.7,22
"Botetourt County, VA",VA,2017,17435,16828,607,3.5,60
"Botetourt County, VA",VA,2016,17375,16755,620,3.6,-84
"Botetourt County, VA",VA,2015,17459,16738,721,4.1,-290
"Botetourt County, VA",VA,2014,17749,16900,849,4.8,115
"Botetourt County, VA",VA,2013,17634,16731,903,5.1,-68
"Botetourt County, VA",VA,2012,17702,16752,950,5.4,-1
"Botetourt County, VA",VA,2011,17703,16667,1036,5.9,-19
"Botetourt County, VA",VA,2010,17722,16551,1171,6.6,0
"Bottineau County, ND",ND,2021,2976,2834,142,4.8,-9
"Bottineau County, ND",ND,2020,2985,2825,160,5.4,-19
"Bottineau County, ND",ND,2019,3004,2914,90,3.0,-36
"Bottineau County, ND",ND,2018,3040,2948,92,3.0,-110
"Bottineau County, ND",ND,2017,3150,3046,104,3.3,-72
"Bottineau County, ND",ND,2016,3222,3072,150,4.7,6
"Bottineau County, ND",ND,2015,3216,3075,141,4.4,-4
"Bottineau County, ND",ND,2014,3220,3113,107,3.3,-2
"Bottineau County, ND",ND,2013,3222,3098,124,3.8,-167
"Bottineau County, ND",ND,2012,3389,3279,110,3.2,-36
"Bottineau County, ND",ND,2011,3425,3301,124,3.6,22
"Bottineau County, ND",ND,2010,3403,3271,132,3.9,0
"Boulder County, CO",CO,2021,195616,187094,8522,4.4,4874
"Boulder County, CO",CO,2020,190742,179615,11127,5.8,-3152
"Boulder County, CO",CO,2019,193894,189610,4284,2.2,2988
"Boulder County, CO",CO,2018,190906,185906,5000,2.6,5850
"Boulder County, CO",CO,2017,185056,180914,4142,2.2,4155
"Boulder County, CO",CO,2016,180901,176286,4615,2.6,4083
"Boulder County, CO",CO,2015,176818,171415,5403,3.1,695
"Boulder County, CO",CO,2014,176123,168947,7176,4.1,1357
"Boulder County, CO",CO,2013,174766,165314,9452,5.4,958
"Boulder County, CO",CO,2012,173808,162818,10990,6.3,2223
"Boulder County, CO",CO,2011,171585,160020,11565,6.7,1907
"Boulder County, CO",CO,2010,169678,157072,12606,7.4,0
"Boundary County, ID",ID,2021,5597,5353,244,4.4,59
"Boundary County, ID",ID,2020,5538,5186,352,6.4,129
"Boundary County, ID",ID,2019,5409,5162,247,4.6,113
"Boundary County, ID",ID,2018,5296,5060,236,4.5,110
"Boundary County, ID",ID,2017,5186,4938,248,4.8,88
"Boundary County, ID",ID,2016,5098,4841,257,5.0,9
"Boundary County, ID",ID,2015,5089,4829,260,5.1,204
"Boundary County, ID",ID,2014,4885,4616,269,5.5,-75
"Boundary County, ID",ID,2013,4960,4522,438,8.8,-283
"Boundary County, ID",ID,2012,5243,4737,506,9.7,-132
"Boundary County, ID",ID,2011,5375,4764,611,11.4,3
"Boundary County, ID",ID,2010,5372,4664,708,13.2,0
"Bourbon County, KS",KS,2021,6513,6272,241,3.7,-177
"Bourbon County, KS",KS,2020,6690,6319,371,5.5,-50
"Bourbon County, KS",KS,2019,6740,6458,282,4.2,-386
"Bourbon County, KS",KS,2018,7126,6835,291,4.1,66
"Bourbon County, KS",KS,2017,7060,6750,310,4.4,-100
"Bourbon County, KS",KS,2016,7160,6813,347,4.8,22
"Bourbon County, KS",KS,2015,7138,6796,342,4.8,33
"Bourbon County, KS",KS,2014,7105,6734,371,5.2,221
"Bourbon County, KS",KS,2013,6884,6438,446,6.5,145
"Bourbon County, KS",KS,2012,6739,6224,515,7.6,-167
"Bourbon County, KS",KS,2011,6906,6296,610,8.8,-313
"Bourbon County, KS",KS,2010,7219,6577,642,8.9,0
"Bourbon County, KY",KY,2021,9663,9288,375,3.9,95
"Bourbon County, KY",KY,2020,9568,9025,543,5.7,-65
"Bourbon County, KY",KY,2019,9633,9283,350,3.6,-53
"Bourbon County, KY",KY,2018,9686,9312,374,3.9,-204
"Bourbon County, KY",KY,2017,9890,9446,444,4.5,11
"Bourbon County, KY",KY,2016,9879,9416,463,4.7,137
"Bourbon County, KY",KY,2015,9742,9288,454,4.7,93
"Bourbon County, KY",KY,2014,9649,9109,540,5.6,-179
"Bourbon County, KY",KY,2013,9828,9146,682,6.9,-23
"Bourbon County, KY",KY,2012,9851,9132,719,7.3,-220
"Bourbon County, KY",KY,2011,10071,9224,847,8.4,-43
"Bourbon County, KY",KY,2010,10114,9189,925,9.1,0
"Bowie County, TX",TX,2021,39047,36770,2277,5.8,635
"Bowie County, TX",TX,2020,38412,35569,2843,7.4,-738
"Bowie County, TX",TX,2019,39150,37408,1742,4.4,49
"Bowie County, TX",TX,2018,39101,37159,1942,5.0,115
"Bowie County, TX",TX,2017,38986,37186,1800,4.6,-657
"Bowie County, TX",TX,2016,39643,37775,1868,4.7,472
"Bowie County, TX",TX,2015,39171,37274,1897,4.8,-441
"Bowie County, TX",TX,2014,39612,37088,2524,6.4,-869
"Bowie County, TX",TX,2013,40481,37371,3110,7.7,-971
"Bowie County, TX",TX,2012,41452,38388,3064,7.4,-873
"Bowie County, TX",TX,2011,42325,38711,3614,8.5,56
"Bowie County, TX",TX,2010,42269,38685,3584,8.5,0
"Bowman County, ND",ND,2021,1581,1542,39,2.5,-54
"Bowman County, ND",ND,2020,1635,1580,55,3.4,-107
"Bowman County, ND",ND,2019,1742,1716,26,1.5,74
"Bowman County, ND",ND,2018,1668,1640,28,1.7,-109
"Bowman County, ND",ND,2017,1777,1746,31,1.7,-55
"Bowman County, ND",ND,2016,1832,1792,40,2.2,-15
"Bowman County, ND",ND,2015,1847,1813,34,1.8,-26
"Bowman County, ND",ND,2014,1873,1840,33,1.8,-102
"Bowman County, ND",ND,2013,1975,1936,39,2.0,67
"Bowman County, ND",ND,2012,1908,1874,34,1.8,37
"Bowman County, ND",ND,2011,1871,1832,39,2.1,96
"Bowman County, ND",ND,2010,1775,1730,45,2.5,0
"Box Butte County, NE",NE,2021,5483,5349,134,2.4,79
"Box Butte County, NE",NE,2020,5404,5155,249,4.6,-70
"Box Butte County, NE",NE,2019,5474,5300,174,3.2,16
"Box Butte County, NE",NE,2018,5458,5301,157,2.9,-20
"Box Butte County, NE",NE,2017,5478,5295,183,3.3,-197
"Box Butte County, NE",NE,2016,5675,5472,203,3.6,-8
"Box Butte County, NE",NE,2015,5683,5513,170,3.0,-64
"Box Butte County, NE",NE,2014,5747,5569,178,3.1,-220
"Box Butte County, NE",NE,2013,5967,5742,225,3.8,3
"Box Butte County, NE",NE,2012,5964,5731,233,3.9,-19
"Box Butte County, NE",NE,2011,5983,5730,253,4.2,139
"Box Butte County, NE",NE,2010,5844,5548,296,5.1,0
"Box Elder County, UT",UT,2021,26895,26237,658,2.4,254
"Box Elder County, UT",UT,2020,26641,25470,1171,4.4,409
"Box Elder County, UT",UT,2019,26232,25552,680,2.6,565
"Box Elder County, UT",UT,2018,25667,24938,729,2.8,230
"Box Elder County, UT",UT,2017,25437,24632,805,3.2,842
"Box Elder County, UT",UT,2016,24595,23763,832,3.4,741
"Box Elder County, UT",UT,2015,23854,22991,863,3.6,624
"Box Elder County, UT",UT,2014,23230,22372,858,3.7,397
"Box Elder County, UT",UT,2013,22833,21840,993,4.3,307
"Box Elder County, UT",UT,2012,22526,21382,1144,5.1,-507
"Box Elder County, UT",UT,2011,23033,21230,1803,7.8,-510
"Box Elder County, UT",UT,2010,23543,21520,2023,8.6,0
"Boyd County, KY",KY,2021,17284,16208,1076,6.2,-179
"Boyd County, KY",KY,2020,17463,16052,1411,8.1,-360
"Boyd County, KY",KY,2019,17823,16869,954,5.4,-89
"Boyd County, KY",KY,2018,17912,16880,1032,5.8,-389
"Boyd County, KY",KY,2017,18301,17014,1287,7.0,-241
"Boyd County, KY",KY,2016,18542,17058,1484,8.0,242
"Boyd County, KY",KY,2015,18300,17058,1242,6.8,-781
"Boyd County, KY",KY,2014,19081,17648,1433,7.5,-625
"Boyd County, KY",KY,2013,19706,17863,1843,9.4,-390
"Boyd County, KY",KY,2012,20096,18210,1886,9.4,-208
"Boyd County, KY",KY,2011,20304,18214,2090,10.3,-227
"Boyd County, KY",KY,2010,20531,18418,2113,10.3,0
"Boyd County, NE",NE,2021,1040,1019,21,2.0,-17
"Boyd County, NE",NE,2020,1057,1028,29,2.7,-33
"Boyd County, NE",NE,2019,1090,1054,36,3.3,3
"Boyd County, NE",NE,2018,1087,1054,33,3.0,-2
"Boyd County, NE",NE,2017,1089,1052,37,3.4,-16
"Boyd County, NE",NE,2016,1105,1072,33,3.0,12
"Boyd County, NE",NE,2015,1093,1064,29,2.7,-7
"Boyd County, NE",NE,2014,1100,1064,36,3.3,-25
"Boyd County, NE",NE,2013,1125,1087,38,3.4,-20
"Boyd County, NE",NE,2012,1145,1101,44,3.8,-4
"Boyd County, NE",NE,2011,1149,1105,44,3.8,44
"Boyd County, NE",NE,2010,1105,1061,44,4.0,0
"Boyle County, KY",KY,2021,12657,12027,630,5.0,95
"Boyle County, KY",KY,2020,12562,11673,889,7.1,-97
"Boyle County, KY",KY,2019,12659,12103,556,4.4,103
"Boyle County, KY",KY,2018,12556,12015,541,4.3,-56
"Boyle County, KY",KY,2017,12612,11987,625,5.0,300
"Boyle County, KY",KY,2016,12312,11711,601,4.9,297
"Boyle County, KY",KY,2015,12015,11358,657,5.5,-277
"Boyle County, KY",KY,2014,12292,11447,845,6.9,-524
"Boyle County, KY",KY,2013,12816,11695,1121,8.7,-266
"Boyle County, KY",KY,2012,13082,11899,1183,9.0,-110
"Boyle County, KY",KY,2011,13192,11776,1416,10.7,-223
"Boyle County, KY",KY,2010,13415,11902,1513,11.3,0
"Bracken County, KY",KY,2021,3775,3597,178,4.7,62
"Bracken County, KY",KY,2020,3713,3490,223,6.0,-154
"Bracken County, KY",KY,2019,3867,3689,178,4.6,59
"Bracken County, KY",KY,2018,3808,3626,182,4.8,-25
"Bracken County, KY",KY,2017,3833,3614,219,5.7,2
"Bracken County, KY",KY,2016,3831,3604,227,5.9,108
"Bracken County, KY",KY,2015,3723,3492,231,6.2,-77
"Bracken County, KY",KY,2014,3800,3501,299,7.9,-132
"Bracken County, KY",KY,2013,3932,3550,382,9.7,-20
"Bracken County, KY",KY,2012,3952,3577,375,9.5,-38
"Bracken County, KY",KY,2011,3990,3563,427,10.7,-12
"Bracken County, KY",KY,2010,4002,3543,459,11.5,0
"Bradford County, FL",FL,2021,10791,10343,448,4.2,78
"Bradford County, FL",FL,2020,10713,10018,695,6.5,-140
"Bradford County, FL",FL,2019,10853,10494,359,3.3,-206
"Bradford County, FL",FL,2018,11059,10674,385,3.5,-105
"Bradford County, FL",FL,2017,11164,10750,414,3.7,268
"Bradford County, FL",FL,2016,10896,10427,469,4.3,110
"Bradford County, FL",FL,2015,10786,10260,526,4.9,53
"Bradford County, FL",FL,2014,10733,10110,623,5.8,-218
"Bradford County, FL",FL,2013,10951,10232,719,6.6,-123
"Bradford County, FL",FL,2012,11074,10210,864,7.8,-365
"Bradford County, FL",FL,2011,11439,10403,1036,9.1,-51
"Bradford County, FL",FL,2010,11490,10393,1097,9.5,0
"Bradford County, PA",PA,2021,27852,26294,1558,5.6,-619
"Bradford County, PA",PA,2020,28471,26329,2142,7.5,-551
"Bradford County, PA",PA,2019,29022,27722,1300,4.5,-137
"Bradford County, PA",PA,2018,29159,27835,1324,4.5,-415
"Bradford County, PA",PA,2017,29574,28030,1544,5.2,-640
"Bradford County, PA",PA,2016,30214,28262,1952,6.5,-1167
"Bradford County, PA",PA,2015,31381,29490,1891,6.0,-209
"Bradford County, PA",PA,2014,31590,29854,1736,5.5,-159
"Bradford County, PA",PA,2013,31749,29510,2239,7.1,-822
"Bradford County, PA",PA,2012,32571,30383,2188,6.7,617
"Bradford County, PA",PA,2011,31954,29932,2022,6.3,1223
"Bradford County, PA",PA,2010,30731,28578,2153,7.0,0
"Bradley County, AR",AR,2021,4056,3865,191,4.7,-312
"Bradley County, AR",AR,2020,4368,4110,258,5.9,-114
"Bradley County, AR",AR,2019,4482,4301,181,4.0,1
"Bradley County, AR",AR,2018,4481,4289,192,4.3,25
"Bradley County, AR",AR,2017,4456,4252,204,4.6,-35
"Bradley County, AR",AR,2016,4491,4265,226,5.0,-84
"Bradley County, AR",AR,2015,4575,4314,261,5.7,226
"Bradley County, AR",AR,2014,4349,4008,341,7.8,51
"Bradley County, AR",AR,2013,4298,3900,398,9.3,-233
"Bradley County, AR",AR,2012,4531,4062,469,10.4,-164
"Bradley County, AR",AR,2011,4695,4153,542,11.5,-462
"Bradley County, AR",AR,2010,5157,4637,520,10.1,0
"Bradley County, TN",TN,2021,50805,48732,2073,4.1,-1764
"Bradley County, TN",TN,2020,52569,49146,3423,6.5,-19
"Bradley County, TN",TN,2019,52588,50772,1816,3.5,1982
"Bradley County, TN",TN,2018,50606,48796,1810,3.6,-312
"Bradley County, TN",TN,2017,50918,49064,1854,3.6,765
"Bradley County, TN",TN,2016,50153,47911,2242,4.5,609
"Bradley County, TN",TN,2015,49544,46975,2569,5.2,250
"Bradley County, TN",TN,2014,49294,46297,2997,6.1,-359
"Bradley County, TN",TN,2013,49653,46138,3515,7.1,953
"Bradley County, TN",TN,2012,48700,45054,3646,7.5,1380
"Bradley County, TN",TN,2011,47320,43049,4271,9.0,839
"Bradley County, TN",TN,2010,46481,42041,4440,9.6,0
"Branch County, MI",MI,2021,19085,18140,945,5.0,-577
"Branch County, MI",MI,2020,19662,18014,1648,8.4,268
"Branch County, MI",MI,2019,19394,18621,773,4.0,43
"Branch County, MI",MI,2018,19351,18626,725,3.7,105
"Branch County, MI",MI,2017,19246,18371,875,4.5,89
"Branch County, MI",MI,2016,19157,18224,933,4.9,-81
"Branch County, MI",MI,2015,19238,18243,995,5.2,-90
"Branch County, MI",MI,2014,19328,18041,1287,6.7,248
"Branch County, MI",MI,2013,19080,17489,1591,8.3,365
"Branch County, MI",MI,2012,18715,17079,1636,8.7,-410
"Branch County, MI",MI,2011,19125,17204,1921,10.0,-721
"Branch County, MI",MI,2010,19846,17409,2437,12.3,0
"Brantley County, GA",GA,2021,7296,7030,266,3.6,278
"Brantley County, GA",GA,2020,7018,6645,373,5.3,-239
"Brantley County, GA",GA,2019,7257,6944,313,4.3,-131
"Brantley County, GA",GA,2018,7388,7053,335,4.5,13
"Brantley County, GA",GA,2017,7375,6951,424,5.7,277
"Brantley County, GA",GA,2016,7098,6614,484,6.8,268
"Brantley County, GA",GA,2015,6830,6311,519,7.6,-50
"Brantley County, GA",GA,2014,6880,6240,640,9.3,-147
"Brantley County, GA",GA,2013,7027,6283,744,10.6,-384
"Brantley County, GA",GA,2012,7411,6532,879,11.9,-39
"Brantley County, GA",GA,2011,7450,6474,976,13.1,-42
"Brantley County, GA",GA,2010,7492,6525,967,12.9,0
"Braxton County, WV",WV,2021,5097,4753,344,6.7,-98
"Braxton County, WV",WV,2020,5195,4672,523,10.1,-47
"Braxton County, WV",WV,2019,5242,4852,390,7.4,93
"Braxton County, WV",WV,2018,5149,4791,358,7.0,-134
"Braxton County, WV",WV,2017,5283,4886,397,7.5,-226
"Braxton County, WV",WV,2016,5509,5026,483,8.8,-14
"Braxton County, WV",WV,2015,5523,5042,481,8.7,250
"Braxton County, WV",WV,2014,5273,4784,489,9.3,-62
"Braxton County, WV",WV,2013,5335,4792,543,10.2,-69
"Braxton County, WV",WV,2012,5404,4840,564,10.4,-84
"Braxton County, WV",WV,2011,5488,4894,594,10.8,-191
"Braxton County, WV",WV,2010,5679,5049,630,11.1,0
"Brazoria County, TX",TX,2021,180207,167799,12408,6.9,2895
"Brazoria County, TX",TX,2020,177312,162103,15209,8.6,-257
"Brazoria County, TX",TX,2019,177569,170069,7500,4.2,2689
"Brazoria County, TX",TX,2018,174880,166883,7997,4.6,2874
"Brazoria County, TX",TX,2017,172006,162805,9201,5.3,2066
"Brazoria County, TX",TX,2016,169940,161111,8829,5.2,2814
"Brazoria County, TX",TX,2015,167126,159416,7710,4.6,638
"Brazoria County, TX",TX,2014,166488,157901,8587,5.2,2473
"Brazoria County, TX",TX,2013,164015,153913,10102,6.2,3204
"Brazoria County, TX",TX,2012,160811,150155,10656,6.6,2289
"Brazoria County, TX",TX,2011,158522,145399,13123,8.3,3079
"Brazoria County, TX",TX,2010,155443,142179,13264,8.5,0
"Brazos County, TX",TX,2021,121046,116075,4971,4.1,4725
"Brazos County, TX",TX,2020,116321,110128,6193,5.3,-991
"Brazos County, TX",TX,2019,117312,114136,3176,2.7,1960
"Brazos County, TX",TX,2018,115352,112032,3320,2.9,3167
"Brazos County, TX",TX,2017,112185,108698,3487,3.1,847
"Brazos County, TX",TX,2016,111338,107481,3857,3.5,2700
"Brazos County, TX",TX,2015,108638,105010,3628,3.3,4458
"Brazos County, TX",TX,2014,104180,99973,4207,4.0,1586
"Brazos County, TX",TX,2013,102594,97521,5073,4.9,2996
"Brazos County, TX",TX,2012,99598,94375,5223,5.2,-70
"Brazos County, TX",TX,2011,99668,93461,6207,6.2,-477
"Brazos County, TX",TX,2010,100145,93813,6332,6.3,0
"Breathitt County, KY",KY,2021,3261,2979,282,8.6,10
"Breathitt County, KY",KY,2020,3251,2928,323,9.9,-218
"Breathitt County, KY",KY,2019,3469,3223,246,7.1,-145
"Breathitt County, KY",KY,2018,3614,3359,255,7.1,-127
"Breathitt County, KY",KY,2017,3741,3419,322,8.6,-4
"Breathitt County, KY",KY,2016,3745,3381,364,9.7,-69
"Breathitt County, KY",KY,2015,3814,3443,371,9.7,-366
"Breathitt County, KY",KY,2014,4180,3705,475,11.4,-302
"Breathitt County, KY",KY,2013,4482,3820,662,14.8,-59
"Breathitt County, KY",KY,2012,4541,3881,660,14.5,120
"Breathitt County, KY",KY,2011,4421,3858,563,12.7,-133
"Breathitt County, KY",KY,2010,4554,3933,621,13.6,0
"Breckinridge County, KY",KY,2021,8021,7601,420,5.2,203
"Breckinridge County, KY",KY,2020,7818,7268,550,7.0,-123
"Breckinridge County, KY",KY,2019,7941,7539,402,5.1,0
"Breckinridge County, KY",KY,2018,7941,7524,417,5.3,-78
"Breckinridge County, KY",KY,2017,8019,7548,471,5.9,283
"Breckinridge County, KY",KY,2016,7736,7256,480,6.2,85
"Breckinridge County, KY",KY,2015,7651,7185,466,6.1,-436
"Breckinridge County, KY",KY,2014,8087,7506,581,7.2,-157
"Breckinridge County, KY",KY,2013,8244,7495,749,9.1,-42
"Breckinridge County, KY",KY,2012,8286,7482,804,9.7,-13
"Breckinridge County, KY",KY,2011,8299,7343,956,11.5,-18
"Breckinridge County, KY",KY,2010,8317,7232,1085,13.0,0
"Bremer County, IA",IA,2021,13793,13351,442,3.2,10
"Bremer County, IA",IA,2020,13783,13259,524,3.8,-612
"Bremer County, IA",IA,2019,14395,14082,313,2.2,387
"Bremer County, IA",IA,2018,14008,13723,285,2.0,95
"Bremer County, IA",IA,2017,13913,13530,383,2.8,-66
"Bremer County, IA",IA,2016,13979,13483,496,3.5,10
"Bremer County, IA",IA,2015,13969,13483,486,3.5,-207
"Bremer County, IA",IA,2014,14176,13657,519,3.7,159
"Bremer County, IA",IA,2013,14017,13486,531,3.8,95
"Bremer County, IA",IA,2012,13922,13386,536,3.9,21
"Bremer County, IA",IA,2011,13901,13283,618,4.4,75
"Bremer County, IA",IA,2010,13826,13136,690,5.0,0
"Brevard County, FL",FL,2021,289653,277951,11702,4.0,8149
"Brevard County, FL",FL,2020,281504,261302,20202,7.2,82
"Brevard County, FL",FL,2019,281422,272198,9224,3.3,6871
"Brevard County, FL",FL,2018,274551,264555,9996,3.6,7778
"Brevard County, FL",FL,2017,266773,255041,11732,4.4,3355
"Brevard County, FL",FL,2016,263418,249817,13601,5.2,5961
"Brevard County, FL",FL,2015,257457,241882,15575,6.0,-112
"Brevard County, FL",FL,2014,257569,239073,18496,7.2,-589
"Brevard County, FL",FL,2013,258158,235821,22337,8.7,-2888
"Brevard County, FL",FL,2012,261046,235751,25295,9.7,-2633
"Brevard County, FL",FL,2011,263679,235001,28678,10.9,337
"Brevard County, FL",FL,2010,263342,234627,28715,10.9,0
"Brewster County, TX",TX,2021,4181,3991,190,4.5,112
"Brewster County, TX",TX,2020,4069,3800,269,6.6,-72
"Brewster County, TX",TX,2019,4141,4020,121,2.9,135
"Brewster County, TX",TX,2018,4006,3871,135,3.4,68
"Brewster County, TX",TX,2017,3938,3799,139,3.5,-25
"Brewster County, TX",TX,2016,3963,3814,149,3.8,52
"Brewster County, TX",TX,2015,3911,3756,155,4.0,-151
"Brewster County, TX",TX,2014,4062,3871,191,4.7,-84
"Brewster County, TX",TX,2013,4146,3914,232,5.6,-406
"Brewster County, TX",TX,2012,4552,4322,230,5.1,-304
"Brewster County, TX",TX,2011,4856,4577,279,5.7,-63
"Brewster County, TX",TX,2010,4919,4649,270,5.5,0
"Briscoe County, TX",TX,2021,574,547,27,4.7,25
"Briscoe County, TX",TX,2020,549,523,26,4.7,-22
"Briscoe County, TX",TX,2019,571,551,20,3.5,17
"Briscoe County, TX",TX,2018,554,532,22,4.0,4
"Briscoe County, TX",TX,2017,550,526,24,4.4,2
"Briscoe County, TX",TX,2016,548,524,24,4.4,-47
"Briscoe County, TX",TX,2015,595,572,23,3.9,-41
"Briscoe County, TX",TX,2014,636,609,27,4.2,8
"Briscoe County, TX",TX,2013,628,592,36,5.7,-14
"Briscoe County, TX",TX,2012,642,607,35,5.5,-80
"Briscoe County, TX",TX,2011,722,676,46,6.4,-13
"Briscoe County, TX",TX,2010,735,690,45,6.1,0
"Bristol Bay Borough, AK",AK,2021,449,424,25,5.6,56
"Bristol Bay Borough, AK",AK,2020,393,362,31,7.9,-56
"Bristol Bay Borough, AK",AK,2019,449,425,24,5.3,1
"Bristol Bay Borough, AK",AK,2018,448,423,25,5.6,27
"Bristol Bay Borough, AK",AK,2017,421,396,25,5.9,8
"Bristol Bay Borough, AK",AK,2016,413,385,28,6.8,33
"Bristol Bay Borough, AK",AK,2015,380,346,34,8.9,-115
"Bristol Bay Borough, AK",AK,2014,495,456,39,7.9,6
"Bristol Bay Borough, AK",AK,2013,489,445,44,9.0,10
"Bristol Bay Borough, AK",AK,2012,479,431,48,10.0,-37
"Bristol Bay Borough, AK",AK,2011,516,469,47,9.1,11
"Bristol Bay Borough, AK",AK,2010,505,454,51,10.1,0
"Bristol city, VA",VA,2021,7313,6966,347,4.7,-245
"Bristol city, VA",VA,2020,7558,6988,570,7.5,172
"Bristol city, VA",VA,2019,7386,7112,274,3.7,138
"Bristol city, VA",VA,2018,7248,6978,270,3.7,-167
"Bristol city, VA",VA,2017,7415,7084,331,4.5,-40
"Bristol city, VA",VA,2016,7455,7084,371,5.0,-86
"Bristol city, VA",VA,2015,7541,7143,398,5.3,-205
"Bristol city, VA",VA,2014,7746,7261,485,6.3,-76
"Bristol city, VA",VA,2013,7822,7289,533,6.8,-166
"Bristol city, VA",VA,2012,7988,7417,571,7.1,-96
"Bristol city, VA",VA,2011,8084,7416,668,8.3,93
"Bristol city, VA",VA,2010,7991,7270,721,9.0,0
"Bristol County, MA",MA,2021,299547,279940,19607,6.5,-431
"Bristol County, MA",MA,2020,299978,267445,32533,10.8,-5069
"Bristol County, MA",MA,2019,305047,293056,11991,3.9,168
"Bristol County, MA",MA,2018,304879,291498,13381,4.4,5948
"Bristol County, MA",MA,2017,298931,284403,14528,4.9,8241
"Bristol County, MA",MA,2016,290690,275900,14790,5.1,886
"Bristol County, MA",MA,2015,289804,272081,17723,6.1,773
"Bristol County, MA",MA,2014,289031,267763,21268,7.4,2234
"Bristol County, MA",MA,2013,286797,262075,24722,8.6,-347
"Bristol County, MA",MA,2012,287144,261994,25150,8.8,1005
"Bristol County, MA",MA,2011,286139,259243,26896,9.4,-480
"Bristol County, MA",MA,2010,286619,257175,29444,10.3,0
"Bristol County, RI",RI,2021,26496,25239,1257,4.7,447
"Bristol County, RI",RI,2020,26049,24111,1938,7.4,-595
"Bristol County, RI",RI,2019,26644,25844,800,3.0,-70
"Bristol County, RI",RI,2018,26714,25792,922,3.5,60
"Bristol County, RI",RI,2017,26654,25619,1035,3.9,522
"Bristol County, RI",RI,2016,26132,24919,1213,4.6,-67
"Bristol County, RI",RI,2015,26199,24805,1394,5.3,8
"Bristol County, RI",RI,2014,26191,24416,1775,6.8,-147
"Bristol County, RI",RI,2013,26338,24205,2133,8.1,57
"Bristol County, RI",RI,2012,26281,23960,2321,8.8,-102
"Bristol County, RI",RI,2011,26383,23852,2531,9.6,-785
"Bristol County, RI",RI,2010,27168,24421,2747,10.1,0
"Broadwater County, MT",MT,2021,2667,2560,107,4.0,17
"Broadwater County, MT",MT,2020,2650,2486,164,6.2,8
"Broadwater County, MT",MT,2019,2642,2534,108,4.1,-5
"Broadwater County, MT",MT,2018,2647,2541,106,4.0,45
"Broadwater County, MT",MT,2017,2602,2477,125,4.8,51
"Broadwater County, MT",MT,2016,2551,2421,130,5.1,64
"Broadwater County, MT",MT,2015,2487,2357,130,5.2,-15
"Broadwater County, MT",MT,2014,2502,2368,134,5.4,-7
"Broadwater County, MT",MT,2013,2509,2351,158,6.3,30
"Broadwater County, MT",MT,2012,2479,2299,180,7.3,-12
"Broadwater County, MT",MT,2011,2491,2316,175,7.0,-17
"Broadwater County, MT",MT,2010,2508,2325,183,7.3,0
"Bronx County, NY",NY,2021,606729,524483,82246,13.6,-10928
"Bronx County, NY",NY,2020,617657,517592,100065,16.2,-11926
"Bronx County, NY",NY,2019,629583,596668,32915,5.2,-98
"Bronx County, NY",NY,2018,629681,594200,35481,5.6,-3248
"Bronx County, NY",NY,2017,632929,593962,38967,6.2,29923
"Bronx County, NY",NY,2016,603006,560468,42538,7.1,75
"Bronx County, NY",NY,2015,602931,556946,45985,7.6,-270
"Bronx County, NY",NY,2014,603201,545610,57591,9.5,2676
"Bronx County, NY",NY,2013,600525,530049,70476,11.7,5640
"Bronx County, NY",NY,2012,594885,520367,74518,12.5,8666
"Bronx County, NY",NY,2011,586219,516013,70206,12.0,-586
"Bronx County, NY",NY,2010,586805,516105,70700,12.0,0
"Brooke County, WV",WV,2021,9939,9336,603,6.1,187
"Brooke County, WV",WV,2020,9752,8899,853,8.7,-236
"Brooke County, WV",WV,2019,9988,9468,520,5.2,34
"Brooke County, WV",WV,2018,9954,9357,597,6.0,119
"Brooke County, WV",WV,2017,9835,9236,599,6.1,-177
"Brooke County, WV",WV,2016,10012,9306,706,7.1,-192
"Brooke County, WV",WV,2015,10204,9475,729,7.1,5
"Brooke County, WV",WV,2014,10199,9473,726,7.1,-184
"Brooke County, WV",WV,2013,10383,9591,792,7.6,-263
"Brooke County, WV",WV,2012,10646,9747,899,8.4,-57
"Brooke County, WV",WV,2011,10703,9685,1018,9.5,-206
"Brooke County, WV",WV,2010,10909,9659,1250,11.5,0
"Brookings County, SD",SD,2021,18533,17940,593,3.2,127
"Brookings County, SD",SD,2020,18406,17649,757,4.1,-574
"Brookings County, SD",SD,2019,18980,18451,529,2.8,20
"Brookings County, SD",SD,2018,18960,18458,502,2.6,170
"Brookings County, SD",SD,2017,18790,18246,544,2.9,-193
"Brookings County, SD",SD,2016,18983,18457,526,2.8,299
"Brookings County, SD",SD,2015,18684,18146,538,2.9,375
"Brookings County, SD",SD,2014,18309,17747,562,3.1,421
"Brookings County, SD",SD,2013,17888,17289,599,3.3,16
"Brookings County, SD",SD,2012,17872,17209,663,3.7,-202
"Brookings County, SD",SD,2011,18074,17296,778,4.3,133
"Brookings County, SD",SD,2010,17941,17113,828,4.6,0
"Brooks County, GA",GA,2021,6821,6566,255,3.7,76
"Brooks County, GA",GA,2020,6745,6391,354,5.2,-140
"Brooks County, GA",GA,2019,6885,6641,244,3.5,-99
"Brooks County, GA",GA,2018,6984,6704,280,4.0,-127
"Brooks County, GA",GA,2017,7111,6788,323,4.5,101
"Brooks County, GA",GA,2016,7010,6638,372,5.3,205
"Brooks County, GA",GA,2015,6805,6386,419,6.2,186
"Brooks County, GA",GA,2014,6619,6141,478,7.2,-54
"Brooks County, GA",GA,2013,6673,6121,552,8.3,-111
"Brooks County, GA",GA,2012,6784,6172,612,9.0,-269
"Brooks County, GA",GA,2011,7053,6353,700,9.9,-275
"Brooks County, GA",GA,2010,7328,6614,714,9.7,0
"Brooks County, TX",TX,2021,2499,2268,231,9.2,-72
"Brooks County, TX",TX,2020,2571,2297,274,10.7,-15
"Brooks County, TX",TX,2019,2586,2454,132,5.1,157
"Brooks County, TX",TX,2018,2429,2272,157,6.5,14
"Brooks County, TX",TX,2017,2415,2214,201,8.3,-26
"Brooks County, TX",TX,2016,2441,2152,289,11.8,-163
"Brooks County, TX",TX,2015,2604,2344,260,10.0,-100
"Brooks County, TX",TX,2014,2704,2492,212,7.8,-57
"Brooks County, TX",TX,2013,2761,2510,251,9.1,46
"Brooks County, TX",TX,2012,2715,2479,236,8.7,22
"Brooks County, TX",TX,2011,2693,2397,296,11.0,96
"Brooks County, TX",TX,2010,2597,2285,312,12.0,0
"Broome County, NY",NY,2021,81423,77161,4262,5.2,-1918
"Broome County, NY",NY,2020,83341,76405,6936,8.3,-2030
"Broome County, NY",NY,2019,85371,81493,3878,4.5,-566
"Broome County, NY",NY,2018,85937,81778,4159,4.8,-164
"Broome County, NY",NY,2017,86101,81335,4766,5.5,185
"Broome County, NY",NY,2016,85916,81177,4739,5.5,-726
"Broome County, NY",NY,2015,86642,81430,5212,6.0,-1237
"Broome County, NY",NY,2014,87879,82002,5877,6.7,-3949
"Broome County, NY",NY,2013,91828,84512,7316,8.0,-2051
"Broome County, NY",NY,2012,93879,85603,8276,8.8,-976
"Broome County, NY",NY,2011,94855,86646,8209,8.7,-3076
"Broome County, NY",NY,2010,97931,89241,8690,8.9,0
"Broomfield County/city, CO",CO,2021,41167,39319,1848,4.5,758
"Broomfield County/city, CO",CO,2020,40409,37908,2501,6.2,262
"Broomfield County/city, CO",CO,2019,40147,39216,931,2.3,959
"Broomfield County/city, CO",CO,2018,39188,38132,1056,2.7,974
"Broomfield County/city, CO",CO,2017,38214,37289,925,2.4,1430
"Broomfield County/city, CO",CO,2016,36784,35767,1017,2.8,1238
"Broomfield County/city, CO",CO,2015,35546,34415,1131,3.2,1381
"Broomfield County/city, CO",CO,2014,34165,32727,1438,4.2,1396
"Broomfield County/city, CO",CO,2013,32769,30895,1874,5.7,594
"Broomfield County/city, CO",CO,2012,32175,30009,2166,6.7,491
"Broomfield County/city, CO",CO,2011,31684,29377,2307,7.3,266
"Broomfield County/city, CO",CO,2010,31418,28970,2448,7.8,0
"Broward County, FL",FL,2021,1029454,979064,50390,4.9,8433
"Broward County, FL",FL,2020,1021021,923137,97884,9.6,-11413
"Broward County, FL",FL,2019,1032434,1000261,32173,3.1,8122
"Broward County, FL",FL,2018,1024312,988673,35639,3.5,10298
"Broward County, FL",FL,2017,1014014,973134,40880,4.0,6755
"Broward County, FL",FL,2016,1007259,961500,45759,4.5,15226
"Broward County, FL",FL,2015,992033,940668,51365,5.2,6393
"Broward County, FL",FL,2014,985640,925482,60158,6.1,13907
"Broward County, FL",FL,2013,971733,903073,68660,7.1,14465
"Broward County, FL",FL,2012,957268,878506,78762,8.2,11097
"Broward County, FL",FL,2011,946171,856799,89372,9.4,17356
"Broward County, FL",FL,2010,928815,837443,91372,9.8,0
"Brown County, IL",IL,2021,3012,2937,75,2.5,31
"Brown County, IL",IL,2020,2981,2864,117,3.9,-28
"Brown County, IL",IL,2019,3009,2938,71,2.4,120
"Brown County, IL",IL,2018,2889,2814,75,2.6,24
"Brown County, IL",IL,2017,2865,2783,82,2.9,-3
"Brown County, IL",IL,2016,2868,2771,97,3.4,86
"Brown County, IL",IL,2015,2782,2683,99,3.6,49
"Brown County, IL",IL,2014,2733,2618,115,4.2,121
"Brown County, IL",IL,2013,2612,2452,160,6.1,-5
"Brown County, IL",IL,2012,2617,2460,157,6.0,28
"Brown County, IL",IL,2011,2589,2428,161,6.2,8
"Brown County, IL",IL,2010,2581,2400,181,7.0,0
"Brown County, IN",IN,2021,7637,7389,248,3.2,105
"Brown County, IN",IN,2020,7532,7018,514,6.8,-114
"Brown County, IN",IN,2019,7646,7418,228,3.0,-55
"Brown County, IN",IN,2018,7701,7460,241,3.1,145
"Brown County, IN",IN,2017,7556,7301,255,3.4,25
"Brown County, IN",IN,2016,7531,7232,299,4.0,89
"Brown County, IN",IN,2015,7442,7088,354,4.8,81
"Brown County, IN",IN,2014,7361,6922,439,6.0,32
"Brown County, IN",IN,2013,7329,6795,534,7.3,0
"Brown County, IN",IN,2012,7329,6751,578,7.9,-117
"Brown County, IN",IN,2011,7446,6775,671,9.0,-122
"Brown County, IN",IN,2010,7568,6803,765,10.1,0
"Brown County, KS",KS,2021,5143,5006,137,2.7,5
"Brown County, KS",KS,2020,5138,4917,221,4.3,-246
"Brown County, KS",KS,2019,5384,5217,167,3.1,-13
"Brown County, KS",KS,2018,5397,5237,160,3.0,37
"Brown County, KS",KS,2017,5360,5189,171,3.2,171
"Brown County, KS",KS,2016,5189,5001,188,3.6,-181
"Brown County, KS",KS,2015,5370,5156,214,4.0,-46
"Brown County, KS",KS,2014,5416,5196,220,4.1,-51
"Brown County, KS",KS,2013,5467,5193,274,5.0,211
"Brown County, KS",KS,2012,5256,4975,281,5.3,45
"Brown County, KS",KS,2011,5211,4905,306,5.9,-56
"Brown County, KS",KS,2010,5267,4922,345,6.6,0
"Brown County, MN",MN,2021,13430,13014,416,3.1,-873
"Brown County, MN",MN,2020,14303,13543,760,5.3,-231
"Brown County, MN",MN,2019,14534,13976,558,3.8,-12
"Brown County, MN",MN,2018,14546,14023,523,3.6,100
"Brown County, MN",MN,2017,14446,13905,541,3.7,-66
"Brown County, MN",MN,2016,14512,13904,608,4.2,-143
"Brown County, MN",MN,2015,14655,14043,612,4.2,430
"Brown County, MN",MN,2014,14225,13561,664,4.7,-314
"Brown County, MN",MN,2013,14539,13772,767,5.3,-295
"Brown County, MN",MN,2012,14834,13992,842,5.7,-241
"Brown County, MN",MN,2011,15075,14184,891,5.9,-39
"Brown County, MN",MN,2010,15114,14071,1043,6.9,0
"Brown County, NE",NE,2021,1436,1403,33,2.3,14
"Brown County, NE",NE,2020,1422,1384,38,2.7,8
"Brown County, NE",NE,2019,1414,1363,51,3.6,11
"Brown County, NE",NE,2018,1403,1355,48,3.4,-12
"Brown County, NE",NE,2017,1415,1368,47,3.3,27
"Brown County, NE",NE,2016,1388,1337,51,3.7,-12
"Brown County, NE",NE,2015,1400,1348,52,3.7,-21
"Brown County, NE",NE,2014,1421,1372,49,3.4,-11
"Brown County, NE",NE,2013,1432,1377,55,3.8,-17
"Brown County, NE",NE,2012,1449,1392,57,3.9,-16
"Brown County, NE",NE,2011,1465,1398,67,4.6,5
"Brown County, NE",NE,2010,1460,1390,70,4.8,0
"Brown County, OH",OH,2021,19366,18331,1035,5.3,129
"Brown County, OH",OH,2020,19237,17633,1604,8.3,-440
"Brown County, OH",OH,2019,19677,18688,989,5.0,134
"Brown County, OH",OH,2018,19543,18496,1047,5.4,-65
"Brown County, OH",OH,2017,19608,18488,1120,5.7,39
"Brown County, OH",OH,2016,19569,18429,1140,5.8,15
"Brown County, OH",OH,2015,19554,18323,1231,6.3,-182
"Brown County, OH",OH,2014,19736,18266,1470,7.4,-333
"Brown County, OH",OH,2013,20069,18034,2035,10.1,-84
"Brown County, OH",OH,2012,20153,18141,2012,10.0,-445
"Brown County, OH",OH,2011,20598,18162,2436,11.8,-558
"Brown County, OH",OH,2010,21156,18337,2819,13.3,0
"Brown County, SD",SD,2021,20545,19927,618,3.0,87
"Brown County, SD",SD,2020,20458,19617,841,4.1,-168
"Brown County, SD",SD,2019,20626,20086,540,2.6,-134
"Brown County, SD",SD,2018,20760,20220,540,2.6,-150
"Brown County, SD",SD,2017,20910,20333,577,2.8,-286
"Brown County, SD",SD,2016,21196,20623,573,2.7,70
"Brown County, SD",SD,2015,21126,20573,553,2.6,-33
"Brown County, SD",SD,2014,21159,20558,601,2.8,64
"Brown County, SD",SD,2013,21095,20422,673,3.2,9
"Brown County, SD",SD,2012,21086,20374,712,3.4,97
"Brown County, SD",SD,2011,20989,20204,785,3.7,-5
"Brown County, SD",SD,2010,20994,20196,798,3.8,0
"Brown County, TX",TX,2021,15267,14475,792,5.2,144
"Brown County, TX",TX,2020,15123,14143,980,6.5,-356
"Brown County, TX",TX,2019,15479,14904,575,3.7,-389
"Brown County, TX",TX,2018,15868,15272,596,3.8,-103
"Brown County, TX",TX,2017,15971,15347,624,3.9,-206
"Brown County, TX",TX,2016,16177,15473,704,4.4,277
"Brown County, TX",TX,2015,15900,15208,692,4.4,72
"Brown County, TX",TX,2014,15828,14998,830,5.2,-76
"Brown County, TX",TX,2013,15904,14868,1036,6.5,-128
"Brown County, TX",TX,2012,16032,14951,1081,6.7,-345
"Brown County, TX",TX,2011,16377,15019,1358,8.3,-80
"Brown County, TX",TX,2010,16457,15098,1359,8.3,0
"Brown County, WI",WI,2021,142598,137757,4841,3.4,758
"Brown County, WI",WI,2020,141840,133226,8614,6.1,-379
"Brown County, WI",WI,2019,142219,138014,4205,3.0,-925
"Brown County, WI",WI,2018,143144,139237,3907,2.7,-36
"Brown County, WI",WI,2017,143180,138992,4188,2.9,2386
"Brown County, WI",WI,2016,140794,135820,4974,3.5,1888
"Brown County, WI",WI,2015,138906,133376,5530,4.0,618
"Brown County, WI",WI,2014,138288,131689,6599,4.8,281
"Brown County, WI",WI,2013,138007,129515,8492,6.2,493
"Brown County, WI",WI,2012,137514,128632,8882,6.5,233
"Brown County, WI",WI,2011,137281,127649,9632,7.0,44
"Brown County, WI",WI,2010,137237,126621,10616,7.7,0
"Brule County, SD",SD,2021,2560,2495,65,2.5,104
"Brule County, SD",SD,2020,2456,2354,102,4.2,24
"Brule County, SD",SD,2019,2432,2366,66,2.7,-65
"Brule County, SD",SD,2018,2497,2435,62,2.5,21
"Brule County, SD",SD,2017,2476,2407,69,2.8,-8
"Brule County, SD",SD,2016,2484,2420,64,2.6,-68
"Brule County, SD",SD,2015,2552,2485,67,2.6,-32
"Brule County, SD",SD,2014,2584,2502,82,3.2,-38
"Brule County, SD",SD,2013,2622,2534,88,3.4,-54
"Brule County, SD",SD,2012,2676,2584,92,3.4,-64
"Brule County, SD",SD,2011,2740,2633,107,3.9,-8
"Brule County, SD",SD,2010,2748,2647,101,3.7,0
"Brunswick County, NC",NC,2021,54167,50920,3247,6.0,2388
"Brunswick County, NC",NC,2020,51779,47353,4426,8.5,-2373
"Brunswick County, NC",NC,2019,54152,51350,2802,5.2,1718
"Brunswick County, NC",NC,2018,52434,49625,2809,5.4,1822
"Brunswick County, NC",NC,2017,50612,47744,2868,5.7,1061
"Brunswick County, NC",NC,2016,49551,46354,3197,6.5,1073
"Brunswick County, NC",NC,2015,48478,44982,3496,7.2,793
"Brunswick County, NC",NC,2014,47685,44026,3659,7.7,-64
"Brunswick County, NC",NC,2013,47749,43204,4545,9.5,-32
"Brunswick County, NC",NC,2012,47781,42283,5498,11.5,510
"Brunswick County, NC",NC,2011,47271,41500,5771,12.2,579
"Brunswick County, NC",NC,2010,46692,40898,5794,12.4,0
"Brunswick County, VA",VA,2021,5708,5350,358,6.3,-243
"Brunswick County, VA",VA,2020,5951,5481,470,7.9,-164
"Brunswick County, VA",VA,2019,6115,5832,283,4.6,58
"Brunswick County, VA",VA,2018,6057,5760,297,4.9,-119
"Brunswick County, VA",VA,2017,6176,5852,324,5.2,-40
"Brunswick County, VA",VA,2016,6216,5852,364,5.9,-139
"Brunswick County, VA",VA,2015,6355,5928,427,6.7,-130
"Brunswick County, VA",VA,2014,6485,5971,514,7.9,-171
"Brunswick County, VA",VA,2013,6656,6046,610,9.2,-61
"Brunswick County, VA",VA,2012,6717,6051,666,9.9,-89
"Brunswick County, VA",VA,2011,6806,6089,717,10.5,-162
"Brunswick County, VA",VA,2010,6968,6165,803,11.5,0
"Bryan County, GA",GA,2021,19894,19321,573,2.9,791
"Bryan County, GA",GA,2020,19103,18121,982,5.1,-105
"Bryan County, GA",GA,2019,19208,18620,588,3.1,832
"Bryan County, GA",GA,2018,18376,17747,629,3.4,599
"Bryan County, GA",GA,2017,17777,17025,752,4.2,849
"Bryan County, GA",GA,2016,16928,16093,835,4.9,966
"Bryan County, GA",GA,2015,15962,15109,853,5.3,446
"Bryan County, GA",GA,2014,15516,14513,1003,6.5,118
"Bryan County, GA",GA,2013,15398,14260,1138,7.4,295
"Bryan County, GA",GA,2012,15103,13869,1234,8.2,412
"Bryan County, GA",GA,2011,14691,13329,1362,9.3,199
"Bryan County, GA",GA,2010,14492,13086,1406,9.7,0
"Bryan County, OK",OK,2021,21988,21266,722,3.3,-330
"Bryan County, OK",OK,2020,22318,21168,1150,5.2,953
"Bryan County, OK",OK,2019,21365,20744,621,2.9,487
"Bryan County, OK",OK,2018,20878,20242,636,3.0,570
"Bryan County, OK",OK,2017,20308,19571,737,3.6,818
"Bryan County, OK",OK,2016,19490,18680,810,4.2,1164
"Bryan County, OK",OK,2015,18326,17510,816,4.5,483
"Bryan County, OK",OK,2014,17843,17008,835,4.7,131
"Bryan County, OK",OK,2013,17712,16774,938,5.3,170
"Bryan County, OK",OK,2012,17542,16629,913,5.2,88
"Bryan County, OK",OK,2011,17454,16469,985,5.6,-1029
"Bryan County, OK",OK,2010,18483,17387,1096,5.9,0
"Buchanan County, IA",IA,2021,11178,10764,414,3.7,-30
"Buchanan County, IA",IA,2020,11208,10708,500,4.5,-409
"Buchanan County, IA",IA,2019,11617,11315,302,2.6,235
"Buchanan County, IA",IA,2018,11382,11091,291,2.6,177
"Buchanan County, IA",IA,2017,11205,10853,352,3.1,-54
"Buchanan County, IA",IA,2016,11259,10799,460,4.1,-54
"Buchanan County, IA",IA,2015,11313,10836,477,4.2,-152
"Buchanan County, IA",IA,2014,11465,10933,532,4.6,283
"Buchanan County, IA",IA,2013,11182,10652,530,4.7,113
"Buchanan County, IA",IA,2012,11069,10535,534,4.8,-146
"Buchanan County, IA",IA,2011,11215,10570,645,5.8,-107
"Buchanan County, IA",IA,2010,11322,10633,689,6.1,0
"Buchanan County, MO",MO,2021,43329,41689,1640,3.8,-264
"Buchanan County, MO",MO,2020,43593,41457,2136,4.9,-522
"Buchanan County, MO",MO,2019,44115,42835,1280,2.9,-172
"Buchanan County, MO",MO,2018,44287,42992,1295,2.9,-736
"Buchanan County, MO",MO,2017,45023,43428,1595,3.5,-1619
"Buchanan County, MO",MO,2016,46642,44741,1901,4.1,434
"Buchanan County, MO",MO,2015,46208,44045,2163,4.7,114
"Buchanan County, MO",MO,2014,46094,43456,2638,5.7,-353
"Buchanan County, MO",MO,2013,46447,43537,2910,6.3,37
"Buchanan County, MO",MO,2012,46410,43401,3009,6.5,164
"Buchanan County, MO",MO,2011,46246,42429,3817,8.3,-219
"Buchanan County, MO",MO,2010,46465,42236,4229,9.1,0
"Buchanan County, VA",VA,2021,6130,5717,413,6.7,-300
"Buchanan County, VA",VA,2020,6430,5823,607,9.4,-452
"Buchanan County, VA",VA,2019,6882,6504,378,5.5,-112
"Buchanan County, VA",VA,2018,6994,6616,378,5.4,-61
"Buchanan County, VA",VA,2017,7055,6561,494,7.0,195
"Buchanan County, VA",VA,2016,6860,6136,724,10.6,-438
"Buchanan County, VA",VA,2015,7298,6517,781,10.7,-490
"Buchanan County, VA",VA,2014,7788,6988,800,10.3,-371
"Buchanan County, VA",VA,2013,8159,7281,878,10.8,-410
"Buchanan County, VA",VA,2012,8569,7805,764,8.9,111
"Buchanan County, VA",VA,2011,8458,7740,718,8.5,119
"Buchanan County, VA",VA,2010,8339,7493,846,10.1,0
"Buckingham County, VA",VA,2021,6205,5879,326,5.3,-121
"Buckingham County, VA",VA,2020,6326,5863,463,7.3,-280
"Buckingham County, VA",VA,2019,6606,6335,271,4.1,232
"Buckingham County, VA",VA,2018,6374,6092,282,4.4,-3
"Buckingham County, VA",VA,2017,6377,6037,340,5.3,104
"Buckingham County, VA",VA,2016,6273,5939,334,5.3,-44
"Buckingham County, VA",VA,2015,6317,5948,369,5.8,-5
"Buckingham County, VA",VA,2014,6322,5900,422,6.7,-84
"Buckingham County, VA",VA,2013,6406,5910,496,7.7,-54
"Buckingham County, VA",VA,2012,6460,5920,540,8.4,-123
"Buckingham County, VA",VA,2011,6583,5955,628,9.5,0
"Buckingham County, VA",VA,2010,6583,5866,717,10.9,0
"Bucks County, PA",PA,2021,342596,324437,18159,5.3,-866
"Bucks County, PA",PA,2020,343462,315041,28421,8.3,-5174
"Bucks County, PA",PA,2019,348636,334924,13712,3.9,4209
"Bucks County, PA",PA,2018,344427,330950,13477,3.9,958
"Bucks County, PA",PA,2017,343469,328632,14837,4.3,2096
"Bucks County, PA",PA,2016,341373,325784,15589,4.6,3707
"Bucks County, PA",PA,2015,337666,321616,16050,4.8,2781
"Bucks County, PA",PA,2014,334885,317133,17752,5.3,-1186
"Bucks County, PA",PA,2013,336071,314645,21426,6.4,-1997
"Bucks County, PA",PA,2012,338068,314322,23746,7.0,2421
"Bucks County, PA",PA,2011,335647,311668,23979,7.1,-472
"Bucks County, PA",PA,2010,336119,311287,24832,7.4,0
"Buena Vista city, VA",VA,2021,2961,2846,115,3.9,-239
"Buena Vista city, VA",VA,2020,3200,3022,178,5.6,-308
"Buena Vista city, VA",VA,2019,3508,3414,94,2.7,124
"Buena Vista city, VA",VA,2018,3384,3279,105,3.1,-3
"Buena Vista city, VA",VA,2017,3387,3245,142,4.2,108
"Buena Vista city, VA",VA,2016,3279,3115,164,5.0,-28
"Buena Vista city, VA",VA,2015,3307,3141,166,5.0,-10
"Buena Vista city, VA",VA,2014,3317,3129,188,5.7,3
"Buena Vista city, VA",VA,2013,3314,3094,220,6.6,59
"Buena Vista city, VA",VA,2012,3255,3004,251,7.7,20
"Buena Vista city, VA",VA,2011,3235,2940,295,9.1,-20
"Buena Vista city, VA",VA,2010,3255,2923,332,10.2,0
"Buena Vista County, IA",IA,2021,11628,11260,368,3.2,-112
"Buena Vista County, IA",IA,2020,11740,11319,421,3.6,-205
"Buena Vista County, IA",IA,2019,11945,11707,238,2.0,236
"Buena Vista County, IA",IA,2018,11709,11465,244,2.1,50
"Buena Vista County, IA",IA,2017,11659,11361,298,2.6,88
"Buena Vista County, IA",IA,2016,11571,11167,404,3.5,-11
"Buena Vista County, IA",IA,2015,11582,11163,419,3.6,101
"Buena Vista County, IA",IA,2014,11481,11027,454,4.0,158
"Buena Vista County, IA",IA,2013,11323,10875,448,4.0,51
"Buena Vista County, IA",IA,2012,11272,10801,471,4.2,-113
"Buena Vista County, IA",IA,2011,11385,10862,523,4.6,-6
"Buena Vista County, IA",IA,2010,11391,10842,549,4.8,0
"Buffalo County, NE",NE,2021,28178,27617,561,2.0,313
"Buffalo County, NE",NE,2020,27865,26768,1097,3.9,-298
"Buffalo County, NE",NE,2019,28163,27429,734,2.6,154
"Buffalo County, NE",NE,2018,28009,27333,676,2.4,483
"Buffalo County, NE",NE,2017,27526,26850,676,2.5,155
"Buffalo County, NE",NE,2016,27371,26687,684,2.5,126
"Buffalo County, NE",NE,2015,27245,26582,663,2.4,-253
"Buffalo County, NE",NE,2014,27498,26745,753,2.7,147
"Buffalo County, NE",NE,2013,27351,26486,865,3.2,98
"Buffalo County, NE",NE,2012,27253,26378,875,3.2,378
"Buffalo County, NE",NE,2011,26875,25930,945,3.5,531
"Buffalo County, NE",NE,2010,26344,25371,973,3.7,0
"Buffalo County, SD",SD,2021,702,664,38,5.4,15
"Buffalo County, SD",SD,2020,687,635,52,7.6,20
"Buffalo County, SD",SD,2019,667,630,37,5.5,-37
"Buffalo County, SD",SD,2018,704,665,39,5.5,-2
"Buffalo County, SD",SD,2017,706,657,49,6.9,-24
"Buffalo County, SD",SD,2016,730,669,61,8.4,11
"Buffalo County, SD",SD,2015,719,669,50,7.0,-19
"Buffalo County, SD",SD,2014,738,682,56,7.6,-7
"Buffalo County, SD",SD,2013,745,680,65,8.7,-6
"Buffalo County, SD",SD,2012,751,682,69,9.2,10
"Buffalo County, SD",SD,2011,741,667,74,10.0,46
"Buffalo County, SD",SD,2010,695,618,77,11.1,0
"Buffalo County, WI",WI,2021,6371,6105,266,4.2,-48
"Buffalo County, WI",WI,2020,6419,5941,478,7.4,-55
"Buffalo County, WI",WI,2019,6474,6219,255,3.9,-145
"Buffalo County, WI",WI,2018,6619,6394,225,3.4,19
"Buffalo County, WI",WI,2017,6600,6355,245,3.7,47
"Buffalo County, WI",WI,2016,6553,6268,285,4.3,35
"Buffalo County, WI",WI,2015,6518,6206,312,4.8,64
"Buffalo County, WI",WI,2014,6454,6096,358,5.5,-96
"Buffalo County, WI",WI,2013,6550,6123,427,6.5,-81
"Buffalo County, WI",WI,2012,6631,6222,409,6.2,-310
"Buffalo County, WI",WI,2011,6941,6472,469,6.8,-262
"Buffalo County, WI",WI,2010,7203,6654,549,7.6,0
"Bullitt County, KY",KY,2021,42784,40800,1984,4.6,631
"Bullitt County, KY",KY,2020,42153,39551,2602,6.2,-1129
"Bullitt County, KY",KY,2019,43282,41592,1690,3.9,574
"Bullitt County, KY",KY,2018,42708,41035,1673,3.9,871
"Bullitt County, KY",KY,2017,41837,40109,1728,4.1,1303
"Bullitt County, KY",KY,2016,40534,38873,1661,4.1,1114
"Bullitt County, KY",KY,2015,39420,37652,1768,4.5,192
"Bullitt County, KY",KY,2014,39228,36963,2265,5.8,-454
"Bullitt County, KY",KY,2013,39682,36777,2905,7.3,398
"Bullitt County, KY",KY,2012,39284,36099,3185,8.1,236
"Bullitt County, KY",KY,2011,39048,35177,3871,9.9,30
"Bullitt County, KY",KY,2010,39018,34815,4203,10.8,0
"Bulloch County, GA",GA,2021,38062,36495,1567,4.1,884
"Bulloch County, GA",GA,2020,37178,34769,2409,6.5,-404
"Bulloch County, GA",GA,2019,37582,36072,1510,4.0,408
"Bulloch County, GA",GA,2018,37174,35567,1607,4.3,149
"Bulloch County, GA",GA,2017,37025,35145,1880,5.1,1060
"Bulloch County, GA",GA,2016,35965,33878,2087,5.8,1621
"Bulloch County, GA",GA,2015,34344,32226,2118,6.2,-142
"Bulloch County, GA",GA,2014,34486,31949,2537,7.4,357
"Bulloch County, GA",GA,2013,34129,31186,2943,8.6,328
"Bulloch County, GA",GA,2012,33801,30541,3260,9.6,371
"Bulloch County, GA",GA,2011,33430,29946,3484,10.4,197
"Bulloch County, GA",GA,2010,33233,29839,3394,10.2,0
"Bullock County, AL",AL,2021,4606,4422,184,4.0,-271
"Bullock County, AL",AL,2020,4877,4582,295,6.0,16
"Bullock County, AL",AL,2019,4861,4673,188,3.9,17
"Bullock County, AL",AL,2018,4844,4619,225,4.6,-46
"Bullock County, AL",AL,2017,4890,4644,246,5.0,105
"Bullock County, AL",AL,2016,4785,4457,328,6.9,20
"Bullock County, AL",AL,2015,4765,4385,380,8.0,27
"Bullock County, AL",AL,2014,4738,4323,415,8.8,-36
"Bullock County, AL",AL,2013,4774,4322,452,9.5,32
"Bullock County, AL",AL,2012,4742,4240,502,10.6,-87
"Bullock County, AL",AL,2011,4829,4274,555,11.5,-112
"Bullock County, AL",AL,2010,4941,4365,576,11.7,0
"Buncombe County, NC",NC,2021,136123,130418,5705,4.2,2615
"Buncombe County, NC",NC,2020,133508,122736,10772,8.1,-6019
"Buncombe County, NC",NC,2019,139527,135391,4136,3.0,2483
"Buncombe County, NC",NC,2018,137044,132876,4168,3.0,2387
"Buncombe County, NC",NC,2017,134657,130012,4645,3.4,706
"Buncombe County, NC",NC,2016,133951,128768,5183,3.9,3656
"Buncombe County, NC",NC,2015,130295,124676,5619,4.3,2487
"Buncombe County, NC",NC,2014,127808,121978,5830,4.6,-172
"Buncombe County, NC",NC,2013,127980,120533,7447,5.8,528
"Buncombe County, NC",NC,2012,127452,117988,9464,7.4,2115
"Buncombe County, NC",NC,2011,125337,115383,9954,7.9,1146
"Buncombe County, NC",NC,2010,124191,113649,10542,8.5,0
"Bureau County, IL",IL,2021,16347,15536,811,5.0,-30
"Bureau County, IL",IL,2020,16377,15110,1267,7.7,-848
"Bureau County, IL",IL,2019,17225,16457,768,4.5,-311
"Bureau County, IL",IL,2018,17536,16673,863,4.9,124
"Bureau County, IL",IL,2017,17412,16558,854,4.9,-38
"Bureau County, IL",IL,2016,17450,16393,1057,6.1,308
"Bureau County, IL",IL,2015,17142,16037,1105,6.4,-334
"Bureau County, IL",IL,2014,17476,16187,1289,7.4,-239
"Bureau County, IL",IL,2013,17715,16096,1619,9.1,-413
"Bureau County, IL",IL,2012,18128,16451,1677,9.3,-612
"Bureau County, IL",IL,2011,18740,16880,1860,9.9,-391
"Bureau County, IL",IL,2010,19131,17050,2081,10.9,0
"Burke County, GA",GA,2021,9156,8621,535,5.8,120
"Burke County, GA",GA,2020,9036,8391,645,7.1,-106
"Burke County, GA",GA,2019,9142,8652,490,5.4,-149
"Burke County, GA",GA,2018,9291,8719,572,6.2,-137
"Burke County, GA",GA,2017,9428,8752,676,7.2,184
"Burke County, GA",GA,2016,9244,8522,722,7.8,213
"Burke County, GA",GA,2015,9031,8285,746,8.3,-128
"Burke County, GA",GA,2014,9159,8236,923,10.1,-311
"Burke County, GA",GA,2013,9470,8342,1128,11.9,-208
"Burke County, GA",GA,2012,9678,8500,1178,12.2,-252
"Burke County, GA",GA,2011,9930,8681,1249,12.6,111
"Burke County, GA",GA,2010,9819,8611,1208,12.3,0
"Burke County, NC",NC,2021,39264,37481,1783,4.5,658
"Burke County, NC",NC,2020,38606,35905,2701,7.0,-1822
"Burke County, NC",NC,2019,40428,38941,1487,3.7,164
"Burke County, NC",NC,2018,40264,38784,1480,3.7,341
"Burke County, NC",NC,2017,39923,38249,1674,4.2,190
"Burke County, NC",NC,2016,39733,37798,1935,4.9,448
"Burke County, NC",NC,2015,39285,37103,2182,5.6,-84
"Burke County, NC",NC,2014,39369,36989,2380,6.0,-804
"Burke County, NC",NC,2013,40173,36937,3236,8.1,-875
"Burke County, NC",NC,2012,41048,36909,4139,10.1,-366
"Burke County, NC",NC,2011,41414,36680,4734,11.4,-415
"Burke County, NC",NC,2010,41829,36483,5346,12.8,0
"Burke County, ND",ND,2021,1046,1001,45,4.3,7
"Burke County, ND",ND,2020,1039,984,55,5.3,-43
"Burke County, ND",ND,2019,1082,1060,22,2.0,-8
"Burke County, ND",ND,2018,1090,1067,23,2.1,-15
"Burke County, ND",ND,2017,1105,1071,34,3.1,-38
"Burke County, ND",ND,2016,1143,1091,52,4.5,-29
"Burke County, ND",ND,2015,1172,1133,39,3.3,-111
"Burke County, ND",ND,2014,1283,1251,32,2.5,-89
"Burke County, ND",ND,2013,1372,1342,30,2.2,4
"Burke County, ND",ND,2012,1368,1342,26,1.9,136
"Burke County, ND",ND,2011,1232,1204,28,2.3,99
"Burke County, ND",ND,2010,1133,1102,31,2.7,0
"Burleigh County, ND",ND,2021,51696,50080,1616,3.1,398
"Burleigh County, ND",ND,2020,51298,49088,2210,4.3,708
"Burleigh County, ND",ND,2019,50590,49491,1099,2.2,312
"Burleigh County, ND",ND,2018,50278,49074,1204,2.4,-832
"Burleigh County, ND",ND,2017,51110,49873,1237,2.4,593
"Burleigh County, ND",ND,2016,50517,49212,1305,2.6,1944
"Burleigh County, ND",ND,2015,48573,47414,1159,2.4,1661
"Burleigh County, ND",ND,2014,46912,45789,1123,2.4,111
"Burleigh County, ND",ND,2013,46801,45644,1157,2.5,466
"Burleigh County, ND",ND,2012,46335,45084,1251,2.7,-249
"Burleigh County, ND",ND,2011,46584,45124,1460,3.1,157
"Burleigh County, ND",ND,2010,46427,44784,1643,3.5,0
"Burleson County, TX",TX,2021,8396,7977,419,5.0,322
"Burleson County, TX",TX,2020,8074,7560,514,6.4,-107
"Burleson County, TX",TX,2019,8181,7926,255,3.1,36
"Burleson County, TX",TX,2018,8145,7849,296,3.6,212
"Burleson County, TX",TX,2017,7933,7597,336,4.2,53
"Burleson County, TX",TX,2016,7880,7513,367,4.7,119
"Burleson County, TX",TX,2015,7761,7420,341,4.4,180
"Burleson County, TX",TX,2014,7581,7216,365,4.8,-101
"Burleson County, TX",TX,2013,7682,7204,478,6.2,34
"Burleson County, TX",TX,2012,7648,7170,478,6.3,-114
"Burleson County, TX",TX,2011,7762,7177,585,7.5,-119
"Burleson County, TX",TX,2010,7881,7258,623,7.9,0
"Burlington County, NJ",NJ,2021,242242,229429,12813,5.3,2986
"Burlington County, NJ",NJ,2020,239256,220269,18987,7.9,-1408
"Burlington County, NJ",NJ,2019,240664,233163,7501,3.1,4483
"Burlington County, NJ",NJ,2018,236181,227635,8546,3.6,-1541
"Burlington County, NJ",NJ,2017,237722,228177,9545,4.0,7312
"Burlington County, NJ",NJ,2016,230410,220184,10226,4.4,767
"Burlington County, NJ",NJ,2015,229643,217476,12167,5.3,1416
"Burlington County, NJ",NJ,2014,228227,213563,14664,6.4,-3082
"Burlington County, NJ",NJ,2013,231309,213110,18199,7.9,-3616
"Burlington County, NJ",NJ,2012,234925,214417,20508,8.7,-477
"Burlington County, NJ",NJ,2011,235402,214809,20593,8.7,-1491
"Burlington County, NJ",NJ,2010,236893,215253,21640,9.1,0
"Burnet County, TX",TX,2021,24594,23676,918,3.7,1077
"Burnet County, TX",TX,2020,23517,22399,1118,4.8,209
"Burnet County, TX",TX,2019,23308,22671,637,2.7,610
"Burnet County, TX",TX,2018,22698,22038,660,2.9,592
"Burnet County, TX",TX,2017,22106,21398,708,3.2,102
"Burnet County, TX",TX,2016,22004,21241,763,3.5,820
"Burnet County, TX",TX,2015,21184,20406,778,3.7,-284
"Burnet County, TX",TX,2014,21468,20531,937,4.4,710
"Burnet County, TX",TX,2013,20758,19613,1145,5.5,381
"Burnet County, TX",TX,2012,20377,19171,1206,5.9,-265
"Burnet County, TX",TX,2011,20642,19204,1438,7.0,326
"Burnet County, TX",TX,2010,20316,18933,1383,6.8,0
"Burnett County, WI",WI,2021,7415,7024,391,5.3,145
"Burnett County, WI",WI,2020,7270,6610,660,9.1,108
"Burnett County, WI",WI,2019,7162,6799,363,5.1,-160
"Burnett County, WI",WI,2018,7322,6987,335,4.6,-46
"Burnett County, WI",WI,2017,7368,7015,353,4.8,216
"Burnett County, WI",WI,2016,7152,6735,417,5.8,-97
"Burnett County, WI",WI,2015,7249,6754,495,6.8,-108
"Burnett County, WI",WI,2014,7357,6774,583,7.9,-125
"Burnett County, WI",WI,2013,7482,6852,630,8.4,-46
"Burnett County, WI",WI,2012,7528,6859,669,8.9,-32
"Burnett County, WI",WI,2011,7560,6802,758,10.0,-16
"Burnett County, WI",WI,2010,7576,6752,824,10.9,0
"Burt County, NE",NE,2021,3680,3590,90,2.4,86
"Burt County, NE",NE,2020,3594,3458,136,3.8,57
"Burt County, NE",NE,2019,3537,3418,119,3.4,37
"Burt County, NE",NE,2018,3500,3379,121,3.5,-37
"Burt County, NE",NE,2017,3537,3406,131,3.7,-29
"Burt County, NE",NE,2016,3566,3435,131,3.7,-58
"Burt County, NE",NE,2015,3624,3493,131,3.6,40
"Burt County, NE",NE,2014,3584,3445,139,3.9,-61
"Burt County, NE",NE,2013,3645,3483,162,4.4,-25
"Burt County, NE",NE,2012,3670,3501,169,4.6,31
"Burt County, NE",NE,2011,3639,3430,209,5.7,2
"Burt County, NE",NE,2010,3637,3417,220,6.0,0
"Butler County, AL",AL,2021,8796,8328,468,5.3,-440
"Butler County, AL",AL,2020,9236,8345,891,9.6,-81
"Butler County, AL",AL,2019,9317,8956,361,3.9,247
"Butler County, AL",AL,2018,9070,8642,428,4.7,24
"Butler County, AL",AL,2017,9046,8536,510,5.6,-70
"Butler County, AL",AL,2016,9116,8484,632,6.9,3
"Butler County, AL",AL,2015,9113,8417,696,7.6,-172
"Butler County, AL",AL,2014,9285,8496,789,8.5,141
"Butler County, AL",AL,2013,9144,8189,955,10.4,41
"Butler County, AL",AL,2012,9103,8029,1074,11.8,-77
"Butler County, AL",AL,2011,9180,8046,1134,12.4,-72
"Butler County, AL",AL,2010,9252,8015,1237,13.4,0
"Butler County, IA",IA,2021,7883,7587,296,3.8,143
"Butler County, IA",IA,2020,7740,7389,351,4.5,-315
"Butler County, IA",IA,2019,8055,7811,244,3.0,125
"Butler County, IA",IA,2018,7930,7713,217,2.7,-3
"Butler County, IA",IA,2017,7933,7653,280,3.5,-137
"Butler County, IA",IA,2016,8070,7722,348,4.3,-209
"Butler County, IA",IA,2015,8279,7920,359,4.3,-100
"Butler County, IA",IA,2014,8379,8026,353,4.2,106
"Butler County, IA",IA,2013,8273,7898,375,4.5,28
"Butler County, IA",IA,2012,8245,7871,374,4.5,39
"Butler County, IA",IA,2011,8206,7786,420,5.1,27
"Butler County, IA",IA,2010,8179,7675,504,6.2,0
"Butler County, KS",KS,2021,32456,31315,1141,3.5,73
"Butler County, KS",KS,2020,32383,30314,2069,6.4,-372
"Butler County, KS",KS,2019,32755,31713,1042,3.2,624
"Butler County, KS",KS,2018,32131,31054,1077,3.4,256
"Butler County, KS",KS,2017,31875,30680,1195,3.7,-465
"Butler County, KS",KS,2016,32340,30994,1346,4.2,221
"Butler County, KS",KS,2015,32119,30752,1367,4.3,123
"Butler County, KS",KS,2014,31996,30448,1548,4.8,99
"Butler County, KS",KS,2013,31897,30132,1765,5.5,-217
"Butler County, KS",KS,2012,32114,30120,1994,6.2,-477
"Butler County, KS",KS,2011,32591,30346,2245,6.9,-407
"Butler County, KS",KS,2010,32998,30473,2525,7.7,0
"Butler County, KY",KY,2021,4945,4719,226,4.6,87
"Butler County, KY",KY,2020,4858,4528,330,6.8,-284
"Butler County, KY",KY,2019,5142,4906,236,4.6,38
"Butler County, KY",KY,2018,5104,4859,245,4.8,-82
"Butler County, KY",KY,2017,5186,4906,280,5.4,25
"Butler County, KY",KY,2016,5161,4884,277,5.4,69
"Butler County, KY",KY,2015,5092,4795,297,5.8,-99
"Butler County, KY",KY,2014,5191,4804,387,7.5,-184
"Butler County, KY",KY,2013,5375,4888,487,9.1,-39
"Butler County, KY",KY,2012,5414,4925,489,9.0,-50
"Butler County, KY",KY,2011,5464,4880,584,10.7,-21
"Butler County, KY",KY,2010,5485,4822,663,12.1,0
"Butler County, MO",MO,2021,18037,17187,850,4.7,-83
"Butler County, MO",MO,2020,18120,16990,1130,6.2,264
"Butler County, MO",MO,2019,17856,17064,792,4.4,-224
"Butler County, MO",MO,2018,18080,17266,814,4.5,-406
"Butler County, MO",MO,2017,18486,17655,831,4.5,-285
"Butler County, MO",MO,2016,18771,17701,1070,5.7,-95
"Butler County, MO",MO,2015,18866,17674,1192,6.3,-156
"Butler County, MO",MO,2014,19022,17675,1347,7.1,366
"Butler County, MO",MO,2013,18656,17173,1483,7.9,87
"Butler County, MO",MO,2012,18569,16997,1572,8.5,-162
"Butler County, MO",MO,2011,18731,17008,1723,9.2,44
"Butler County, MO",MO,2010,18687,16910,1777,9.5,0
"Butler County, NE",NE,2021,4707,4605,102,2.2,83
"Butler County, NE",NE,2020,4624,4470,154,3.3,-49
"Butler County, NE",NE,2019,4673,4552,121,2.6,79
"Butler County, NE",NE,2018,4594,4484,110,2.4,-12
"Butler County, NE",NE,2017,4606,4476,130,2.8,-46
"Butler County, NE",NE,2016,4652,4503,149,3.2,-105
"Butler County, NE",NE,2015,4757,4625,132,2.8,-73
"Butler County, NE",NE,2014,4830,4688,142,2.9,55
"Butler County, NE",NE,2013,4775,4617,158,3.3,41
"Butler County, NE",NE,2012,4734,4581,153,3.2,-13
"Butler County, NE",NE,2011,4747,4567,180,3.8,104
"Butler County, NE",NE,2010,4643,4458,185,4.0,0
"Butler County, OH",OH,2021,195166,186387,8779,4.5,1649
"Butler County, OH",OH,2020,193517,179442,14075,7.3,-3541
"Butler County, OH",OH,2019,197058,189535,7523,3.8,2528
"Butler County, OH",OH,2018,194530,186487,8043,4.1,991
"Butler County, OH",OH,2017,193539,184966,8573,4.4,3357
"Butler County, OH",OH,2016,190182,181562,8620,4.5,2111
"Butler County, OH",OH,2015,188071,179345,8726,4.6,1016
"Butler County, OH",OH,2014,187055,176686,10369,5.5,880
"Butler County, OH",OH,2013,186175,172260,13915,7.5,-396
"Butler County, OH",OH,2012,186571,172291,14280,7.7,-1859
"Butler County, OH",OH,2011,188430,171329,17101,9.1,-2627
"Butler County, OH",OH,2010,191057,171808,19249,10.1,0
"Butler County, PA",PA,2021,98106,92616,5490,5.6,-1272
"Butler County, PA",PA,2020,99378,91640,7738,7.8,-1797
"Butler County, PA",PA,2019,101175,97139,4036,4.0,864
"Butler County, PA",PA,2018,100311,96263,4048,4.0,757
"Butler County, PA",PA,2017,99554,94928,4626,4.6,788
"Butler County, PA",PA,2016,98766,93817,4949,5.0,637
"Butler County, PA",PA,2015,98129,93410,4719,4.8,802
"Butler County, PA",PA,2014,97327,92344,4983,5.1,-252
"Butler County, PA",PA,2013,97579,91763,5816,6.0,-236
"Butler County, PA",PA,2012,97815,91658,6157,6.3,1352
"Butler County, PA",PA,2011,96463,90171,6292,6.5,960
"Butler County, PA",PA,2010,95503,88686,6817,7.1,0
"Butte County, CA",CA,2021,92031,85720,6311,6.9,-1049
"Butte County, CA",CA,2020,93080,84291,8789,9.4,-5016
"Butte County, CA",CA,2019,98096,93025,5071,5.2,-3714
"Butte County, CA",CA,2018,101810,96624,5186,5.1,-188
"Butte County, CA",CA,2017,101998,96056,5942,5.8,350
"Butte County, CA",CA,2016,101648,94909,6739,6.6,582
"Butte County, CA",CA,2015,101066,93766,7300,7.2,9
"Butte County, CA",CA,2014,101057,92215,8842,8.7,-351
"Butte County, CA",CA,2013,101408,90829,10579,10.4,596
"Butte County, CA",CA,2012,100812,88363,12449,12.3,282
"Butte County, CA",CA,2011,100530,86549,13981,13.9,-2183
"Butte County, CA",CA,2010,102713,88098,14615,14.2,0
"Butte County, ID",ID,2021,1447,1392,55,3.8,53
"Butte County, ID",ID,2020,1394,1343,51,3.7,8
"Butte County, ID",ID,2019,1386,1349,37,2.7,15
"Butte County, ID",ID,2018,1371,1326,45,3.3,30
"Butte County, ID",ID,2017,1341,1301,40,3.0,48
"Butte County, ID",ID,2016,1293,1241,52,4.0,15
"Butte County, ID",ID,2015,1278,1224,54,4.2,-19
"Butte County, ID",ID,2014,1297,1233,64,4.9,-12
"Butte County, ID",ID,2013,1309,1209,100,7.6,-32
"Butte County, ID",ID,2012,1341,1229,112,8.4,19
"Butte County, ID",ID,2011,1322,1217,105,7.9,-32
"Butte County, ID",ID,2010,1354,1259,95,7.0,0
"Butte County, SD",SD,2021,5013,4843,170,3.4,52
"Butte County, SD",SD,2020,4961,4711,250,5.0,-73
"Butte County, SD",SD,2019,5034,4888,146,2.9,10
"Butte County, SD",SD,2018,5024,4871,153,3.0,8
"Butte County, SD",SD,2017,5016,4852,164,3.3,-57
"Butte County, SD",SD,2016,5073,4896,177,3.5,-51
"Butte County, SD",SD,2015,5124,4953,171,3.3,1
"Butte County, SD",SD,2014,5123,4954,169,3.3,50
"Butte County, SD",SD,2013,5073,4880,193,3.8,48
"Butte County, SD",SD,2012,5025,4803,222,4.4,-48
"Butte County, SD",SD,2011,5073,4832,241,4.8,-63
"Butte County, SD",SD,2010,5136,4879,257,5.0,0
"Butts County, GA",GA,2021,11132,10727,405,3.6,288
"Butts County, GA",GA,2020,10844,10183,661,6.1,-155
"Butts County, GA",GA,2019,10999,10613,386,3.5,278
"Butts County, GA",GA,2018,10721,10278,443,4.1,-2
"Butts County, GA",GA,2017,10723,10203,520,4.8,344
"Butts County, GA",GA,2016,10379,9786,593,5.7,367
"Butts County, GA",GA,2015,10012,9335,677,6.8,0
"Butts County, GA",GA,2014,10012,9258,754,7.5,-171
"Butts County, GA",GA,2013,10183,9243,940,9.2,-153
"Butts County, GA",GA,2012,10336,9292,1044,10.1,-98
"Butts County, GA",GA,2011,10434,9260,1174,11.3,-87
"Butts County, GA",GA,2010,10521,9299,1222,11.6,0
"Cabarrus County, NC",NC,2021,109654,104845,4809,4.4,2483
"Cabarrus County, NC",NC,2020,107171,99996,7175,6.7,-1847
"Cabarrus County, NC",NC,2019,109018,105158,3860,3.5,3441
"Cabarrus County, NC",NC,2018,105577,101702,3875,3.7,2364
"Cabarrus County, NC",NC,2017,103213,98929,4284,4.2,2349
"Cabarrus County, NC",NC,2016,100864,96254,4610,4.6,3353
"Cabarrus County, NC",NC,2015,97511,92526,4985,5.1,3168
"Cabarrus County, NC",NC,2014,94343,89007,5336,5.7,1942
"Cabarrus County, NC",NC,2013,92401,85569,6832,7.4,266
"Cabarrus County, NC",NC,2012,92135,83642,8493,9.2,1828
"Cabarrus County, NC",NC,2011,90307,80923,9384,10.4,942
"Cabarrus County, NC",NC,2010,89365,79159,10206,11.4,0
"Cabell County, WV",WV,2021,41419,39500,1919,4.6,-10
"Cabell County, WV",WV,2020,41429,38200,3229,7.8,-15
"Cabell County, WV",WV,2019,41444,39714,1730,4.2,18
"Cabell County, WV",WV,2018,41426,39497,1929,4.7,-344
"Cabell County, WV",WV,2017,41770,39869,1901,4.6,421
"Cabell County, WV",WV,2016,41349,39356,1993,4.8,-441
"Cabell County, WV",WV,2015,41790,39572,2218,5.3,-751
"Cabell County, WV",WV,2014,42541,40245,2296,5.4,85
"Cabell County, WV",WV,2013,42456,40033,2423,5.7,-603
"Cabell County, WV",WV,2012,43059,40347,2712,6.3,152
"Cabell County, WV",WV,2011,42907,39927,2980,6.9,-323
"Cabell County, WV",WV,2010,43230,40108,3122,7.2,0
"Cabo Rojo Municipio, PR",PR,2021,15042,13772,1270,8.4,
"Cabo Rojo Municipio, PR",PR,2020,N.A.,N.A.,N.A.,N.A.,
"Cabo Rojo Municipio, PR",PR,2019,13596,12417,1179,8.7,-21
"Cabo Rojo Municipio, PR",PR,2018,13617,12195,1422,10.4,-329
"Cabo Rojo Municipio, PR",PR,2017,13946,12047,1899,13.6,-222
"Cabo Rojo Municipio, PR",PR,2016,14168,12405,1763,12.4,36
"Cabo Rojo Municipio, PR",PR,2015,14132,12404,1728,12.2,-259
"Cabo Rojo Municipio, PR",PR,2014,14391,11927,2464,17.1,-487
"Cabo Rojo Municipio, PR",PR,2013,14878,11878,3000,20.2,296
"Cabo Rojo Municipio, PR",PR,2012,14582,12333,2249,15.4,-346
"Cabo Rojo Municipio, PR",PR,2011,14928,12452,2476,16.6,-534
"Cabo Rojo Municipio, PR",PR,2010,15462,12898,2564,16.6,0
"Cache County, UT",UT,2021,68747,67395,1352,2.0,2841
"Cache County, UT",UT,2020,65906,63958,1948,3.0,802
"Cache County, UT",UT,2019,65104,63718,1386,2.1,1287
"Cache County, UT",UT,2018,63817,62209,1608,2.5,912
"Cache County, UT",UT,2017,62905,61219,1686,2.7,1879
"Cache County, UT",UT,2016,61026,59218,1808,3.0,1284
"Cache County, UT",UT,2015,59742,57948,1794,3.0,1335
"Cache County, UT",UT,2014,58407,56624,1783,3.1,1405
"Cache County, UT",UT,2013,57002,54930,2072,3.6,980
"Cache County, UT",UT,2012,56022,53809,2213,4.0,-184
"Cache County, UT",UT,2011,56206,53105,3101,5.5,-790
"Cache County, UT",UT,2010,56996,53470,3526,6.2,0
"Caddo County, OK",OK,2021,12011,11566,445,3.7,117
"Caddo County, OK",OK,2020,11894,11180,714,6.0,122
"Caddo County, OK",OK,2019,11772,11373,399,3.4,-302
"Caddo County, OK",OK,2018,12074,11660,414,3.4,-253
"Caddo County, OK",OK,2017,12327,11812,515,4.2,419
"Caddo County, OK",OK,2016,11908,11298,610,5.1,82
"Caddo County, OK",OK,2015,11826,11231,595,5.0,692
"Caddo County, OK",OK,2014,11134,10551,583,5.2,-228
"Caddo County, OK",OK,2013,11362,10670,692,6.1,-291
"Caddo County, OK",OK,2012,11653,10977,676,5.8,77
"Caddo County, OK",OK,2011,11576,10794,782,6.8,-240
"Caddo County, OK",OK,2010,11816,11028,788,6.7,0
"Caddo Parish, LA",LA,2021,101475,95172,6303,6.2,31
"Caddo Parish, LA",LA,2020,101444,91806,9638,9.5,-1891
"Caddo Parish, LA",LA,2019,103335,97997,5338,5.2,-1261
"Caddo Parish, LA",LA,2018,104596,98917,5679,5.4,-432
"Caddo Parish, LA",LA,2017,105028,98953,6075,5.8,-2141
"Caddo Parish, LA",LA,2016,107169,100070,7099,6.6,-2662
"Caddo Parish, LA",LA,2015,109831,102042,7789,7.1,-758
"Caddo Parish, LA",LA,2014,110589,102525,8064,7.3,-303
"Caddo Parish, LA",LA,2013,110892,102502,8390,7.6,-3127
"Caddo Parish, LA",LA,2012,114019,105631,8388,7.4,-2000
"Caddo Parish, LA",LA,2011,116019,107261,8758,7.5,-694
"Caddo Parish, LA",LA,2010,116713,107724,8989,7.7,0
"Caguas Municipio, PR",PR,2021,51110,47653,3457,6.8,
"Caguas Municipio, PR",PR,2020,N.A.,N.A.,N.A.,N.A.,
"Caguas Municipio, PR",PR,2019,47664,44432,3232,6.8,381
"Caguas Municipio, PR",PR,2018,47283,43609,3674,7.8,-221
"Caguas Municipio, PR",PR,2017,47504,43195,4309,9.1,-760
"Caguas Municipio, PR",PR,2016,48264,43281,4983,10.3,-181
"Caguas Municipio, PR",PR,2015,48445,43426,5019,10.4,-197
"Caguas Municipio, PR",PR,2014,48642,42911,5731,11.8,-1916
"Caguas Municipio, PR",PR,2013,50558,44534,6024,11.9,-1672
"Caguas Municipio, PR",PR,2012,52230,45171,7059,13.5,-690
"Caguas Municipio, PR",PR,2011,52920,44964,7956,15.0,-1892
"Caguas Municipio, PR",PR,2010,54812,46287,8525,15.6,0
"Calaveras County, CA",CA,2021,21402,20177,1225,5.7,87
"Calaveras County, CA",CA,2020,21315,19637,1678,7.9,-34
"Calaveras County, CA",CA,2019,21349,20522,827,3.9,186
"Calaveras County, CA",CA,2018,21163,20303,860,4.1,147
"Calaveras County, CA",CA,2017,21016,20014,1002,4.8,218
"Calaveras County, CA",CA,2016,20798,19615,1183,5.7,249
"Calaveras County, CA",CA,2015,20549,19231,1318,6.4,344
"Calaveras County, CA",CA,2014,20205,18569,1636,8.1,18
"Calaveras County, CA",CA,2013,20187,18157,2030,10.1,21
"Calaveras County, CA",CA,2012,20166,17634,2532,12.6,-479
"Calaveras County, CA",CA,2011,20645,17699,2946,14.3,-400
"Calaveras County, CA",CA,2010,21045,17931,3114,14.8,0
"Calcasieu Parish, LA",LA,2021,95934,90541,5393,5.6,-1398
"Calcasieu Parish, LA",LA,2020,97332,88018,9314,9.6,-9586
"Calcasieu Parish, LA",LA,2019,106918,102706,4212,3.9,-3268
"Calcasieu Parish, LA",LA,2018,110186,106015,4171,3.8,1572
"Calcasieu Parish, LA",LA,2017,108614,104315,4299,4.0,5613
"Calcasieu Parish, LA",LA,2016,103001,98072,4929,4.8,4192
"Calcasieu Parish, LA",LA,2015,98809,93523,5286,5.3,4670
"Calcasieu Parish, LA",LA,2014,94139,88684,5455,5.8,4747
"Calcasieu Parish, LA",LA,2013,89392,83855,5537,6.2,1086
"Calcasieu Parish, LA",LA,2012,88306,82494,5812,6.6,993
"Calcasieu Parish, LA",LA,2011,87313,80948,6365,7.3,-512
"Calcasieu Parish, LA",LA,2010,87825,81183,6642,7.6,0
"Caldwell County, KY",KY,2021,5910,5661,249,4.2,325
"Caldwell County, KY",KY,2020,5585,5253,332,5.9,107
"Caldwell County, KY",KY,2019,5478,5220,258,4.7,96
"Caldwell County, KY",KY,2018,5382,5133,249,4.6,41
"Caldwell County, KY",KY,2017,5341,5062,279,5.2,-15
"Caldwell County, KY",KY,2016,5356,5067,289,5.4,57
"Caldwell County, KY",KY,2015,5299,5006,293,5.5,-154
"Caldwell County, KY",KY,2014,5453,5099,354,6.5,-180
"Caldwell County, KY",KY,2013,5633,5176,457,8.1,-48
"Caldwell County, KY",KY,2012,5681,5205,476,8.4,-31
"Caldwell County, KY",KY,2011,5712,5164,548,9.6,-236
"Caldwell County, KY",KY,2010,5948,5315,633,10.6,0
"Caldwell County, MO",MO,2021,4298,4078,220,5.1,62
"Caldwell County, MO",MO,2020,4236,4011,225,5.3,-41
"Caldwell County, MO",MO,2019,4277,4148,129,3.0,-69
"Caldwell County, MO",MO,2018,4346,4211,135,3.1,-76
"Caldwell County, MO",MO,2017,4422,4243,179,4.0,-47
"Caldwell County, MO",MO,2016,4469,4259,210,4.7,101
"Caldwell County, MO",MO,2015,4368,4165,203,4.6,50
"Caldwell County, MO",MO,2014,4318,4080,238,5.5,-17
"Caldwell County, MO",MO,2013,4335,4042,293,6.8,-35
"Caldwell County, MO",MO,2012,4370,4055,315,7.2,-58
"Caldwell County, MO",MO,2011,4428,4037,391,8.8,-113
"Caldwell County, MO",MO,2010,4541,4110,431,9.5,0
"Caldwell County, NC",NC,2021,35073,33340,1733,4.9,480
"Caldwell County, NC",NC,2020,34593,31936,2657,7.7,-1487
"Caldwell County, NC",NC,2019,36080,34642,1438,4.0,198
"Caldwell County, NC",NC,2018,35882,34479,1403,3.9,-115
"Caldwell County, NC",NC,2017,35997,34392,1605,4.5,211
"Caldwell County, NC",NC,2016,35786,33928,1858,5.2,365
"Caldwell County, NC",NC,2015,35421,33234,2187,6.2,-66
"Caldwell County, NC",NC,2014,35487,32983,2504,7.1,-935
"Caldwell County, NC",NC,2013,36422,33027,3395,9.3,-813
"Caldwell County, NC",NC,2012,37235,32811,4424,11.9,-307
"Caldwell County, NC",NC,2011,37542,32571,4971,13.2,-792
"Caldwell County, NC",NC,2010,38334,32701,5633,14.7,0
"Caldwell County, TX",TX,2021,19988,19008,980,4.9,1174
"Caldwell County, TX",TX,2020,18814,17593,1221,6.5,-331
"Caldwell County, TX",TX,2019,19145,18492,653,3.4,237
"Caldwell County, TX",TX,2018,18908,18212,696,3.7,537
"Caldwell County, TX",TX,2017,18371,17645,726,4.0,419
"Caldwell County, TX",TX,2016,17952,17173,779,4.3,521
"Caldwell County, TX",TX,2015,17431,16669,762,4.4,213
"Caldwell County, TX",TX,2014,17218,16309,909,5.3,126
"Caldwell County, TX",TX,2013,17092,15961,1131,6.6,289
"Caldwell County, TX",TX,2012,16803,15605,1198,7.1,-50
"Caldwell County, TX",TX,2011,16853,15388,1465,8.7,169
"Caldwell County, TX",TX,2010,16684,15239,1445,8.7,0
"Caldwell Parish, LA",LA,2021,3670,3500,170,4.6,21
"Caldwell Parish, LA",LA,2020,3649,3361,288,7.9,-141
"Caldwell Parish, LA",LA,2019,3790,3567,223,5.9,-56
"Caldwell Parish, LA",LA,2018,3846,3627,219,5.7,-18
"Caldwell Parish, LA",LA,2017,3864,3644,220,5.7,-123
"Caldwell Parish, LA",LA,2016,3987,3682,305,7.6,-23
"Caldwell Parish, LA",LA,2015,4010,3679,331,8.3,-49
"Caldwell Parish, LA",LA,2014,4059,3750,309,7.6,100
"Caldwell Parish, LA",LA,2013,3959,3647,312,7.9,-58
"Caldwell Parish, LA",LA,2012,4017,3682,335,8.3,-98
"Caldwell Parish, LA",LA,2011,4115,3722,393,9.6,-56
"Caldwell Parish, LA",LA,2010,4171,3742,429,10.3,0
"Caledonia County, VT",VT,2021,14037,13516,521,3.7,-534
"Caledonia County, VT",VT,2020,14571,13698,873,6.0,-421
"Caledonia County, VT",VT,2019,14992,14555,437,2.9,-165
"Caledonia County, VT",VT,2018,15157,14667,490,3.2,47
"Caledonia County, VT",VT,2017,15110,14551,559,3.7,164
"Caledonia County, VT",VT,2016,14946,14345,601,4.0,-212
"Caledonia County, VT",VT,2015,15158,14460,698,4.6,-186
"Caledonia County, VT",VT,2014,15344,14597,747,4.9,-400
"Caledonia County, VT",VT,2013,15744,14908,836,5.3,-343
"Caledonia County, VT",VT,2012,16087,15113,974,6.1,-492
"Caledonia County, VT",VT,2011,16579,15520,1059,6.4,-226
"Caledonia County, VT",VT,2010,16805,15624,1181,7.0,0
"Calhoun County, AL",AL,2021,46118,44212,1906,4.1,-904
"Calhoun County, AL",AL,2020,47022,43367,3655,7.8,218
"Calhoun County, AL",AL,2019,46804,45064,1740,3.7,-1
"Calhoun County, AL",AL,2018,46805,44652,2153,4.6,501
"Calhoun County, AL",AL,2017,46304,43960,2344,5.1,854
"Calhoun County, AL",AL,2016,45450,42470,2980,6.6,-358
"Calhoun County, AL",AL,2015,45808,42566,3242,7.1,-1513
"Calhoun County, AL",AL,2014,47321,43562,3759,7.9,-1060
"Calhoun County, AL",AL,2013,48381,44068,4313,8.9,-1336
"Calhoun County, AL",AL,2012,49717,45196,4521,9.1,-1554
"Calhoun County, AL",AL,2011,51271,45986,5285,10.3,-306
"Calhoun County, AL",AL,2010,51577,45798,5779,11.2,0
"Calhoun County, AR",AR,2021,2392,2312,80,3.3,-24
"Calhoun County, AR",AR,2020,2416,2289,127,5.3,-21
"Calhoun County, AR",AR,2019,2437,2332,105,4.3,-4
"Calhoun County, AR",AR,2018,2441,2349,92,3.8,31
"Calhoun County, AR",AR,2017,2410,2316,94,3.9,14
"Calhoun County, AR",AR,2016,2396,2286,110,4.6,-33
"Calhoun County, AR",AR,2015,2429,2300,129,5.3,32
"Calhoun County, AR",AR,2014,2397,2244,153,6.4,-56
"Calhoun County, AR",AR,2013,2453,2259,194,7.9,-83
"Calhoun County, AR",AR,2012,2536,2317,219,8.6,-106
"Calhoun County, AR",AR,2011,2642,2402,240,9.1,-59
"Calhoun County, AR",AR,2010,2701,2474,227,8.4,0
"Calhoun County, FL",FL,2021,4866,4648,218,4.5,122
"Calhoun County, FL",FL,2020,4744,4479,265,5.6,-18
"Calhoun County, FL",FL,2019,4762,4569,193,4.1,-143
"Calhoun County, FL",FL,2018,4905,4690,215,4.4,-29
"Calhoun County, FL",FL,2017,4934,4690,244,4.9,-69
"Calhoun County, FL",FL,2016,5003,4713,290,5.8,43
"Calhoun County, FL",FL,2015,4960,4654,306,6.2,21
"Calhoun County, FL",FL,2014,4939,4586,353,7.1,33
"Calhoun County, FL",FL,2013,4906,4503,403,8.2,-154
"Calhoun County, FL",FL,2012,5060,4583,477,9.4,-152
"Calhoun County, FL",FL,2011,5212,4672,540,10.4,-57
"Calhoun County, FL",FL,2010,5269,4754,515,9.8,0
"Calhoun County, GA",GA,2021,2228,2138,90,4.0,-9
"Calhoun County, GA",GA,2020,2237,2122,115,5.1,-29
"Calhoun County, GA",GA,2019,2266,2182,84,3.7,16
"Calhoun County, GA",GA,2018,2250,2154,96,4.3,-19
"Calhoun County, GA",GA,2017,2269,2149,120,5.3,105
"Calhoun County, GA",GA,2016,2164,2040,124,5.7,59
"Calhoun County, GA",GA,2015,2105,1972,133,6.3,-31
"Calhoun County, GA",GA,2014,2136,1987,149,7.0,33
"Calhoun County, GA",GA,2013,2103,1933,170,8.1,-264
"Calhoun County, GA",GA,2012,2367,2185,182,7.7,-148
"Calhoun County, GA",GA,2011,2515,2307,208,8.3,-111
"Calhoun County, GA",GA,2010,2626,2393,233,8.9,0
"Calhoun County, IA",IA,2021,4061,3901,160,3.9,-41
"Calhoun County, IA",IA,2020,4102,3938,164,4.0,-235
"Calhoun County, IA",IA,2019,4337,4232,105,2.4,-9
"Calhoun County, IA",IA,2018,4346,4237,109,2.5,12
"Calhoun County, IA",IA,2017,4334,4204,130,3.0,-211
"Calhoun County, IA",IA,2016,4545,4375,170,3.7,90
"Calhoun County, IA",IA,2015,4455,4265,190,4.3,35
"Calhoun County, IA",IA,2014,4420,4207,213,4.8,53
"Calhoun County, IA",IA,2013,4367,4140,227,5.2,-79
"Calhoun County, IA",IA,2012,4446,4200,246,5.5,-82
"Calhoun County, IA",IA,2011,4528,4266,262,5.8,-116
"Calhoun County, IA",IA,2010,4644,4360,284,6.1,0
"Calhoun County, IL",IL,2021,2164,2061,103,4.8,-7
"Calhoun County, IL",IL,2020,2171,1999,172,7.9,-145
"Calhoun County, IL",IL,2019,2316,2213,103,4.4,-15
"Calhoun County, IL",IL,2018,2331,2211,120,5.1,-7
"Calhoun County, IL",IL,2017,2338,2212,126,5.4,-45
"Calhoun County, IL",IL,2016,2383,2237,146,6.1,38
"Calhoun County, IL",IL,2015,2345,2187,158,6.7,-20
"Calhoun County, IL",IL,2014,2365,2169,196,8.3,-49
"Calhoun County, IL",IL,2013,2414,2178,236,9.8,-21
"Calhoun County, IL",IL,2012,2435,2191,244,10.0,-62
"Calhoun County, IL",IL,2011,2497,2253,244,9.8,3
"Calhoun County, IL",IL,2010,2494,2241,253,10.1,0
"Calhoun County, MI",MI,2021,59357,55459,3898,6.6,-2398
"Calhoun County, MI",MI,2020,61755,55530,6225,10.1,-767
"Calhoun County, MI",MI,2019,62522,59910,2612,4.2,-620
"Calhoun County, MI",MI,2018,63142,60463,2679,4.2,-821
"Calhoun County, MI",MI,2017,63963,60884,3079,4.8,-622
"Calhoun County, MI",MI,2016,64585,61453,3132,4.8,124
"Calhoun County, MI",MI,2015,64461,61137,3324,5.2,250
"Calhoun County, MI",MI,2014,64211,60140,4071,6.3,1208
"Calhoun County, MI",MI,2013,63003,58086,4917,7.8,543
"Calhoun County, MI",MI,2012,62460,57308,5152,8.2,-622
"Calhoun County, MI",MI,2011,63082,57150,5932,9.4,-1316
"Calhoun County, MI",MI,2010,64398,57068,7330,11.4,0
"Calhoun County, MS",MS,2021,5422,5138,284,5.2,-92
"Calhoun County, MS",MS,2020,5514,5077,437,7.9,-67
"Calhoun County, MS",MS,2019,5581,5268,313,5.6,26
"Calhoun County, MS",MS,2018,5555,5289,266,4.8,-63
"Calhoun County, MS",MS,2017,5618,5348,270,4.8,-538
"Calhoun County, MS",MS,2016,6156,5819,337,5.5,36
"Calhoun County, MS",MS,2015,6120,5737,383,6.3,-99
"Calhoun County, MS",MS,2014,6219,5751,468,7.5,-187
"Calhoun County, MS",MS,2013,6406,5870,536,8.4,-414
"Calhoun County, MS",MS,2012,6820,6263,557,8.2,-313
"Calhoun County, MS",MS,2011,7133,6527,606,8.5,91
"Calhoun County, MS",MS,2010,7042,6409,633,9.0,0
"Calhoun County, SC",SC,2021,6411,6122,289,4.5,72
"Calhoun County, SC",SC,2020,6339,5960,379,6.0,-67
"Calhoun County, SC",SC,2019,6406,6181,225,3.5,34
"Calhoun County, SC",SC,2018,6372,6102,270,4.2,-225
"Calhoun County, SC",SC,2017,6597,6259,338,5.1,-281
"Calhoun County, SC",SC,2016,6878,6462,416,6.0,-9
"Calhoun County, SC",SC,2015,6887,6401,486,7.1,7
"Calhoun County, SC",SC,2014,6880,6343,537,7.8,-68
"Calhoun County, SC",SC,2013,6948,6299,649,9.3,-10
"Calhoun County, SC",SC,2012,6958,6195,763,11.0,-165
"Calhoun County, SC",SC,2011,7123,6252,871,12.2,15
"Calhoun County, SC",SC,2010,7108,6221,887,12.5,0
"Calhoun County, TX",TX,2021,12224,11625,599,4.9,379
"Calhoun County, TX",TX,2020,11845,11155,690,5.8,-138
"Calhoun County, TX",TX,2019,11983,11598,385,3.2,880
"Calhoun County, TX",TX,2018,11103,10644,459,4.1,684
"Calhoun County, TX",TX,2017,10419,9813,606,5.8,-361
"Calhoun County, TX",TX,2016,10780,10178,602,5.6,-553
"Calhoun County, TX",TX,2015,11333,10877,456,4.0,260
"Calhoun County, TX",TX,2014,11073,10538,535,4.8,251
"Calhoun County, TX",TX,2013,10822,10146,676,6.2,425
"Calhoun County, TX",TX,2012,10397,9638,759,7.3,-202
"Calhoun County, TX",TX,2011,10599,9667,932,8.8,403
"Calhoun County, TX",TX,2010,10196,9294,902,8.8,0
"Calhoun County, WV",WV,2021,2495,2237,258,10.3,4
"Calhoun County, WV",WV,2020,2491,2099,392,15.7,-71
"Calhoun County, WV",WV,2019,2562,2229,333,13.0,121
"Calhoun County, WV",WV,2018,2441,2189,252,10.3,20
"Calhoun County, WV",WV,2017,2421,2159,262,10.8,-209
"Calhoun County, WV",WV,2016,2630,2292,338,12.9,-160
"Calhoun County, WV",WV,2015,2790,2450,340,12.2,-140
"Calhoun County, WV",WV,2014,2930,2650,280,9.6,49
"Calhoun County, WV",WV,2013,2881,2593,288,10.0,42
"Calhoun County, WV",WV,2012,2839,2535,304,10.7,-23
"Calhoun County, WV",WV,2011,2862,2509,353,12.3,-42
"Calhoun County, WV",WV,2010,2904,2496,408,14.0,0
"Callahan County, TX",TX,2021,6134,5850,284,4.6,192
"Callahan County, TX",TX,2020,5942,5619,323,5.4,-45
"Callahan County, TX",TX,2019,5987,5802,185,3.1,61
"Callahan County, TX",TX,2018,5926,5725,201,3.4,59
"Callahan County, TX",TX,2017,5867,5652,215,3.7,59
"Callahan County, TX",TX,2016,5808,5560,248,4.3,75
"Callahan County, TX",TX,2015,5733,5487,246,4.3,-90
"Callahan County, TX",TX,2014,5823,5561,262,4.5,-82
"Callahan County, TX",TX,2013,5905,5564,341,5.8,-14
"Callahan County, TX",TX,2012,5919,5561,358,6.0,-95
"Callahan County, TX",TX,2011,6014,5569,445,7.4,4
"Callahan County, TX",TX,2010,6010,5572,438,7.3,0
"Callaway County, MO",MO,2021,21325,20598,727,3.4,-45
"Callaway County, MO",MO,2020,21370,20421,949,4.4,69
"Callaway County, MO",MO,2019,21301,20716,585,2.7,206
"Callaway County, MO",MO,2018,21095,20491,604,2.9,-311
"Callaway County, MO",MO,2017,21406,20664,742,3.5,-394
"Callaway County, MO",MO,2016,21800,20908,892,4.1,258
"Callaway County, MO",MO,2015,21542,20507,1035,4.8,-164
"Callaway County, MO",MO,2014,21706,20480,1226,5.6,143
"Callaway County, MO",MO,2013,21563,20254,1309,6.1,-114
"Callaway County, MO",MO,2012,21677,20291,1386,6.4,-298
"Callaway County, MO",MO,2011,21975,20270,1705,7.8,-309
"Callaway County, MO",MO,2010,22284,20453,1831,8.2,0
"Calloway County, KY",KY,2021,17608,16807,801,4.5,-167
"Calloway County, KY",KY,2020,17775,16707,1068,6.0,-951
"Calloway County, KY",KY,2019,18726,17999,727,3.9,-8
"Calloway County, KY",KY,2018,18734,18022,712,3.8,-64
"Calloway County, KY",KY,2017,18798,17987,811,4.3,104
"Calloway County, KY",KY,2016,18694,17860,834,4.5,150
"Calloway County, KY",KY,2015,18544,17693,851,4.6,-175
"Calloway County, KY",KY,2014,18719,17644,1075,5.7,572
"Calloway County, KY",KY,2013,18147,16842,1305,7.2,-166
"Calloway County, KY",KY,2012,18313,17013,1300,7.1,-754
"Calloway County, KY",KY,2011,19067,17643,1424,7.5,59
"Calloway County, KY",KY,2010,19008,17463,1545,8.1,0
"Calumet County, WI",WI,2021,27758,26984,774,2.8,354
"Calumet County, WI",WI,2020,27404,26108,1296,4.7,-210
"Calumet County, WI",WI,2019,27614,26875,739,2.7,-188
"Calumet County, WI",WI,2018,27802,27089,713,2.6,-192
"Calumet County, WI",WI,2017,27994,27217,777,2.8,344
"Calumet County, WI",WI,2016,27650,26782,868,3.1,252
"Calumet County, WI",WI,2015,27398,26443,955,3.5,282
"Calumet County, WI",WI,2014,27116,25996,1120,4.1,-59
"Calumet County, WI",WI,2013,27175,25755,1420,5.2,-96
"Calumet County, WI",WI,2012,27271,25837,1434,5.3,-193
"Calumet County, WI",WI,2011,27464,25878,1586,5.8,149
"Calumet County, WI",WI,2010,27315,25477,1838,6.7,0
"Calvert County, MD",MD,2021,48774,46537,2237,4.6,-925
"Calvert County, MD",MD,2020,49699,47128,2571,5.2,-1934
"Calvert County, MD",MD,2019,51633,50071,1562,3.0,1158
"Calvert County, MD",MD,2018,50475,48817,1658,3.3,440
"Calvert County, MD",MD,2017,50035,48289,1746,3.5,1285
"Calvert County, MD",MD,2016,48750,46930,1820,3.7,1757
"Calvert County, MD",MD,2015,46993,44875,2118,4.5,-219
"Calvert County, MD",MD,2014,47212,44735,2477,5.2,-545
"Calvert County, MD",MD,2013,47757,44952,2805,5.9,25
"Calvert County, MD",MD,2012,47732,44781,2951,6.2,2
"Calvert County, MD",MD,2011,47730,44595,3135,6.6,-171
"Calvert County, MD",MD,2010,47901,44522,3379,7.1,0
"Camas County, ID",ID,2021,704,680,24,3.4,13
"Camas County, ID",ID,2020,691,657,34,4.9,3
"Camas County, ID",ID,2019,688,668,20,2.9,-4
"Camas County, ID",ID,2018,692,676,16,2.3,5
"Camas County, ID",ID,2017,687,668,19,2.8,29
"Camas County, ID",ID,2016,658,635,23,3.5,9
"Camas County, ID",ID,2015,649,628,21,3.2,20
"Camas County, ID",ID,2014,629,598,31,4.9,-11
"Camas County, ID",ID,2013,640,594,46,7.2,-33
"Camas County, ID",ID,2012,673,609,64,9.5,35
"Camas County, ID",ID,2011,638,560,78,12.2,-6
"Camas County, ID",ID,2010,644,563,81,12.6,0
"Cambria County, PA",PA,2021,55668,51760,3908,7.0,-1320
"Cambria County, PA",PA,2020,56988,51562,5426,9.5,-1527
"Cambria County, PA",PA,2019,58515,55321,3194,5.5,-345
"Cambria County, PA",PA,2018,58860,55687,3173,5.4,-1359
"Cambria County, PA",PA,2017,60219,56525,3694,6.1,-1313
"Cambria County, PA",PA,2016,61532,57404,4128,6.7,-839
"Cambria County, PA",PA,2015,62371,58206,4165,6.7,-575
"Cambria County, PA",PA,2014,62946,58501,4445,7.1,-1434
"Cambria County, PA",PA,2013,64380,58948,5432,8.4,-1440
"Cambria County, PA",PA,2012,65820,60165,5655,8.6,-218
"Cambria County, PA",PA,2011,66038,60407,5631,8.5,-486
"Cambria County, PA",PA,2010,66524,60434,6090,9.2,0
"Camden County, GA",GA,2021,21658,20973,685,3.2,552
"Camden County, GA",GA,2020,21106,20100,1006,4.8,-186
"Camden County, GA",GA,2019,21292,20490,802,3.8,325
"Camden County, GA",GA,2018,20967,20075,892,4.3,-88
"Camden County, GA",GA,2017,21055,19979,1076,5.1,703
"Camden County, GA",GA,2016,20352,19164,1188,5.8,-1696
"Camden County, GA",GA,2015,22048,20804,1244,5.6,123
"Camden County, GA",GA,2014,21925,20471,1454,6.6,375
"Camden County, GA",GA,2013,21550,19890,1660,7.7,-257
"Camden County, GA",GA,2012,21807,19963,1844,8.5,696
"Camden County, GA",GA,2011,21111,19112,1999,9.5,357
"Camden County, GA",GA,2010,20754,18666,2088,10.1,0
"Camden County, MO",MO,2021,19270,18315,955,5.0,532
"Camden County, MO",MO,2020,18738,17442,1296,6.9,-17
"Camden County, MO",MO,2019,18755,17954,801,4.3,194
"Camden County, MO",MO,2018,18561,17788,773,4.2,-300
"Camden County, MO",MO,2017,18861,17961,900,4.8,156
"Camden County, MO",MO,2016,18705,17620,1085,5.8,61
"Camden County, MO",MO,2015,18644,17400,1244,6.7,-94
"Camden County, MO",MO,2014,18738,17206,1532,8.2,-19
"Camden County, MO",MO,2013,18757,17009,1748,9.3,-97
"Camden County, MO",MO,2012,18854,16996,1858,9.9,-215
"Camden County, MO",MO,2011,19069,16904,2165,11.4,-304
"Camden County, MO",MO,2010,19373,17069,2304,11.9,0
"Camden County, NC",NC,2021,4514,4336,178,3.9,68
"Camden County, NC",NC,2020,4446,4208,238,5.4,-220
"Camden County, NC",NC,2019,4666,4491,175,3.8,26
"Camden County, NC",NC,2018,4640,4464,176,3.8,-20
"Camden County, NC",NC,2017,4660,4457,203,4.4,17
"Camden County, NC",NC,2016,4643,4404,239,5.1,35
"Camden County, NC",NC,2015,4608,4347,261,5.7,55
"Camden County, NC",NC,2014,4553,4284,269,5.9,22
"Camden County, NC",NC,2013,4531,4218,313,6.9,-26
"Camden County, NC",NC,2012,4557,4191,366,8.0,-57
"Camden County, NC",NC,2011,4614,4221,393,8.5,2
"Camden County, NC",NC,2010,4612,4230,382,8.3,0
"Camden County, NJ",NJ,2021,266839,248814,18025,6.8,2156
"Camden County, NJ",NJ,2020,264683,238958,25725,9.7,973
"Camden County, NJ",NJ,2019,263710,253535,10175,3.9,4231
"Camden County, NJ",NJ,2018,259479,247900,11579,4.5,-1970
"Camden County, NJ",NJ,2017,261449,248410,13039,5.0,8596
"Camden County, NJ",NJ,2016,252853,239027,13826,5.5,773
"Camden County, NJ",NJ,2015,252080,235944,16136,6.4,721
"Camden County, NJ",NJ,2014,251359,232010,19349,7.7,-4975
"Camden County, NJ",NJ,2013,256334,231711,24623,9.6,-4970
"Camden County, NJ",NJ,2012,261304,233077,28227,10.8,-1145
"Camden County, NJ",NJ,2011,262449,233908,28541,10.9,-2193
"Camden County, NJ",NJ,2010,264642,235220,29422,11.1,0
"Cameron County, PA",PA,2021,2009,1855,154,7.7,-56
"Cameron County, PA",PA,2020,2065,1807,258,12.5,-50
"Cameron County, PA",PA,2019,2115,1987,128,6.1,-45
"Cameron County, PA",PA,2018,2160,2048,112,5.2,-56
"Cameron County, PA",PA,2017,2216,2062,154,6.9,-18
"Cameron County, PA",PA,2016,2234,2072,162,7.3,-31
"Cameron County, PA",PA,2015,2265,2100,165,7.3,-32
"Cameron County, PA",PA,2014,2297,2133,164,7.1,-48
"Cameron County, PA",PA,2013,2345,2125,220,9.4,-101
"Cameron County, PA",PA,2012,2446,2201,245,10.0,-57
"Cameron County, PA",PA,2011,2503,2241,262,10.5,-41
"Cameron County, PA",PA,2010,2544,2232,312,12.3,0
"Cameron County, TX",TX,2021,175073,160786,14287,8.2,5762
"Cameron County, TX",TX,2020,169311,152198,17113,10.1,4652
"Cameron County, TX",TX,2019,164659,155573,9086,5.5,303
"Cameron County, TX",TX,2018,164356,154162,10194,6.2,-695
"Cameron County, TX",TX,2017,165051,153499,11552,7.0,-1060
"Cameron County, TX",TX,2016,166111,154169,11942,7.2,2920
"Cameron County, TX",TX,2015,163191,151483,11708,7.2,-3013
"Cameron County, TX",TX,2014,166204,152175,14029,8.4,-606
"Cameron County, TX",TX,2013,166810,150060,16750,10.0,950
"Cameron County, TX",TX,2012,165860,148873,16987,10.2,-84
"Cameron County, TX",TX,2011,165944,146311,19633,11.8,3422
"Cameron County, TX",TX,2010,162522,144310,18212,11.2,0
"Cameron Parish, LA",LA,2021,3503,3381,122,3.5,-1
"Cameron Parish, LA",LA,2020,3504,3288,216,6.2,-457
"Cameron Parish, LA",LA,2019,3961,3819,142,3.6,-128
"Cameron Parish, LA",LA,2018,4089,3946,143,3.5,78
"Cameron Parish, LA",LA,2017,4011,3867,144,3.6,189
"Cameron Parish, LA",LA,2016,3822,3654,168,4.4,169
"Cameron Parish, LA",LA,2015,3653,3484,169,4.6,224
"Cameron Parish, LA",LA,2014,3429,3263,166,4.8,113
"Cameron Parish, LA",LA,2013,3316,3146,170,5.1,73
"Cameron Parish, LA",LA,2012,3243,3081,162,5.0,-22
"Cameron Parish, LA",LA,2011,3265,3087,178,5.5,-35
"Cameron Parish, LA",LA,2010,3300,3105,195,5.9,0
"Camp County, TX",TX,2021,5116,4812,304,5.9,164
"Camp County, TX",TX,2020,4952,4586,366,7.4,42
"Camp County, TX",TX,2019,4910,4704,206,4.2,-42
"Camp County, TX",TX,2018,4952,4708,244,4.9,-39
"Camp County, TX",TX,2017,4991,4706,285,5.7,-73
"Camp County, TX",TX,2016,5064,4717,347,6.9,-32
"Camp County, TX",TX,2015,5096,4781,315,6.2,-115
"Camp County, TX",TX,2014,5211,4889,322,6.2,-295
"Camp County, TX",TX,2013,5506,5098,408,7.4,15
"Camp County, TX",TX,2012,5491,5054,437,8.0,-189
"Camp County, TX",TX,2011,5680,5154,526,9.3,-29
"Camp County, TX",TX,2010,5709,5186,523,9.2,0
"Campbell County, KY",KY,2021,50276,48242,2034,4.0,730
"Campbell County, KY",KY,2020,49546,46891,2655,5.4,-1726
"Campbell County, KY",KY,2019,51272,49586,1686,3.3,782
"Campbell County, KY",KY,2018,50490,48871,1619,3.2,606
"Campbell County, KY",KY,2017,49884,48039,1845,3.7,1153
"Campbell County, KY",KY,2016,48731,46893,1838,3.8,938
"Campbell County, KY",KY,2015,47793,45840,1953,4.1,-106
"Campbell County, KY",KY,2014,47899,45428,2471,5.2,-870
"Campbell County, KY",KY,2013,48769,45596,3173,6.5,-63
"Campbell County, KY",KY,2012,48832,45436,3396,7.0,-96
"Campbell County, KY",KY,2011,48928,44884,4044,8.3,-29
"Campbell County, KY",KY,2010,48957,44467,4490,9.2,0
"Campbell County, SD",SD,2021,774,748,26,3.4,-6
"Campbell County, SD",SD,2020,780,754,26,3.3,15
"Campbell County, SD",SD,2019,765,741,24,3.1,-16
"Campbell County, SD",SD,2018,781,752,29,3.7,-50
"Campbell County, SD",SD,2017,831,805,26,3.1,-23
"Campbell County, SD",SD,2016,854,829,25,2.9,-1
"Campbell County, SD",SD,2015,855,830,25,2.9,-1
"Campbell County, SD",SD,2014,856,829,27,3.2,8
"Campbell County, SD",SD,2013,848,818,30,3.5,-22
"Campbell County, SD",SD,2012,870,840,30,3.4,-10
"Campbell County, SD",SD,2011,880,847,33,3.8,-32
"Campbell County, SD",SD,2010,912,873,39,4.3,0
"Campbell County, TN",TN,2021,14796,14092,704,4.8,209
"Campbell County, TN",TN,2020,14587,13489,1098,7.5,-330
"Campbell County, TN",TN,2019,14917,14230,687,4.6,233
"Campbell County, TN",TN,2018,14684,13983,701,4.8,50
"Campbell County, TN",TN,2017,14634,13872,762,5.2,-109
"Campbell County, TN",TN,2016,14743,13720,1023,6.9,86
"Campbell County, TN",TN,2015,14657,13504,1153,7.9,-118
"Campbell County, TN",TN,2014,14775,13388,1387,9.4,-520
"Campbell County, TN",TN,2013,15295,13607,1688,11.0,-428
"Campbell County, TN",TN,2012,15723,13955,1768,11.2,-366
"Campbell County, TN",TN,2011,16089,14176,1913,11.9,-64
"Campbell County, TN",TN,2010,16153,14100,2053,12.7,0
"Campbell County, VA",VA,2021,24996,24042,954,3.8,-763
"Campbell County, VA",VA,2020,25759,24261,1498,5.8,-619
"Campbell County, VA",VA,2019,26378,25566,812,3.1,230
"Campbell County, VA",VA,2018,26148,25273,875,3.3,-153
"Campbell County, VA",VA,2017,26301,25223,1078,4.1,328
"Campbell County, VA",VA,2016,25973,24840,1133,4.4,-355
"Campbell County, VA",VA,2015,26328,25100,1228,4.7,-397
"Campbell County, VA",VA,2014,26725,25317,1408,5.3,-217
"Campbell County, VA",VA,2013,26942,25375,1567,5.8,-102
"Campbell County, VA",VA,2012,27044,25331,1713,6.3,-516
"Campbell County, VA",VA,2011,27560,25594,1966,7.1,-233
"Campbell County, VA",VA,2010,27793,25601,2192,7.9,0
"Campbell County, WY",WY,2021,22000,20842,1158,5.3,-1166
"Campbell County, WY",WY,2020,23166,21591,1575,6.8,-148
"Campbell County, WY",WY,2019,23314,22424,890,3.8,211
"Campbell County, WY",WY,2018,23103,22156,947,4.1,11
"Campbell County, WY",WY,2017,23092,21934,1158,5.0,-1323
"Campbell County, WY",WY,2016,24415,22648,1767,7.2,-1184
"Campbell County, WY",WY,2015,25599,24606,993,3.9,-347
"Campbell County, WY",WY,2014,25946,25033,913,3.5,618
"Campbell County, WY",WY,2013,25328,24242,1086,4.3,-486
"Campbell County, WY",WY,2012,25814,24580,1234,4.8,278
"Campbell County, WY",WY,2011,25536,24202,1334,5.2,-629
"Campbell County, WY",WY,2010,26165,24466,1699,6.5,0
"Camuy Municipio, PR",PR,2021,10241,9478,763,7.5,
"Camuy Municipio, PR",PR,2020,N.A.,N.A.,N.A.,N.A.,
"Camuy Municipio, PR",PR,2019,9509,8696,813,8.5,197
"Camuy Municipio, PR",PR,2018,9312,8395,917,9.8,-75
"Camuy Municipio, PR",PR,2017,9387,8297,1090,11.6,-118
"Camuy Municipio, PR",PR,2016,9505,8330,1175,12.4,76
"Camuy Municipio, PR",PR,2015,9429,8217,1212,12.9,-199
"Camuy Municipio, PR",PR,2014,9628,8196,1432,14.9,-362
"Camuy Municipio, PR",PR,2013,9990,8486,1504,15.1,10
"Camuy Municipio, PR",PR,2012,9980,8551,1429,14.3,-365
"Camuy Municipio, PR",PR,2011,10345,8695,1650,15.9,-513
"Camuy Municipio, PR",PR,2010,10858,9067,1791,16.5,0
"Canadian County, OK",OK,2021,78317,75802,2515,3.2,1035
"Canadian County, OK",OK,2020,77282,72687,4595,5.9,1648
"Canadian County, OK",OK,2019,75634,73593,2041,2.7,2366
"Canadian County, OK",OK,2018,73268,71324,1944,2.7,2447
"Canadian County, OK",OK,2017,70821,68466,2355,3.3,1471
"Canadian County, OK",OK,2016,69350,66683,2667,3.8,1092
"Canadian County, OK",OK,2015,68258,65855,2403,3.5,2373
"Canadian County, OK",OK,2014,65885,63625,2260,3.4,1188
"Canadian County, OK",OK,2013,64697,62113,2584,4.0,1455
"Canadian County, OK",OK,2012,63242,60849,2393,3.8,1865
"Canadian County, OK",OK,2011,61377,58821,2556,4.2,1336
"Canadian County, OK",OK,2010,60041,57066,2975,5.0,0
"Candler County, GA",GA,2021,6009,5827,182,3.0,277
"Candler County, GA",GA,2020,5732,5482,250,4.4,109
"Candler County, GA",GA,2019,5623,5450,173,3.1,262
"Candler County, GA",GA,2018,5361,5176,185,3.5,82
"Candler County, GA",GA,2017,5279,5061,218,4.1,208
"Candler County, GA",GA,2016,5071,4825,246,4.9,161
"Candler County, GA",GA,2015,4910,4626,284,5.8,-157
"Candler County, GA",GA,2014,5067,4715,352,6.9,-28
"Candler County, GA",GA,2013,5095,4682,413,8.1,-73
"Candler County, GA",GA,2012,5168,4727,441,8.5,147
"Candler County, GA",GA,2011,5021,4544,477,9.5,93
"Candler County, GA",GA,2010,4928,4487,441,8.9,0
"Cannon County, TN",TN,2021,6657,6432,225,3.4,132
"Cannon County, TN",TN,2020,6525,6102,423,6.5,-148
"Cannon County, TN",TN,2019,6673,6468,205,3.1,238
"Cannon County, TN",TN,2018,6435,6232,203,3.2,229
"Cannon County, TN",TN,2017,6206,5986,220,3.5,182
"Cannon County, TN",TN,2016,6024,5744,280,4.6,155
"Cannon County, TN",TN,2015,5869,5533,336,5.7,65
"Cannon County, TN",TN,2014,5804,5434,370,6.4,-119
"Cannon County, TN",TN,2013,5923,5457,466,7.9,-98
"Cannon County, TN",TN,2012,6021,5501,520,8.6,-60
"Cannon County, TN",TN,2011,6081,5443,638,10.5,-8
"Cannon County, TN",TN,2010,6089,5399,690,11.3,0
"Canovanas Municipio, PR",PR,2021,17540,16282,1258,7.2,
"Canovanas Municipio, PR",PR,2020,N.A.,N.A.,N.A.,N.A.,
"Canovanas Municipio, PR",PR,2019,16116,15058,1058,6.6,181
"Canovanas Municipio, PR",PR,2018,15935,14682,1253,7.9,-78
"Canovanas Municipio, PR",PR,2017,16013,14452,1561,9.7,-261
"Canovanas Municipio, PR",PR,2016,16274,14404,1870,11.5,4
"Canovanas Municipio, PR",PR,2015,16270,14358,1912,11.8,91
"Canovanas Municipio, PR",PR,2014,16179,14067,2112,13.1,-248
"Canovanas Municipio, PR",PR,2013,16427,14276,2151,13.1,-299
"Canovanas Municipio, PR",PR,2012,16726,14402,2324,13.9,-286
"Canovanas Municipio, PR",PR,2011,17012,14218,2794,16.4,-687
"Canovanas Municipio, PR",PR,2010,17699,14543,3156,17.8,0
"Canyon County, ID",ID,2021,110244,105885,4359,4.0,3054
"Canyon County, ID",ID,2020,107190,100806,6384,6.0,1538
"Canyon County, ID",ID,2019,105652,102201,3451,3.3,4397
"Canyon County, ID",ID,2018,101255,98059,3196,3.2,4049
"Canyon County, ID",ID,2017,97206,93690,3516,3.6,3651
"Canyon County, ID",ID,2016,93555,89622,3933,4.2,2553
"Canyon County, ID",ID,2015,91002,86781,4221,4.6,2427
"Canyon County, ID",ID,2014,88575,83805,4770,5.4,-113
"Canyon County, ID",ID,2013,88688,81246,7442,8.4,1314
"Canyon County, ID",ID,2012,87374,79199,8175,9.4,1920
"Canyon County, ID",ID,2011,85454,76517,8937,10.5,554
"Canyon County, ID",ID,2010,84900,75463,9437,11.1,0
"Cape Girardeau County, MO",MO,2021,40445,38992,1453,3.6,70
"Cape Girardeau County, MO",MO,2020,40375,38321,2054,5.1,-240
"Cape Girardeau County, MO",MO,2019,40615,39493,1122,2.8,436
"Cape Girardeau County, MO",MO,2018,40179,39093,1086,2.7,399
"Cape Girardeau County, MO",MO,2017,39780,38406,1374,3.5,-931
"Cape Girardeau County, MO",MO,2016,40711,38952,1759,4.3,99
"Cape Girardeau County, MO",MO,2015,40612,38827,1785,4.4,95
"Cape Girardeau County, MO",MO,2014,40517,38296,2221,5.5,-269
"Cape Girardeau County, MO",MO,2013,40786,38417,2369,5.8,274
"Cape Girardeau County, MO",MO,2012,40512,38199,2313,5.7,38
"Cape Girardeau County, MO",MO,2011,40474,37691,2783,6.9,-387
"Cape Girardeau County, MO",MO,2010,40861,37890,2971,7.3,0
"Cape May County, NJ",NJ,2021,47377,43177,4200,8.9,1601
"Cape May County, NJ",NJ,2020,45776,39544,6232,13.6,-1926
"Cape May County, NJ",NJ,2019,47702,44433,3269,6.9,459
"Cape May County, NJ",NJ,2018,47243,43385,3858,8.2,-405
"Cape May County, NJ",NJ,2017,47648,43332,4316,9.1,868
"Cape May County, NJ",NJ,2016,46780,42204,4576,9.8,-1228
"Cape May County, NJ",NJ,2015,48008,42733,5275,11.0,-505
"Cape May County, NJ",NJ,2014,48513,42589,5924,12.2,-666
"Cape May County, NJ",NJ,2013,49179,42027,7152,14.5,-624
"Cape May County, NJ",NJ,2012,49803,42076,7727,15.5,311
"Cape May County, NJ",NJ,2011,49492,42134,7358,14.9,-730
"Cape May County, NJ",NJ,2010,50222,43082,7140,14.2,0
"Carbon County, MT",MT,2021,5662,5468,194,3.4,24
"Carbon County, MT",MT,2020,5638,5310,328,5.8,99
"Carbon County, MT",MT,2019,5539,5342,197,3.6,17
"Carbon County, MT",MT,2018,5522,5326,196,3.5,-13
"Carbon County, MT",MT,2017,5535,5331,204,3.7,117
"Carbon County, MT",MT,2016,5418,5196,222,4.1,-9
"Carbon County, MT",MT,2015,5427,5222,205,3.8,36
"Carbon County, MT",MT,2014,5391,5181,210,3.9,-10
"Carbon County, MT",MT,2013,5401,5162,239,4.4,69
"Carbon County, MT",MT,2012,5332,5090,242,4.5,39
"Carbon County, MT",MT,2011,5293,5003,290,5.5,-40
"Carbon County, MT",MT,2010,5333,4997,336,6.3,0
"Carbon County, PA",PA,2021,32079,29924,2155,6.7,113
"Carbon County, PA",PA,2020,31966,28839,3127,9.8,-553
"Carbon County, PA",PA,2019,32519,30723,1796,5.5,449
"Carbon County, PA",PA,2018,32070,30387,1683,5.2,281
"Carbon County, PA",PA,2017,31789,29992,1797,5.7,176
"Carbon County, PA",PA,2016,31613,29747,1866,5.9,136
"Carbon County, PA",PA,2015,31477,29534,1943,6.2,-89
"Carbon County, PA",PA,2014,31566,29301,2265,7.2,-530
"Carbon County, PA",PA,2013,32096,29202,2894,9.0,-135
"Carbon County, PA",PA,2012,32231,29075,3156,9.8,439
"Carbon County, PA",PA,2011,31792,28667,3125,9.8,126
"Carbon County, PA",PA,2010,31666,28416,3250,10.3,0
"Carbon County, UT",UT,2021,8424,8097,327,3.9,-176
"Carbon County, UT",UT,2020,8600,8146,454,5.3,17
"Carbon County, UT",UT,2019,8583,8271,312,3.6,52
"Carbon County, UT",UT,2018,8531,8170,361,4.2,218
"Carbon County, UT",UT,2017,8313,7906,407,4.9,15
"Carbon County, UT",UT,2016,8298,7819,479,5.8,-363
"Carbon County, UT",UT,2015,8661,8178,483,5.6,41
"Carbon County, UT",UT,2014,8620,8198,422,4.9,-189
"Carbon County, UT",UT,2013,8809,8298,511,5.8,-270
"Carbon County, UT",UT,2012,9079,8512,567,6.2,-411
"Carbon County, UT",UT,2011,9490,8737,753,7.9,-378
"Carbon County, UT",UT,2010,9868,9007,861,8.7,0
"Carbon County, WY",WY,2021,7884,7579,305,3.9,-41
"Carbon County, WY",WY,2020,7925,7562,363,4.6,126
"Carbon County, WY",WY,2019,7799,7527,272,3.5,-88
"Carbon County, WY",WY,2018,7887,7592,295,3.7,-37
"Carbon County, WY",WY,2017,7924,7597,327,4.1,-439
"Carbon County, WY",WY,2016,8363,7969,394,4.7,-5
"Carbon County, WY",WY,2015,8368,8061,307,3.7,26
"Carbon County, WY",WY,2014,8342,7993,349,4.2,85
"Carbon County, WY",WY,2013,8257,7897,360,4.4,137
"Carbon County, WY",WY,2012,8120,7687,433,5.3,66
"Carbon County, WY",WY,2011,8054,7544,510,6.3,-164
"Carbon County, WY",WY,2010,8218,7623,595,7.2,0
"Caribou County, ID",ID,2021,4128,4000,128,3.1,5
"Caribou County, ID",ID,2020,4123,3972,151,3.7,-22
"Caribou County, ID",ID,2019,4145,4032,113,2.7,250
"Caribou County, ID",ID,2018,3895,3785,110,2.8,5
"Caribou County, ID",ID,2017,3890,3768,122,3.1,98
"Caribou County, ID",ID,2016,3792,3661,131,3.5,24
"Caribou County, ID",ID,2015,3768,3624,144,3.8,-70
"Caribou County, ID",ID,2014,3838,3691,147,3.8,-90
"Caribou County, ID",ID,2013,3928,3697,231,5.9,-58
"Caribou County, ID",ID,2012,3986,3738,248,6.2,107
"Caribou County, ID",ID,2011,3879,3596,283,7.3,34
"Caribou County, ID",ID,2010,3845,3553,292,7.6,0
"Carlisle County, KY",KY,2021,2244,2158,86,3.8,82
"Carlisle County, KY",KY,2020,2162,2065,97,4.5,-77
"Carlisle County, KY",KY,2019,2239,2150,89,4.0,-16
"Carlisle County, KY",KY,2018,2255,2146,109,4.8,-130
"Carlisle County, KY",KY,2017,2385,2223,162,6.8,-180
"Carlisle County, KY",KY,2016,2565,2401,164,6.4,339
"Carlisle County, KY",KY,2015,2226,2096,130,5.8,-156
"Carlisle County, KY",KY,2014,2382,2240,142,6.0,5
"Carlisle County, KY",KY,2013,2377,2208,169,7.1,36
"Carlisle County, KY",KY,2012,2341,2154,187,8.0,29
"Carlisle County, KY",KY,2011,2312,2107,205,8.9,50
"Carlisle County, KY",KY,2010,2262,2055,207,9.2,0
"Carlton County, MN",MN,2021,17106,16421,685,4.0,-718
"Carlton County, MN",MN,2020,17824,16497,1327,7.4,-280
"Carlton County, MN",MN,2019,18104,17246,858,4.7,181
"Carlton County, MN",MN,2018,17923,17136,787,4.4,147
"Carlton County, MN",MN,2017,17776,16925,851,4.8,45
"Carlton County, MN",MN,2016,17731,16791,940,5.3,114
"Carlton County, MN",MN,2015,17617,16732,885,5.0,-15
"Carlton County, MN",MN,2014,17632,16686,946,5.4,101
"Carlton County, MN",MN,2013,17531,16466,1065,6.1,40
"Carlton County, MN",MN,2012,17491,16283,1208,6.9,-168
"Carlton County, MN",MN,2011,17659,16316,1343,7.6,-138
"Carlton County, MN",MN,2010,17797,16312,1485,8.3,0
"Carolina Municipio, PR",PR,2021,66051,61276,4775,7.2,
"Carolina Municipio, PR",PR,2020,N.A.,N.A.,N.A.,N.A.,
"Carolina Municipio, PR",PR,2019,60969,57379,3590,5.9,217
"Carolina Municipio, PR",PR,2018,60752,56627,4125,6.8,-353
"Carolina Municipio, PR",PR,2017,61105,56351,4754,7.8,-1059
"Carolina Municipio, PR",PR,2016,62164,56791,5373,8.6,-606
"Carolina Municipio, PR",PR,2015,62770,57222,5548,8.8,-267
"Carolina Municipio, PR",PR,2014,63037,56843,6194,9.8,-1535
"Carolina Municipio, PR",PR,2013,64572,58444,6128,9.5,-2209
"Carolina Municipio, PR",PR,2012,66781,59747,7034,10.5,-1393
"Carolina Municipio, PR",PR,2011,68174,59923,8251,12.1,-3237
"Carolina Municipio, PR",PR,2010,71411,62139,9272,13.0,0
"Caroline County, MD",MD,2021,17435,16609,826,4.7,-266
"Caroline County, MD",MD,2020,17701,16714,987,5.6,-977
"Caroline County, MD",MD,2019,18678,18036,642,3.4,182
"Caroline County, MD",MD,2018,18496,17843,653,3.5,281
"Caroline County, MD",MD,2017,18215,17466,749,4.1,572
"Caroline County, MD",MD,2016,17643,16830,813,4.6,183
"Caroline County, MD",MD,2015,17460,16525,935,5.4,54
"Caroline County, MD",MD,2014,17406,16332,1074,6.2,-272
"Caroline County, MD",MD,2013,17678,16464,1214,6.9,61
"Caroline County, MD",MD,2012,17617,16272,1345,7.6,124
"Caroline County, MD",MD,2011,17493,15967,1526,8.7,34
"Caroline County, MD",MD,2010,17459,15803,1656,9.5,0
"Caroline County, VA",VA,2021,14644,14012,632,4.3,-385
"Caroline County, VA",VA,2020,15029,14024,1005,6.7,-360
"Caroline County, VA",VA,2019,15389,14899,490,3.2,93
"Caroline County, VA",VA,2018,15296,14769,527,3.4,133
"Caroline County, VA",VA,2017,15163,14519,644,4.2,288
"Caroline County, VA",VA,2016,14875,14224,651,4.4,85
"Caroline County, VA",VA,2015,14790,14047,743,5.0,-29
"Caroline County, VA",VA,2014,14819,13922,897,6.1,240
"Caroline County, VA",VA,2013,14579,13573,1006,6.9,102
"Caroline County, VA",VA,2012,14477,13370,1107,7.6,27
"Caroline County, VA",VA,2011,14450,13157,1293,8.9,87
"Caroline County, VA",VA,2010,14363,12966,1397,9.7,0
"Carroll County, AR",AR,2021,12708,12279,429,3.4,-27
"Carroll County, AR",AR,2020,12735,12013,722,5.7,-95
"Carroll County, AR",AR,2019,12830,12439,391,3.0,226
"Carroll County, AR",AR,2018,12604,12204,400,3.2,-386
"Carroll County, AR",AR,2017,12990,12554,436,3.4,99
"Carroll County, AR",AR,2016,12891,12432,459,3.6,180
"Carroll County, AR",AR,2015,12711,12138,573,4.5,70
"Carroll County, AR",AR,2014,12641,12001,640,5.1,281
"Carroll County, AR",AR,2013,12360,11637,723,5.8,-179
"Carroll County, AR",AR,2012,12539,11778,761,6.1,-313
"Carroll County, AR",AR,2011,12852,11968,884,6.9,251
"Carroll County, AR",AR,2010,12601,11711,890,7.1,0
"Carroll County, GA",GA,2021,56140,54073,2067,3.7,1444
"Carroll County, GA",GA,2020,54696,51259,3437,6.3,-1075
"Carroll County, GA",GA,2019,55771,53746,2025,3.6,677
"Carroll County, GA",GA,2018,55094,52854,2240,4.1,-338
"Carroll County, GA",GA,2017,55432,52618,2814,5.1,1882
"Carroll County, GA",GA,2016,53550,50291,3259,6.1,2342
"Carroll County, GA",GA,2015,51208,47706,3502,6.8,-678
"Carroll County, GA",GA,2014,51886,47618,4268,8.2,98
"Carroll County, GA",GA,2013,51788,46833,4955,9.6,-41
"Carroll County, GA",GA,2012,51829,46582,5247,10.1,0
"Carroll County, GA",GA,2011,51829,45973,5856,11.3,-153
"Carroll County, GA",GA,2010,51982,45819,6163,11.9,0
"Carroll County, IA",IA,2021,10559,10232,327,3.1,-52
"Carroll County, IA",IA,2020,10611,10201,410,3.9,-551
"Carroll County, IA",IA,2019,11162,10957,205,1.8,185
"Carroll County, IA",IA,2018,10977,10773,204,1.9,-161
"Carroll County, IA",IA,2017,11138,10887,251,2.3,-199
"Carroll County, IA",IA,2016,11337,11049,288,2.5,33
"Carroll County, IA",IA,2015,11304,11011,293,2.6,79
"Carroll County, IA",IA,2014,11225,10871,354,3.2,-61
"Carroll County, IA",IA,2013,11286,10907,379,3.4,-96
"Carroll County, IA",IA,2012,11382,10954,428,3.8,-277
"Carroll County, IA",IA,2011,11659,11180,479,4.1,-21
"Carroll County, IA",IA,2010,11680,11168,512,4.4,0
"Carroll County, IL",IL,2021,7545,7226,319,4.2,113
"Carroll County, IL",IL,2020,7432,6892,540,7.3,42
"Carroll County, IL",IL,2019,7390,7101,289,3.9,-104
"Carroll County, IL",IL,2018,7494,7163,331,4.4,-136
"Carroll County, IL",IL,2017,7630,7277,353,4.6,-270
"Carroll County, IL",IL,2016,7900,7452,448,5.7,-50
"Carroll County, IL",IL,2015,7950,7516,434,5.5,102
"Carroll County, IL",IL,2014,7848,7342,506,6.4,-25
"Carroll County, IL",IL,2013,7873,7249,624,7.9,-154
"Carroll County, IL",IL,2012,8027,7366,661,8.2,-275
"Carroll County, IL",IL,2011,8302,7553,749,9.0,-226
"Carroll County, IL",IL,2010,8528,7633,895,10.5,0
"Carroll County, IN",IN,2021,9497,9219,278,2.9,89
"Carroll County, IN",IN,2020,9408,8816,592,6.3,-723
"Carroll County, IN",IN,2019,10131,9826,305,3.0,-107
"Carroll County, IN",IN,2018,10238,9906,332,3.2,166
"Carroll County, IN",IN,2017,10072,9730,342,3.4,-46
"Carroll County, IN",IN,2016,10118,9695,423,4.2,97
"Carroll County, IN",IN,2015,10021,9589,432,4.3,134
"Carroll County, IN",IN,2014,9887,9371,516,5.2,-36
"Carroll County, IN",IN,2013,9923,9238,685,6.9,-72
"Carroll County, IN",IN,2012,9995,9271,724,7.2,-154
"Carroll County, IN",IN,2011,10149,9322,827,8.1,-109
"Carroll County, IN",IN,2010,10258,9269,989,9.6,0
"Carroll County, KY",KY,2021,5391,5169,222,4.1,98
"Carroll County, KY",KY,2020,5293,4991,302,5.7,-41
"Carroll County, KY",KY,2019,5334,5135,199,3.7,87
"Carroll County, KY",KY,2018,5247,5038,209,4.0,243
"Carroll County, KY",KY,2017,5004,4777,227,4.5,-179
"Carroll County, KY",KY,2016,5183,4930,253,4.9,176
"Carroll County, KY",KY,2015,5007,4733,274,5.5,137
"Carroll County, KY",KY,2014,4870,4524,346,7.1,-298
"Carroll County, KY",KY,2013,5168,4700,468,9.1,100
"Carroll County, KY",KY,2012,5068,4547,521,10.3,-54
"Carroll County, KY",KY,2011,5122,4500,622,12.1,95
"Carroll County, KY",KY,2010,5027,4292,735,14.6,0
"Carroll County, MD",MD,2021,93816,89896,3920,4.2,-1212
"Carroll County, MD",MD,2020,95028,90205,4823,5.1,-3596
"Carroll County, MD",MD,2019,98624,95871,2753,2.8,1838
"Carroll County, MD",MD,2018,96786,93880,2906,3.0,1294
"Carroll County, MD",MD,2017,95492,92385,3107,3.3,2477
"Carroll County, MD",MD,2016,93015,89753,3262,3.5,1
"Carroll County, MD",MD,2015,93014,89165,3849,4.1,444
"Carroll County, MD",MD,2014,92570,88185,4385,4.7,-484
"Carroll County, MD",MD,2013,93054,87988,5066,5.4,-265
"Carroll County, MD",MD,2012,93319,87885,5434,5.8,455
"Carroll County, MD",MD,2011,92864,87107,5757,6.2,133
"Carroll County, MD",MD,2010,92731,86236,6495,7.0,0
"Carroll County, MO",MO,2021,4504,4306,198,4.4,-107
"Carroll County, MO",MO,2020,4611,4357,254,5.5,-158
"Carroll County, MO",MO,2019,4769,4623,146,3.1,113
"Carroll County, MO",MO,2018,4656,4512,144,3.1,-123
"Carroll County, MO",MO,2017,4779,4586,193,4.0,17
"Carroll County, MO",MO,2016,4762,4507,255,5.4,-27
"Carroll County, MO",MO,2015,4789,4494,295,6.2,66
"Carroll County, MO",MO,2014,4723,4383,340,7.2,58
"Carroll County, MO",MO,2013,4665,4320,345,7.4,95
"Carroll County, MO",MO,2012,4570,4176,394,8.6,-153
"Carroll County, MO",MO,2011,4723,4218,505,10.7,-51
"Carroll County, MO",MO,2010,4774,4231,543,11.4,0
"Carroll County, MS",MS,2021,3471,3269,202,5.8,80
"Carroll County, MS",MS,2020,3391,3134,257,7.6,-139
"Carroll County, MS",MS,2019,3530,3311,219,6.2,87
"Carroll County, MS",MS,2018,3443,3243,200,5.8,-83
"Carroll County, MS",MS,2017,3526,3315,211,6.0,-23
"Carroll County, MS",MS,2016,3549,3286,263,7.4,98
"Carroll County, MS",MS,2015,3451,3164,287,8.3,49
"Carroll County, MS",MS,2014,3402,3076,326,9.6,-72
"Carroll County, MS",MS,2013,3474,3109,365,10.5,-240
"Carroll County, MS",MS,2012,3714,3312,402,10.8,-98
"Carroll County, MS",MS,2011,3812,3358,454,11.9,-25
"Carroll County, MS",MS,2010,3837,3347,490,12.8,0
"Carroll County, NH",NH,2021,23067,22185,882,3.8,77
"Carroll County, NH",NH,2020,22990,21209,1781,7.7,-1095
"Carroll County, NH",NH,2019,24085,23461,624,2.6,231
"Carroll County, NH",NH,2018,23854,23226,628,2.6,179
"Carroll County, NH",NH,2017,23675,23019,656,2.8,-27
"Carroll County, NH",NH,2016,23702,23003,699,2.9,-131
"Carroll County, NH",NH,2015,23833,22997,836,3.5,-396
"Carroll County, NH",NH,2014,24229,23205,1024,4.2,-256
"Carroll County, NH",NH,2013,24485,23245,1240,5.1,-172
"Carroll County, NH",NH,2012,24657,23372,1285,5.2,-120
"Carroll County, NH",NH,2011,24777,23415,1362,5.5,-201
"Carroll County, NH",NH,2010,24978,23495,1483,5.9,0
"Carroll County, OH",OH,2021,12726,12006,720,5.7,-116
"Carroll County, OH",OH,2020,12842,11708,1134,8.8,-176
"Carroll County, OH",OH,2019,13018,12367,651,5.0,-20
"Carroll County, OH",OH,2018,13038,12349,689,5.3,-285
"Carroll County, OH",OH,2017,13323,12545,778,5.8,-168
"Carroll County, OH",OH,2016,13491,12562,929,6.9,97
"Carroll County, OH",OH,2015,13394,12587,807,6.0,-214
"Carroll County, OH",OH,2014,13608,12773,835,6.1,-83
"Carroll County, OH",OH,2013,13691,12612,1079,7.9,-107
"Carroll County, OH",OH,2012,13798,12704,1094,7.9,-271
"Carroll County, OH",OH,2011,14069,12638,1431,10.2,-324
"Carroll County, OH",OH,2010,14393,12519,1874,13.0,0
"Carroll County, TN",TN,2021,11437,10915,522,4.6,11
"Carroll County, TN",TN,2020,11426,10583,843,7.4,-629
"Carroll County, TN",TN,2019,12055,11473,582,4.8,-2
"Carroll County, TN",TN,2018,12057,11463,594,4.9,110
"Carroll County, TN",TN,2017,11947,11332,615,5.1,-84
"Carroll County, TN",TN,2016,12031,11219,812,6.7,-175
"Carroll County, TN",TN,2015,12206,11203,1003,8.2,-329
"Carroll County, TN",TN,2014,12535,11271,1264,10.1,-614
"Carroll County, TN",TN,2013,13149,11593,1556,11.8,-222
"Carroll County, TN",TN,2012,13371,11885,1486,11.1,-287
"Carroll County, TN",TN,2011,13658,11979,1679,12.3,-203
"Carroll County, TN",TN,2010,13861,11800,2061,14.9,0
"Carroll County, VA",VA,2021,12778,12255,523,4.1,-417
"Carroll County, VA",VA,2020,13195,12116,1079,8.2,-256
"Carroll County, VA",VA,2019,13451,12976,475,3.5,31
"Carroll County, VA",VA,2018,13420,12941,479,3.6,-217
"Carroll County, VA",VA,2017,13637,13040,597,4.4,660
"Carroll County, VA",VA,2016,12977,12321,656,5.1,-123
"Carroll County, VA",VA,2015,13100,12409,691,5.3,-129
"Carroll County, VA",VA,2014,13229,12357,872,6.6,-27
"Carroll County, VA",VA,2013,13256,12185,1071,8.1,-211
"Carroll County, VA",VA,2012,13467,12341,1126,8.4,-135
"Carroll County, VA",VA,2011,13602,12267,1335,9.8,-430
"Carroll County, VA",VA,2010,14032,12382,1650,11.8,0
"Carson City, NV",NV,2021,25665,24434,1231,4.8,108
"Carson City, NV",NV,2020,25557,23362,2195,8.6,-628
"Carson City, NV",NV,2019,26185,25124,1061,4.1,673
"Carson City, NV",NV,2018,25512,24349,1163,4.6,369
"Carson City, NV",NV,2017,25143,23882,1261,5.0,614
"Carson City, NV",NV,2016,24529,23017,1512,6.2,-72
"Carson City, NV",NV,2015,24601,22808,1793,7.3,-151
"Carson City, NV",NV,2014,24752,22548,2204,8.9,-462
"Carson City, NV",NV,2013,25214,22498,2716,10.8,-506
"Carson City, NV",NV,2012,25720,22588,3132,12.2,-555
"Carson City, NV",NV,2011,26275,22734,3541,13.5,-431
"Carson City, NV",NV,2010,26706,23056,3650,13.7,0
"Carson County, TX",TX,2021,2958,2844,114,3.9,104
"Carson County, TX",TX,2020,2854,2734,120,4.2,-91
"Carson County, TX",TX,2019,2945,2869,76,2.6,-21
"Carson County, TX",TX,2018,2966,2882,84,2.8,-41
"Carson County, TX",TX,2017,3007,2909,98,3.3,-91
"Carson County, TX",TX,2016,3098,2997,101,3.3,29
"Carson County, TX",TX,2015,3069,2970,99,3.2,-76
"Carson County, TX",TX,2014,3145,3038,107,3.4,-26
"Carson County, TX",TX,2013,3171,3029,142,4.5,-112
"Carson County, TX",TX,2012,3283,3135,148,4.5,-137
"Carson County, TX",TX,2011,3420,3244,176,5.1,64
"Carson County, TX",TX,2010,3356,3173,183,5.5,0
"Carter County, KY",KY,2021,9695,8940,755,7.8,173
"Carter County, KY",KY,2020,9522,8635,887,9.3,-202
"Carter County, KY",KY,2019,9724,8957,767,7.9,-96
"Carter County, KY",KY,2018,9820,8937,883,9.0,-92
"Carter County, KY",KY,2017,9912,8955,957,9.7,-22
"Carter County, KY",KY,2016,9934,8899,1035,10.4,5
"Carter County, KY",KY,2015,9929,8937,992,10.0,-556
"Carter County, KY",KY,2014,10485,9364,1121,10.7,-546
"Carter County, KY",KY,2013,11031,9647,1384,12.5,-469
"Carter County, KY",KY,2012,11500,10056,1444,12.6,-223
"Carter County, KY",KY,2011,11723,10108,1615,13.8,-267
"Carter County, KY",KY,2010,11990,10286,1704,14.2,0
"Carter County, MO",MO,2021,2571,2438,133,5.2,53
"Carter County, MO",MO,2020,2518,2355,163,6.5,3
"Carter County, MO",MO,2019,2515,2398,117,4.7,14
"Carter County, MO",MO,2018,2501,2376,125,5.0,-26
"Carter County, MO",MO,2017,2527,2380,147,5.8,-13
"Carter County, MO",MO,2016,2540,2360,180,7.1,44
"Carter County, MO",MO,2015,2496,2307,189,7.6,-52
"Carter County, MO",MO,2014,2548,2319,229,9.0,7
"Carter County, MO",MO,2013,2541,2296,245,9.6,9
"Carter County, MO",MO,2012,2532,2285,247,9.8,-96
"Carter County, MO",MO,2011,2628,2326,302,11.5,-27
"Carter County, MO",MO,2010,2655,2351,304,11.5,0
"Carter County, MT",MT,2021,650,633,17,2.6,3
"Carter County, MT",MT,2020,647,629,18,2.8,-16
"Carter County, MT",MT,2019,663,644,19,2.9,-9
"Carter County, MT",MT,2018,672,655,17,2.5,-28
"Carter County, MT",MT,2017,700,682,18,2.6,4
"Carter County, MT",MT,2016,696,676,20,2.9,10
"Carter County, MT",MT,2015,686,663,23,3.4,-1
"Carter County, MT",MT,2014,687,665,22,3.2,14
"Carter County, MT",MT,2013,673,652,21,3.1,-14
"Carter County, MT",MT,2012,687,665,22,3.2,2
"Carter County, MT",MT,2011,685,659,26,3.8,-40
"Carter County, MT",MT,2010,725,698,27,3.7,0
"Carter County, OK",OK,2021,21388,20447,941,4.4,149
"Carter County, OK",OK,2020,21239,19729,1510,7.1,-161
"Carter County, OK",OK,2019,21400,20704,696,3.3,-647
"Carter County, OK",OK,2018,22047,21305,742,3.4,-323
"Carter County, OK",OK,2017,22370,21413,957,4.3,-320
"Carter County, OK",OK,2016,22690,21557,1133,5.0,150
"Carter County, OK",OK,2015,22540,21541,999,4.4,529
"Carter County, OK",OK,2014,22011,21066,945,4.3,8
"Carter County, OK",OK,2013,22003,20868,1135,5.2,174
"Carter County, OK",OK,2012,21829,20659,1170,5.4,249
"Carter County, OK",OK,2011,21580,20262,1318,6.1,424
"Carter County, OK",OK,2010,21156,19711,1445,6.8,0
"Carter County, TN",TN,2021,24094,23081,1013,4.2,415
"Carter County, TN",TN,2020,23679,22074,1605,6.8,-487
"Carter County, TN",TN,2019,24166,23185,981,4.1,268
"Carter County, TN",TN,2018,23898,22907,991,4.1,-4
"Carter County, TN",TN,2017,23902,22813,1089,4.6,217
"Carter County, TN",TN,2016,23685,22342,1343,5.7,110
"Carter County, TN",TN,2015,23575,22069,1506,6.4,-305
"Carter County, TN",TN,2014,23880,22036,1844,7.7,-984
"Carter County, TN",TN,2013,24864,22580,2284,9.2,-609
"Carter County, TN",TN,2012,25473,23158,2315,9.1,-756
"Carter County, TN",TN,2011,26229,23549,2680,10.2,-24
"Carter County, TN",TN,2010,26253,23334,2919,11.1,0
"Carteret County, NC",NC,2021,31149,29867,1282,4.1,818
"Carteret County, NC",NC,2020,30331,28486,1845,6.1,-1488
"Carteret County, NC",NC,2019,31819,30527,1292,4.1,379
"Carteret County, NC",NC,2018,31440,30060,1380,4.4,-40
"Carteret County, NC",NC,2017,31480,30080,1400,4.4,7
"Carteret County, NC",NC,2016,31473,29850,1623,5.2,173
"Carteret County, NC",NC,2015,31300,29472,1828,5.8,221
"Carteret County, NC",NC,2014,31079,29208,1871,6.0,-158
"Carteret County, NC",NC,2013,31237,28867,2370,7.6,-526
"Carteret County, NC",NC,2012,31763,28859,2904,9.1,633
"Carteret County, NC",NC,2011,31130,28112,3018,9.7,-366
"Carteret County, NC",NC,2010,31496,28511,2985,9.5,0
"Carver County, MN",MN,2021,58187,56606,1581,2.7,-1594
"Carver County, MN",MN,2020,59781,56622,3159,5.3,-176
"Carver County, MN",MN,2019,59957,58192,1765,2.9,1418
"Carver County, MN",MN,2018,58539,56995,1544,2.6,861
"Carver County, MN",MN,2017,57678,55976,1702,3.0,1386
"Carver County, MN",MN,2016,56292,54436,1856,3.3,991
"Carver County, MN",MN,2015,55301,53510,1791,3.2,905
"Carver County, MN",MN,2014,54396,52377,2019,3.7,1027
"Carver County, MN",MN,2013,53369,51033,2336,4.4,885
"Carver County, MN",MN,2012,52484,49934,2550,4.9,248
"Carver County, MN",MN,2011,52236,49344,2892,5.5,578
"Carver County, MN",MN,2010,51658,48173,3485,6.7,0
"Cascade County, MT",MT,2021,37812,36561,1251,3.3,-95
"Cascade County, MT",MT,2020,37907,35719,2188,5.8,-548
"Cascade County, MT",MT,2019,38455,37120,1335,3.5,311
"Cascade County, MT",MT,2018,38144,36761,1383,3.6,143
"Cascade County, MT",MT,2017,38001,36554,1447,3.8,220
"Cascade County, MT",MT,2016,37781,36224,1557,4.1,-539
"Cascade County, MT",MT,2015,38320,36730,1590,4.1,19
"Cascade County, MT",MT,2014,38301,36654,1647,4.3,-120
"Cascade County, MT",MT,2013,38421,36478,1943,5.1,41
"Cascade County, MT",MT,2012,38380,36314,2066,5.4,51
"Cascade County, MT",MT,2011,38329,35990,2339,6.1,-142
"Cascade County, MT",MT,2010,38471,36059,2412,6.3,0
"Casey County, KY",KY,2021,6766,6486,280,4.1,111
"Casey County, KY",KY,2020,6655,6255,400,6.0,-82
"Casey County, KY",KY,2019,6737,6468,269,4.0,26
"Casey County, KY",KY,2018,6711,6405,306,4.6,27
"Casey County, KY",KY,2017,6684,6368,316,4.7,-5
"Casey County, KY",KY,2016,6689,6371,318,4.8,185
"Casey County, KY",KY,2015,6504,6133,371,5.7,-116
"Casey County, KY",KY,2014,6620,6172,448,6.8,-193
"Casey County, KY",KY,2013,6813,6231,582,8.5,-52
"Casey County, KY",KY,2012,6865,6287,578,8.4,-132
"Casey County, KY",KY,2011,6997,6300,697,10.0,46
"Casey County, KY",KY,2010,6951,6180,771,11.1,0
"Cass County, IA",IA,2021,6768,6520,248,3.7,-34
"Cass County, IA",IA,2020,6802,6543,259,3.8,-251
"Cass County, IA",IA,2019,7053,6864,189,2.7,-153
"Cass County, IA",IA,2018,7206,7015,191,2.7,10
"Cass County, IA",IA,2017,7196,6942,254,3.5,-105
"Cass County, IA",IA,2016,7301,7065,236,3.2,-156
"Cass County, IA",IA,2015,7457,7189,268,3.6,74
"Cass County, IA",IA,2014,7383,7064,319,4.3,83
"Cass County, IA",IA,2013,7300,6932,368,5.0,78
"Cass County, IA",IA,2012,7222,6846,376,5.2,-99
"Cass County, IA",IA,2011,7321,6877,444,6.1,-70
"Cass County, IA",IA,2010,7391,6920,471,6.4,0
"Cass County, IL",IL,2021,5667,5389,278,4.9,-143
"Cass County, IL",IL,2020,5810,5417,393,6.8,-276
"Cass County, IL",IL,2019,6086,5846,240,3.9,-47
"Cass County, IL",IL,2018,6133,5860,273,4.5,-23
"Cass County, IL",IL,2017,6156,5877,279,4.5,-83
"Cass County, IL",IL,2016,6239,5890,349,5.6,-198
"Cass County, IL",IL,2015,6437,6072,365,5.7,26
"Cass County, IL",IL,2014,6411,5964,447,7.0,-15
"Cass County, IL",IL,2013,6426,5841,585,9.1,-148
"Cass County, IL",IL,2012,6574,6014,560,8.5,-319
"Cass County, IL",IL,2011,6893,6327,566,8.2,-87
"Cass County, IL",IL,2010,6980,6396,584,8.4,0
"Cass County, IN",IN,2021,17216,16594,622,3.6,-420
"Cass County, IN",IN,2020,17636,16420,1216,6.9,-453
"Cass County, IN",IN,2019,18089,17470,619,3.4,-187
"Cass County, IN",IN,2018,18276,17611,665,3.6,387
"Cass County, IN",IN,2017,17889,17213,676,3.8,-176
"Cass County, IN",IN,2016,18065,17238,827,4.6,307
"Cass County, IN",IN,2015,17758,16947,811,4.6,18
"Cass County, IN",IN,2014,17740,16722,1018,5.7,45
"Cass County, IN",IN,2013,17695,16361,1334,7.5,-97
"Cass County, IN",IN,2012,17792,16285,1507,8.5,-427
"Cass County, IN",IN,2011,18219,16538,1681,9.2,-636
"Cass County, IN",IN,2010,18855,16865,1990,10.6,0
"Cass County, MI",MI,2021,23154,21980,1174,5.1,-1193
"Cass County, MI",MI,2020,24347,22107,2240,9.2,-434
"Cass County, MI",MI,2019,24781,23711,1070,4.3,306
"Cass County, MI",MI,2018,24475,23470,1005,4.1,176
"Cass County, MI",MI,2017,24299,23198,1101,4.5,-113
"Cass County, MI",MI,2016,24412,23254,1158,4.7,280
"Cass County, MI",MI,2015,24132,22898,1234,5.1,248
"Cass County, MI",MI,2014,23884,22273,1611,6.7,276
"Cass County, MI",MI,2013,23608,21688,1920,8.1,-233
"Cass County, MI",MI,2012,23841,21855,1986,8.3,-533
"Cass County, MI",MI,2011,24374,22108,2266,9.3,9
"Cass County, MI",MI,2010,24365,21670,2695,11.1,0
"Cass County, MN",MN,2021,15598,14909,689,4.4,1047
"Cass County, MN",MN,2020,14551,13194,1357,9.3,-39
"Cass County, MN",MN,2019,14590,13735,855,5.9,220
"Cass County, MN",MN,2018,14370,13579,791,5.5,-47
"Cass County, MN",MN,2017,14417,13550,867,6.0,267
"Cass County, MN",MN,2016,14150,13183,967,6.8,77
"Cass County, MN",MN,2015,14073,13112,961,6.8,41
"Cass County, MN",MN,2014,14032,13011,1021,7.3,20
"Cass County, MN",MN,2013,14012,12844,1168,8.3,140
"Cass County, MN",MN,2012,13872,12632,1240,8.9,-311
"Cass County, MN",MN,2011,14183,12754,1429,10.1,-216
"Cass County, MN",MN,2010,14399,12872,1527,10.6,0
"Cass County, MO",MO,2021,54398,52278,2120,3.9,569
"Cass County, MO",MO,2020,53829,50977,2852,5.3,-823
"Cass County, MO",MO,2019,54652,53092,1560,2.9,475
"Cass County, MO",MO,2018,54177,52536,1641,3.0,62
"Cass County, MO",MO,2017,54115,52221,1894,3.5,-334
"Cass County, MO",MO,2016,54449,52196,2253,4.1,894
"Cass County, MO",MO,2015,53555,50932,2623,4.9,936
"Cass County, MO",MO,2014,52619,49595,3024,5.7,493
"Cass County, MO",MO,2013,52126,48813,3313,6.4,-330
"Cass County, MO",MO,2012,52456,48846,3610,6.9,-376
"Cass County, MO",MO,2011,52832,48262,4570,8.7,-305
"Cass County, MO",MO,2010,53137,48049,5088,9.6,0
"Cass County, ND",ND,2021,107219,104116,3103,2.9,964
"Cass County, ND",ND,2020,106255,101632,4623,4.4,845
"Cass County, ND",ND,2019,105410,103482,1928,1.8,1331
"Cass County, ND",ND,2018,104079,101921,2158,2.1,905
"Cass County, ND",ND,2017,103174,101011,2163,2.1,3180
"Cass County, ND",ND,2016,99994,97756,2238,2.2,5371
"Cass County, ND",ND,2015,94623,92497,2126,2.2,2885
"Cass County, ND",ND,2014,91738,89562,2176,2.4,1347
"Cass County, ND",ND,2013,90391,87915,2476,2.7,1312
"Cass County, ND",ND,2012,89079,86578,2501,2.8,-260
"Cass County, ND",ND,2011,89339,86532,2807,3.1,342
"Cass County, ND",ND,2010,88997,85913,3084,3.5,0
"Cass County, NE",NE,2021,13554,13192,362,2.7,80
"Cass County, NE",NE,2020,13474,12899,575,4.3,-217
"Cass County, NE",NE,2019,13691,13230,461,3.4,226
"Cass County, NE",NE,2018,13465,13051,414,3.1,176
"Cass County, NE",NE,2017,13289,12864,425,3.2,72
"Cass County, NE",NE,2016,13217,12774,443,3.4,94
"Cass County, NE",NE,2015,13123,12688,435,3.3,-121
"Cass County, NE",NE,2014,13244,12755,489,3.7,-30
"Cass County, NE",NE,2013,13274,12711,563,4.2,-8
"Cass County, NE",NE,2012,13282,12681,601,4.5,-103
"Cass County, NE",NE,2011,13385,12682,703,5.3,-2
"Cass County, NE",NE,2010,13387,12620,767,5.7,0
"Cass County, TX",TX,2021,12386,11556,830,6.7,254
"Cass County, TX",TX,2020,12132,11172,960,7.9,-97
"Cass County, TX",TX,2019,12229,11700,529,4.3,49
"Cass County, TX",TX,2018,12180,11561,619,5.1,76
"Cass County, TX",TX,2017,12104,11377,727,6.0,-172
"Cass County, TX",TX,2016,12276,11391,885,7.2,101
"Cass County, TX",TX,2015,12175,11342,833,6.8,-95
"Cass County, TX",TX,2014,12270,11321,949,7.7,-304
"Cass County, TX",TX,2013,12574,11408,1166,9.3,-221
"Cass County, TX",TX,2012,12795,11627,1168,9.1,-521
"Cass County, TX",TX,2011,13316,11851,1465,11.0,-42
"Cass County, TX",TX,2010,13358,11855,1503,11.3,0
"Cassia County, ID",ID,2021,12613,12248,365,2.9,166
"Cassia County, ID",ID,2020,12447,11982,465,3.7,195
"Cassia County, ID",ID,2019,12252,11950,302,2.5,396
"Cassia County, ID",ID,2018,11856,11588,268,2.3,55
"Cassia County, ID",ID,2017,11801,11505,296,2.5,212
"Cassia County, ID",ID,2016,11589,11254,335,2.9,113
"Cassia County, ID",ID,2015,11476,11120,356,3.1,277
"Cassia County, ID",ID,2014,11199,10768,431,3.8,-4
"Cassia County, ID",ID,2013,11203,10551,652,5.8,52
"Cassia County, ID",ID,2012,11151,10491,660,5.9,-31
"Cassia County, ID",ID,2011,11182,10462,720,6.4,55
"Cassia County, ID",ID,2010,11127,10363,764,6.9,0
"Castro County, TX",TX,2021,3380,3263,117,3.5,131
"Castro County, TX",TX,2020,3249,3131,118,3.6,-129
"Castro County, TX",TX,2019,3378,3285,93,2.8,-52
"Castro County, TX",TX,2018,3430,3331,99,2.9,62
"Castro County, TX",TX,2017,3368,3256,112,3.3,-129
"Castro County, TX",TX,2016,3497,3389,108,3.1,-121
"Castro County, TX",TX,2015,3618,3494,124,3.4,-172
"Castro County, TX",TX,2014,3790,3637,153,4.0,13
"Castro County, TX",TX,2013,3777,3598,179,4.7,-273
"Castro County, TX",TX,2012,4050,3874,176,4.3,-36
"Castro County, TX",TX,2011,4086,3874,212,5.2,-57
"Castro County, TX",TX,2010,4143,3919,224,5.4,0
"Caswell County, NC",NC,2021,9473,8970,503,5.3,83
"Caswell County, NC",NC,2020,9390,8684,706,7.5,-386
"Caswell County, NC",NC,2019,9776,9345,431,4.4,86
"Caswell County, NC",NC,2018,9690,9257,433,4.5,60
"Caswell County, NC",NC,2017,9630,9175,455,4.7,-31
"Caswell County, NC",NC,2016,9661,9135,526,5.4,48
"Caswell County, NC",NC,2015,9613,9014,599,6.2,-39
"Caswell County, NC",NC,2014,9652,8976,676,7.0,-221
"Caswell County, NC",NC,2013,9873,9009,864,8.8,-177
"Caswell County, NC",NC,2012,10050,8954,1096,10.9,-112
"Caswell County, NC",NC,2011,10162,8966,1196,11.8,60
"Caswell County, NC",NC,2010,10102,8779,1323,13.1,0
"Catahoula Parish, LA",LA,2021,3483,3304,179,5.1,36
"Catahoula Parish, LA",LA,2020,3447,3185,262,7.6,47
"Catahoula Parish, LA",LA,2019,3400,3190,210,6.2,30
"Catahoula Parish, LA",LA,2018,3370,3145,225,6.7,-69
"Catahoula Parish, LA",LA,2017,3439,3197,242,7.0,11
"Catahoula Parish, LA",LA,2016,3428,3109,319,9.3,-171
"Catahoula Parish, LA",LA,2015,3599,3255,344,9.6,-227
"Catahoula Parish, LA",LA,2014,3826,3523,303,7.9,-71
"Catahoula Parish, LA",LA,2013,3897,3582,315,8.1,-34
"Catahoula Parish, LA",LA,2012,3931,3596,335,8.5,-138
"Catahoula Parish, LA",LA,2011,4069,3669,400,9.8,-151
"Catahoula Parish, LA",LA,2010,4220,3807,413,9.8,0
"Catano Municipio, PR",PR,2021,8412,7720,692,8.2,
"Catano Municipio, PR",PR,2020,N.A.,N.A.,N.A.,N.A.,
"Catano Municipio, PR",PR,2019,7762,7202,560,7.2,39
"Catano Municipio, PR",PR,2018,7723,7103,620,8.0,-59
"Catano Municipio, PR",PR,2017,7782,7076,706,9.1,-130
"Catano Municipio, PR",PR,2016,7912,7119,793,10.0,-136
"Catano Municipio, PR",PR,2015,8048,7207,841,10.4,-111
"Catano Municipio, PR",PR,2014,8159,7153,1006,12.3,-311
"Catano Municipio, PR",PR,2013,8470,7366,1104,13.0,-243
"Catano Municipio, PR",PR,2012,8713,7539,1174,13.5,-216
"Catano Municipio, PR",PR,2011,8929,7578,1351,15.1,-358
"Catano Municipio, PR",PR,2010,9287,7879,1408,15.2,0
"Catawba County, NC",NC,2021,76433,72869,3564,4.7,664
"Catawba County, NC",NC,2020,75769,69884,5885,7.8,-2404
"Catawba County, NC",NC,2019,78173,75402,2771,3.5,610
"Catawba County, NC",NC,2018,77563,74780,2783,3.6,28
"Catawba County, NC",NC,2017,77535,74314,3221,4.2,887
"Catawba County, NC",NC,2016,76648,73016,3632,4.7,1574
"Catawba County, NC",NC,2015,75074,70986,4088,5.4,415
"Catawba County, NC",NC,2014,74659,70051,4608,6.2,-1474
"Catawba County, NC",NC,2013,76133,69845,6288,8.3,-1114
"Catawba County, NC",NC,2012,77247,69223,8024,10.4,25
"Catawba County, NC",NC,2011,77222,68220,9002,11.7,-941
"Catawba County, NC",NC,2010,78163,68058,10105,12.9,0
"Catoosa County, GA",GA,2021,33457,32551,906,2.7,853
"Catoosa County, GA",GA,2020,32604,31183,1421,4.4,-930
"Catoosa County, GA",GA,2019,33534,32479,1055,3.1,-33
"Catoosa County, GA",GA,2018,33567,32408,1159,3.5,396
"Catoosa County, GA",GA,2017,33171,31790,1381,4.2,999
"Catoosa County, GA",GA,2016,32172,30595,1577,4.9,1160
"Catoosa County, GA",GA,2015,31012,29364,1648,5.3,22
"Catoosa County, GA",GA,2014,30990,29079,1911,6.2,-618
"Catoosa County, GA",GA,2013,31608,29495,2113,6.7,-537
"Catoosa County, GA",GA,2012,32145,29780,2365,7.4,143
"Catoosa County, GA",GA,2011,32002,29402,2600,8.1,576
"Catoosa County, GA",GA,2010,31426,28700,2726,8.7,0
"Catron County, NM",NM,2021,1182,1109,73,6.2,37
"Catron County, NM",NM,2020,1145,1063,82,7.2,-2
"Catron County, NM",NM,2019,1147,1074,73,6.4,19
"Catron County, NM",NM,2018,1128,1056,72,6.4,-48
"Catron County, NM",NM,2017,1176,1095,81,6.9,-38
"Catron County, NM",NM,2016,1214,1115,99,8.2,14
"Catron County, NM",NM,2015,1200,1099,101,8.4,6
"Catron County, NM",NM,2014,1194,1096,98,8.2,-54
"Catron County, NM",NM,2013,1248,1137,111,8.9,-1
"Catron County, NM",NM,2012,1249,1132,117,9.4,94
"Catron County, NM",NM,2011,1155,1030,125,10.8,-51
"Catron County, NM",NM,2010,1206,1066,140,11.6,0
"Cattaraugus County, NY",NY,2021,32847,31107,1740,5.3,-779
"Cattaraugus County, NY",NY,2020,33626,30565,3061,9.1,-861
"Cattaraugus County, NY",NY,2019,34487,32811,1676,4.9,-281
"Cattaraugus County, NY",NY,2018,34768,32926,1842,5.3,-145
"Cattaraugus County, NY",NY,2017,34913,32764,2149,6.2,34
"Cattaraugus County, NY",NY,2016,34879,32760,2119,6.1,-278
"Cattaraugus County, NY",NY,2015,35157,32929,2228,6.3,-1424
"Cattaraugus County, NY",NY,2014,36581,34000,2581,7.1,-1491
"Cattaraugus County, NY",NY,2013,38072,34742,3330,8.7,-192
"Cattaraugus County, NY",NY,2012,38264,34639,3625,9.5,-348
"Cattaraugus County, NY",NY,2011,38612,34970,3642,9.4,-1094
"Cattaraugus County, NY",NY,2010,39706,35851,3855,9.7,0
"Cavalier County, ND",ND,2021,1870,1812,58,3.1,-45
"Cavalier County, ND",ND,2020,1915,1849,66,3.4,-4
"Cavalier County, ND",ND,2019,1919,1871,48,2.5,-89
"Cavalier County, ND",ND,2018,2008,1960,48,2.4,-74
"Cavalier County, ND",ND,2017,2082,2027,55,2.6,-29
"Cavalier County, ND",ND,2016,2111,2055,56,2.7,66
"Cavalier County, ND",ND,2015,2045,1988,57,2.8,17
"Cavalier County, ND",ND,2014,2028,1971,57,2.8,-25
"Cavalier County, ND",ND,2013,2053,1986,67,3.3,-83
"Cavalier County, ND",ND,2012,2136,2071,65,3.0,-106
"Cavalier County, ND",ND,2011,2242,2177,65,2.9,-23
"Cavalier County, ND",ND,2010,2265,2197,68,3.0,0
"Cayey Municipio, PR",PR,2021,17165,16142,1023,6.0,
"Cayey Municipio, PR",PR,2020,N.A.,N.A.,N.A.,N.A.,
"Cayey Municipio, PR",PR,2019,16084,14954,1130,7.0,200
"Cayey Municipio, PR",PR,2018,15884,14655,1229,7.7,-223
"Cayey Municipio, PR",PR,2017,16107,14479,1628,10.1,-113
"Cayey Municipio, PR",PR,2016,16220,14480,1740,10.7,-17
"Cayey Municipio, PR",PR,2015,16237,14493,1744,10.7,-138
"Cayey Municipio, PR",PR,2014,16375,14300,2075,12.7,-537
"Cayey Municipio, PR",PR,2013,16912,14616,2296,13.6,-542
"Cayey Municipio, PR",PR,2012,17454,14860,2594,14.9,-167
"Cayey Municipio, PR",PR,2011,17621,14826,2795,15.9,-566
"Cayey Municipio, PR",PR,2010,18187,15305,2882,15.8,0
"Cayuga County, NY",NY,2021,35130,33473,1657,4.7,-894
"Cayuga County, NY",NY,2020,36024,33290,2734,7.6,-673
"Cayuga County, NY",NY,2019,36697,35190,1507,4.1,-51
"Cayuga County, NY",NY,2018,36748,35118,1630,4.4,211
"Cayuga County, NY",NY,2017,36537,34715,1822,5.0,-179
"Cayuga County, NY",NY,2016,36716,34828,1888,5.1,-289
"Cayuga County, NY",NY,2015,37005,35015,1990,5.4,-561
"Cayuga County, NY",NY,2014,37566,35298,2268,6.0,-1244
"Cayuga County, NY",NY,2013,38810,35875,2935,7.6,-246
"Cayuga County, NY",NY,2012,39056,35787,3269,8.4,-65
"Cayuga County, NY",NY,2011,39121,35927,3194,8.2,-794
"Cayuga County, NY",NY,2010,39915,36448,3467,8.7,0
"Cecil County, MD",MD,2021,52338,49595,2743,5.2,-985
"Cecil County, MD",MD,2020,53323,50171,3152,5.9,-1498
"Cecil County, MD",MD,2019,54821,52739,2082,3.8,1213
"Cecil County, MD",MD,2018,53608,51411,2197,4.1,42
"Cecil County, MD",MD,2017,53566,51100,2466,4.6,1002
"Cecil County, MD",MD,2016,52564,49912,2652,5.0,19
"Cecil County, MD",MD,2015,52545,49457,3088,5.9,125
"Cecil County, MD",MD,2014,52420,49013,3407,6.5,185
"Cecil County, MD",MD,2013,52235,48243,3992,7.6,337
"Cecil County, MD",MD,2012,51898,47630,4268,8.2,-223
"Cecil County, MD",MD,2011,52121,47454,4667,9.0,39
"Cecil County, MD",MD,2010,52082,47005,5077,9.7,0
"Cedar County, IA",IA,2021,10351,9962,389,3.8,-117
"Cedar County, IA",IA,2020,10468,10022,446,4.3,-581
"Cedar County, IA",IA,2019,11049,10789,260,2.4,109
"Cedar County, IA",IA,2018,10940,10675,265,2.4,43
"Cedar County, IA",IA,2017,10897,10587,310,2.8,-17
"Cedar County, IA",IA,2016,10914,10554,360,3.3,-71
"Cedar County, IA",IA,2015,10985,10612,373,3.4,60
"Cedar County, IA",IA,2014,10925,10504,421,3.9,98
"Cedar County, IA",IA,2013,10827,10361,466,4.3,120
"Cedar County, IA",IA,2012,10707,10218,489,4.6,-213
"Cedar County, IA",IA,2011,10920,10346,574,5.3,-39
"Cedar County, IA",IA,2010,10959,10358,601,5.5,0
"Cedar County, MO",MO,2021,5790,5578,212,3.7,71
"Cedar County, MO",MO,2020,5719,5465,254,4.4,-21
"Cedar County, MO",MO,2019,5740,5538,202,3.5,50
"Cedar County, MO",MO,2018,5690,5498,192,3.4,-56
"Cedar County, MO",MO,2017,5746,5514,232,4.0,-43
"Cedar County, MO",MO,2016,5789,5501,288,5.0,-68
"Cedar County, MO",MO,2015,5857,5542,315,5.4,18
"Cedar County, MO",MO,2014,5839,5467,372,6.4,-22
"Cedar County, MO",MO,2013,5861,5445,416,7.1,101
"Cedar County, MO",MO,2012,5760,5318,442,7.7,-214
"Cedar County, MO",MO,2011,5974,5444,530,8.9,-113
"Cedar County, MO",MO,2010,6087,5511,576,9.5,0
"Cedar County, NE",NE,2021,4665,4582,83,1.8,102
"Cedar County, NE",NE,2020,4563,4442,121,2.7,-12
"Cedar County, NE",NE,2019,4575,4461,114,2.5,59
"Cedar County, NE",NE,2018,4516,4409,107,2.4,5
"Cedar County, NE",NE,2017,4511,4409,102,2.3,-84
"Cedar County, NE",NE,2016,4595,4478,117,2.5,-65
"Cedar County, NE",NE,2015,4660,4550,110,2.4,-10
"Cedar County, NE",NE,2014,4670,4563,107,2.3,-48
"Cedar County, NE",NE,2013,4718,4582,136,2.9,-14
"Cedar County, NE",NE,2012,4732,4598,134,2.8,22
"Cedar County, NE",NE,2011,4710,4555,155,3.3,91
"Cedar County, NE",NE,2010,4619,4452,167,3.6,0
"Ceiba Municipio, PR",PR,2021,3854,3509,345,9.0,
"Ceiba Municipio, PR",PR,2020,N.A.,N.A.,N.A.,N.A.,
"Ceiba Municipio, PR",PR,2019,3673,3289,384,10.5,-104
"Ceiba Municipio, PR",PR,2018,3777,3263,514,13.6,3
"Ceiba Municipio, PR",PR,2017,3774,3265,509,13.5,-24
"Ceiba Municipio, PR",PR,2016,3798,3301,497,13.1,-68
"Ceiba Municipio, PR",PR,2015,3866,3331,535,13.8,-144
"Ceiba Municipio, PR",PR,2014,4010,3327,683,17.0,-185
"Ceiba Municipio, PR",PR,2013,4195,3437,758,18.1,-161
"Ceiba Municipio, PR",PR,2012,4356,3527,829,19.0,-134
"Ceiba Municipio, PR",PR,2011,4490,3559,931,20.7,-186
"Ceiba Municipio, PR",PR,2010,4676,3706,970,20.7,0
"Centre County, PA",PA,2021,76030,72547,3483,4.6,-1547
"Centre County, PA",PA,2020,77577,73057,4520,5.8,-3253
"Centre County, PA",PA,2019,80830,78054,2776,3.4,376
"Centre County, PA",PA,2018,80454,77735,2719,3.4,653
"Centre County, PA",PA,2017,79801,76808,2993,3.8,743
"Centre County, PA",PA,2016,79058,75796,3262,4.1,1242
"Centre County, PA",PA,2015,77816,74668,3148,4.0,278
"Centre County, PA",PA,2014,77538,74166,3372,4.3,-268
"Centre County, PA",PA,2013,77806,73840,3966,5.1,365
"Centre County, PA",PA,2012,77441,73287,4154,5.4,166
"Centre County, PA",PA,2011,77275,73171,4104,5.3,125
"Centre County, PA",PA,2010,77150,72708,4442,5.8,0
"Cerro Gordo County, IA",IA,2021,22505,21534,971,4.3,-754
"Cerro Gordo County, IA",IA,2020,23259,22076,1183,5.1,-796
"Cerro Gordo County, IA",IA,2019,24055,23430,625,2.6,428
"Cerro Gordo County, IA",IA,2018,23627,23012,615,2.6,177
"Cerro Gordo County, IA",IA,2017,23450,22744,706,3.0,215
"Cerro Gordo County, IA",IA,2016,23235,22408,827,3.6,228
"Cerro Gordo County, IA",IA,2015,23007,22107,900,3.9,-225
"Cerro Gordo County, IA",IA,2014,23232,22155,1077,4.6,-133
"Cerro Gordo County, IA",IA,2013,23365,22103,1262,5.4,-451
"Cerro Gordo County, IA",IA,2012,23816,22484,1332,5.6,-450
"Cerro Gordo County, IA",IA,2011,24266,22754,1512,6.2,-238
"Cerro Gordo County, IA",IA,2010,24504,22799,1705,7.0,0
"Chaffee County, CO",CO,2021,10248,9835,413,4.0,606
"Chaffee County, CO",CO,2020,9642,9062,580,6.0,-54
"Chaffee County, CO",CO,2019,9696,9477,219,2.3,171
"Chaffee County, CO",CO,2018,9525,9288,237,2.5,298
"Chaffee County, CO",CO,2017,9227,9026,201,2.2,384
"Chaffee County, CO",CO,2016,8843,8619,224,2.5,349
"Chaffee County, CO",CO,2015,8494,8215,279,3.3,113
"Chaffee County, CO",CO,2014,8381,8017,364,4.3,83
"Chaffee County, CO",CO,2013,8298,7796,502,6.0,-45
"Chaffee County, CO",CO,2012,8343,7765,578,6.9,61
"Chaffee County, CO",CO,2011,8282,7659,623,7.5,38
"Chaffee County, CO",CO,2010,8244,7575,669,8.1,0
"Chambers County, AL",AL,2021,15752,15173,579,3.7,-341
"Chambers County, AL",AL,2020,16093,14884,1209,7.5,101
"Chambers County, AL",AL,2019,15992,15502,490,3.1,462
"Chambers County, AL",AL,2018,15530,14929,601,3.9,155
"Chambers County, AL",AL,2017,15375,14734,641,4.2,517
"Chambers County, AL",AL,2016,14858,14044,814,5.5,-81
"Chambers County, AL",AL,2015,14939,14031,908,6.1,-390
"Chambers County, AL",AL,2014,15329,14308,1021,6.7,66
"Chambers County, AL",AL,2013,15263,14028,1235,8.1,103
"Chambers County, AL",AL,2012,15160,13630,1530,10.1,-25
"Chambers County, AL",AL,2011,15185,13386,1799,11.8,451
"Chambers County, AL",AL,2010,14734,12581,2153,14.6,0
"Chambers County, TX",TX,2021,20681,18967,1714,8.3,474
"Chambers County, TX",TX,2020,20207,18316,1891,9.4,533
"Chambers County, TX",TX,2019,19674,18786,888,4.5,586
"Chambers County, TX",TX,2018,19088,18052,1036,5.4,303
"Chambers County, TX",TX,2017,18785,17554,1231,6.6,564
"Chambers County, TX",TX,2016,18221,17110,1111,6.1,406
"Chambers County, TX",TX,2015,17815,16858,957,5.4,-5
"Chambers County, TX",TX,2014,17820,16779,1041,5.8,369
"Chambers County, TX",TX,2013,17451,16161,1290,7.4,341
"Chambers County, TX",TX,2012,17110,15740,1370,8.0,304
"Chambers County, TX",TX,2011,16806,15194,1612,9.6,174
"Chambers County, TX",TX,2010,16632,15013,1619,9.7,0
"Champaign County, IL",IL,2021,108489,103230,5259,4.8,1653
"Champaign County, IL",IL,2020,106836,99733,7103,6.6,-2271
"Champaign County, IL",IL,2019,109107,105208,3899,3.6,748
"Champaign County, IL",IL,2018,108359,103728,4631,4.3,1289
"Champaign County, IL",IL,2017,107070,102504,4566,4.3,-788
"Champaign County, IL",IL,2016,107858,102462,5396,5.0,455
"Champaign County, IL",IL,2015,107403,101976,5427,5.1,599
"Champaign County, IL",IL,2014,106804,100559,6245,5.8,647
"Champaign County, IL",IL,2013,106157,98539,7618,7.2,-1003
"Champaign County, IL",IL,2012,107160,99565,7595,7.1,-1003
"Champaign County, IL",IL,2011,108163,99976,8187,7.6,-543
"Champaign County, IL",IL,2010,108706,99758,8948,8.2,0
"Champaign County, OH",OH,2021,19413,18560,853,4.4,-367
"Champaign County, OH",OH,2020,19780,18366,1414,7.1,-440
"Champaign County, OH",OH,2019,20220,19463,757,3.7,220
"Champaign County, OH",OH,2018,20000,19240,760,3.8,-23
"Champaign County, OH",OH,2017,20023,19200,823,4.1,65
"Champaign County, OH",OH,2016,19958,19055,903,4.5,19
"Champaign County, OH",OH,2015,19939,19057,882,4.4,-45
"Champaign County, OH",OH,2014,19984,18974,1010,5.1,-17
"Champaign County, OH",OH,2013,20001,18623,1378,6.9,619
"Champaign County, OH",OH,2012,19382,17953,1429,7.4,-87
"Champaign County, OH",OH,2011,19469,17635,1834,9.4,-538
"Champaign County, OH",OH,2010,20007,17694,2313,11.6,0
"Chariton County, MO",MO,2021,3743,3620,123,3.3,8
"Chariton County, MO",MO,2020,3735,3585,150,4.0,44
"Chariton County, MO",MO,2019,3691,3586,105,2.8,-68
"Chariton County, MO",MO,2018,3759,3655,104,2.8,-86
"Chariton County, MO",MO,2017,3845,3713,132,3.4,-6
"Chariton County, MO",MO,2016,3851,3684,167,4.3,21
"Chariton County, MO",MO,2015,3830,3646,184,4.8,-7
"Chariton County, MO",MO,2014,3837,3614,223,5.8,108
"Chariton County, MO",MO,2013,3729,3493,236,6.3,-276
"Chariton County, MO",MO,2012,4005,3734,271,6.8,-74
"Chariton County, MO",MO,2011,4079,3706,373,9.1,-32
"Chariton County, MO",MO,2010,4111,3723,388,9.4,0
"Charles City County, VA",VA,2021,3443,3292,151,4.4,-91
"Charles City County, VA",VA,2020,3534,3300,234,6.6,-180
"Charles City County, VA",VA,2019,3714,3587,127,3.4,36
"Charles City County, VA",VA,2018,3678,3532,146,4.0,-40
"Charles City County, VA",VA,2017,3718,3542,176,4.7,-6
"Charles City County, VA",VA,2016,3724,3558,166,4.5,-7
"Charles City County, VA",VA,2015,3731,3535,196,5.3,1
"Charles City County, VA",VA,2014,3730,3512,218,5.8,-58
"Charles City County, VA",VA,2013,3788,3538,250,6.6,-59
"Charles City County, VA",VA,2012,3847,3551,296,7.7,-83
"Charles City County, VA",VA,2011,3930,3578,352,9.0,22
"Charles City County, VA",VA,2010,3908,3525,383,9.8,0
"Charles County, MD",MD,2021,86208,81268,4940,5.7,-1966
"Charles County, MD",MD,2020,88174,82357,5817,6.6,-2390
"Charles County, MD",MD,2019,90564,87407,3157,3.5,2649
"Charles County, MD",MD,2018,87915,84773,3142,3.6,1113
"Charles County, MD",MD,2017,86802,83476,3326,3.8,2990
"Charles County, MD",MD,2016,83812,80379,3433,4.1,3341
"Charles County, MD",MD,2015,80471,76540,3931,4.9,345
"Charles County, MD",MD,2014,80126,75591,4535,5.7,-121
"Charles County, MD",MD,2013,80247,75103,5144,6.4,653
"Charles County, MD",MD,2012,79594,74359,5235,6.6,569
"Charles County, MD",MD,2011,79025,73669,5356,6.8,688
"Charles County, MD",MD,2010,78337,72775,5562,7.1,0
"Charles Mix County, SD",SD,2021,3804,3663,141,3.7,50
"Charles Mix County, SD",SD,2020,3754,3531,223,5.9,20
"Charles Mix County, SD",SD,2019,3734,3615,119,3.2,-88
"Charles Mix County, SD",SD,2018,3822,3711,111,2.9,-57
"Charles Mix County, SD",SD,2017,3879,3748,131,3.4,-29
"Charles Mix County, SD",SD,2016,3908,3782,126,3.2,-101
"Charles Mix County, SD",SD,2015,4009,3874,135,3.4,-35
"Charles Mix County, SD",SD,2014,4044,3894,150,3.7,22
"Charles Mix County, SD",SD,2013,4022,3851,171,4.3,-74
"Charles Mix County, SD",SD,2012,4096,3904,192,4.7,-75
"Charles Mix County, SD",SD,2011,4171,3969,202,4.8,5
"Charles Mix County, SD",SD,2010,4166,3964,202,4.8,0
"Charleston County, SC",SC,2021,210944,203337,7607,3.6,4610
"Charleston County, SC",SC,2020,206334,193644,12690,6.2,-384
"Charleston County, SC",SC,2019,206718,202035,4683,2.3,4754
"Charleston County, SC",SC,2018,201964,196411,5553,2.7,2452
"Charleston County, SC",SC,2017,199512,192647,6865,3.4,-1676
"Charleston County, SC",SC,2016,201188,193146,8042,4.0,3105
"Charleston County, SC",SC,2015,198083,188588,9495,4.8,5736
"Charleston County, SC",SC,2014,192347,182709,9638,5.0,4092
"Charleston County, SC",SC,2013,188255,177472,10783,5.7,1381
"Charleston County, SC",SC,2012,186874,173805,13069,7.0,3009
"Charleston County, SC",SC,2011,183865,168779,15086,8.2,3516
"Charleston County, SC",SC,2010,180349,164252,16097,8.9,0
"Charlevoix County, MI",MI,2021,12219,11484,735,6.0,-286
"Charlevoix County, MI",MI,2020,12505,11224,1281,10.2,-398
"Charlevoix County, MI",MI,2019,12903,12292,611,4.7,-221
"Charlevoix County, MI",MI,2018,13124,12493,631,4.8,49
"Charlevoix County, MI",MI,2017,13075,12356,719,5.5,-18
"Charlevoix County, MI",MI,2016,13093,12362,731,5.6,-18
"Charlevoix County, MI",MI,2015,13111,12311,800,6.1,-12
"Charlevoix County, MI",MI,2014,13123,12053,1070,8.2,84
"Charlevoix County, MI",MI,2013,13039,11656,1383,10.6,80
"Charlevoix County, MI",MI,2012,12959,11575,1384,10.7,73
"Charlevoix County, MI",MI,2011,12886,11379,1507,11.7,-334
"Charlevoix County, MI",MI,2010,13220,11420,1800,13.6,0
"Charlotte County, FL",FL,2021,73248,70060,3188,4.4,1863
"Charlotte County, FL",FL,2020,71385,65764,5621,7.9,64
"Charlotte County, FL",FL,2019,71321,68620,2701,3.8,1069
"Charlotte County, FL",FL,2018,70252,67332,2920,4.2,767
"Charlotte County, FL",FL,2017,69485,66140,3345,4.8,-34
"Charlotte County, FL",FL,2016,69519,65781,3738,5.4,1591
"Charlotte County, FL",FL,2015,67928,63810,4118,6.1,1134
"Charlotte County, FL",FL,2014,66794,62075,4719,7.1,739
"Charlotte County, FL",FL,2013,66055,60527,5528,8.4,571
"Charlotte County, FL",FL,2012,65484,59064,6420,9.8,142
"Charlotte County, FL",FL,2011,65342,57979,7363,11.3,-354
"Charlotte County, FL",FL,2010,65696,57567,8129,12.4,0
"Charlotte County, VA",VA,2021,5206,5013,193,3.7,93
"Charlotte County, VA",VA,2020,5113,4830,283,5.5,-213
"Charlotte County, VA",VA,2019,5326,5140,186,3.5,65
"Charlotte County, VA",VA,2018,5261,5070,191,3.6,-110
"Charlotte County, VA",VA,2017,5371,5128,243,4.5,112
"Charlotte County, VA",VA,2016,5259,5000,259,4.9,-12
"Charlotte County, VA",VA,2015,5271,4975,296,5.6,-46
"Charlotte County, VA",VA,2014,5317,4964,353,6.6,5
"Charlotte County, VA",VA,2013,5312,4909,403,7.6,-42
"Charlotte County, VA",VA,2012,5354,4897,457,8.5,-37
"Charlotte County, VA",VA,2011,5391,4865,526,9.8,23
"Charlotte County, VA",VA,2010,5368,4818,550,10.2,0
"Charlottesville city, VA",VA,2021,24609,23706,903,3.7,-669
"Charlottesville city, VA",VA,2020,25278,23641,1637,6.5,-1206
"Charlottesville city, VA",VA,2019,26484,25863,621,2.3,259
"Charlottesville city, VA",VA,2018,26225,25564,661,2.5,207
"Charlottesville city, VA",VA,2017,26018,25224,794,3.1,1102
"Charlottesville city, VA",VA,2016,24916,24088,828,3.3,170
"Charlottesville city, VA",VA,2015,24746,23846,900,3.6,438
"Charlottesville city, VA",VA,2014,24308,23277,1031,4.2,898
"Charlottesville city, VA",VA,2013,23410,22340,1070,4.6,10
"Charlottesville city, VA",VA,2012,23400,22225,1175,5.0,188
"Charlottesville city, VA",VA,2011,23212,21918,1294,5.6,-17
"Charlottesville city, VA",VA,2010,23229,21779,1450,6.2,0
"Charlton County, GA",GA,2021,4959,4802,157,3.2,86
"Charlton County, GA",GA,2020,4873,4687,186,3.8,-50
"Charlton County, GA",GA,2019,4923,4729,194,3.9,102
"Charlton County, GA",GA,2018,4821,4610,211,4.4,-86
"Charlton County, GA",GA,2017,4907,4658,249,5.1,166
"Charlton County, GA",GA,2016,4741,4470,271,5.7,28
"Charlton County, GA",GA,2015,4713,4407,306,6.5,-84
"Charlton County, GA",GA,2014,4797,4442,355,7.4,-115
"Charlton County, GA",GA,2013,4912,4500,412,8.4,-50
"Charlton County, GA",GA,2012,4962,4506,456,9.2,7
"Charlton County, GA",GA,2011,4955,4433,522,10.5,144
"Charlton County, GA",GA,2010,4811,4294,517,10.7,0
"Chase County, KS",KS,2021,1385,1352,33,2.4,-67
"Chase County, KS",KS,2020,1452,1375,77,5.3,-92
"Chase County, KS",KS,2019,1544,1502,42,2.7,70
"Chase County, KS",KS,2018,1474,1436,38,2.6,39
"Chase County, KS",KS,2017,1435,1398,37,2.6,22
"Chase County, KS",KS,2016,1413,1364,49,3.5,158
"Chase County, KS",KS,2015,1255,1210,45,3.6,21
"Chase County, KS",KS,2014,1234,1184,50,4.1,-19
"Chase County, KS",KS,2013,1253,1183,70,5.6,-77
"Chase County, KS",KS,2012,1330,1260,70,5.3,-14
"Chase County, KS",KS,2011,1344,1272,72,5.4,-98
"Chase County, KS",KS,2010,1442,1362,80,5.5,0
"Chase County, NE",NE,2021,2263,2227,36,1.6,-26
"Chase County, NE",NE,2020,2289,2250,39,1.7,-11
"Chase County, NE",NE,2019,2300,2249,51,2.2,1
"Chase County, NE",NE,2018,2299,2248,51,2.2,-26
"Chase County, NE",NE,2017,2325,2281,44,1.9,21
"Chase County, NE",NE,2016,2304,2257,47,2.0,-44
"Chase County, NE",NE,2015,2348,2303,45,1.9,-1
"Chase County, NE",NE,2014,2349,2301,48,2.0,-50
"Chase County, NE",NE,2013,2399,2343,56,2.3,30
"Chase County, NE",NE,2012,2369,2314,55,2.3,21
"Chase County, NE",NE,2011,2348,2290,58,2.5,59
"Chase County, NE",NE,2010,2289,2224,65,2.8,0
"Chatham County, GA",GA,2021,143877,137644,6233,4.3,4181
"Chatham County, GA",GA,2020,139696,129111,10585,7.6,-1624
"Chatham County, GA",GA,2019,141320,136469,4851,3.4,899
"Chatham County, GA",GA,2018,140421,135108,5313,3.8,239
"Chatham County, GA",GA,2017,140182,133838,6344,4.5,4094
"Chatham County, GA",GA,2016,136088,128852,7236,5.3,4343
"Chatham County, GA",GA,2015,131745,123904,7841,6.0,216
"Chatham County, GA",GA,2014,131529,121872,9657,7.3,333
"Chatham County, GA",GA,2013,131196,120414,10782,8.2,-339
"Chatham County, GA",GA,2012,131535,119558,11977,9.1,2118
"Chatham County, GA",GA,2011,129417,116527,12890,10.0,1717
"Chatham County, GA",GA,2010,127700,114919,12781,10.0,0
"Chatham County, NC",NC,2021,36405,35108,1297,3.6,1437
"Chatham County, NC",NC,2020,34968,33157,1811,5.2,-936
"Chatham County, NC",NC,2019,35904,34710,1194,3.3,1291
"Chatham County, NC",NC,2018,34613,33426,1187,3.4,932
"Chatham County, NC",NC,2017,33681,32374,1307,3.9,-735
"Chatham County, NC",NC,2016,34416,32957,1459,4.2,1062
"Chatham County, NC",NC,2015,33354,31789,1565,4.7,1097
"Chatham County, NC",NC,2014,32257,30729,1528,4.7,625
"Chatham County, NC",NC,2013,31632,29700,1932,6.1,-243
"Chatham County, NC",NC,2012,31875,29313,2562,8.0,590
"Chatham County, NC",NC,2011,31285,28750,2535,8.1,505
"Chatham County, NC",NC,2010,30780,28176,2604,8.5,0
"Chattahoochee County, GA",GA,2021,1912,1826,86,4.5,-7
"Chattahoochee County, GA",GA,2020,1919,1798,121,6.3,-114
"Chattahoochee County, GA",GA,2019,2033,1937,96,4.7,-7
"Chattahoochee County, GA",GA,2018,2040,1927,113,5.5,32
"Chattahoochee County, GA",GA,2017,2008,1870,138,6.9,-52
"Chattahoochee County, GA",GA,2016,2060,1887,173,8.4,-27
"Chattahoochee County, GA",GA,2015,2087,1901,186,8.9,-139
"Chattahoochee County, GA",GA,2014,2226,2009,217,9.7,-231
"Chattahoochee County, GA",GA,2013,2457,2189,268,10.9,-134
"Chattahoochee County, GA",GA,2012,2591,2292,299,11.5,228
"Chattahoochee County, GA",GA,2011,2363,2093,270,11.4,139
"Chattahoochee County, GA",GA,2010,2224,1978,246,11.1,0
"Chattooga County, GA",GA,2021,9562,9107,455,4.8,-192
"Chattooga County, GA",GA,2020,9754,8943,811,8.3,-649
"Chattooga County, GA",GA,2019,10403,9859,544,5.2,-121
"Chattooga County, GA",GA,2018,10524,10089,435,4.1,-135
"Chattooga County, GA",GA,2017,10659,10152,507,4.8,223
"Chattooga County, GA",GA,2016,10436,9769,667,6.4,4
"Chattooga County, GA",GA,2015,10432,9777,655,6.3,-67
"Chattooga County, GA",GA,2014,10499,9698,801,7.6,-23
"Chattooga County, GA",GA,2013,10522,9583,939,8.9,-80
"Chattooga County, GA",GA,2012,10602,9533,1069,10.1,48
"Chattooga County, GA",GA,2011,10554,9401,1153,10.9,-145
"Chattooga County, GA",GA,2010,10699,9436,1263,11.8,0
"Chautauqua County, KS",KS,2021,1458,1399,59,4.0,-21
"Chautauqua County, KS",KS,2020,1479,1391,88,5.9,37
"Chautauqua County, KS",KS,2019,1442,1388,54,3.7,20
"Chautauqua County, KS",KS,2018,1422,1367,55,3.9,-31
"Chautauqua County, KS",KS,2017,1453,1385,68,4.7,-94
"Chautauqua County, KS",KS,2016,1547,1467,80,5.2,-9
"Chautauqua County, KS",KS,2015,1556,1467,89,5.7,-23
"Chautauqua County, KS",KS,2014,1579,1494,85,5.4,-44
"Chautauqua County, KS",KS,2013,1623,1523,100,6.2,-78
"Chautauqua County, KS",KS,2012,1701,1590,111,6.5,-5
"Chautauqua County, KS",KS,2011,1706,1568,138,8.1,-33
"Chautauqua County, KS",KS,2010,1739,1584,155,8.9,0
"Chautauqua County, NY",NY,2021,52786,49847,2939,5.6,-1035
"Chautauqua County, NY",NY,2020,53821,49233,4588,8.5,-1665
"Chautauqua County, NY",NY,2019,55486,52973,2513,4.5,-462
"Chautauqua County, NY",NY,2018,55948,53150,2798,5.0,-511
"Chautauqua County, NY",NY,2017,56459,53096,3363,6.0,300
"Chautauqua County, NY",NY,2016,56159,52844,3315,5.9,-1343
"Chautauqua County, NY",NY,2015,57502,54012,3490,6.1,-202
"Chautauqua County, NY",NY,2014,57704,53745,3959,6.9,-2455
"Chautauqua County, NY",NY,2013,60159,55211,4948,8.2,-1035
"Chautauqua County, NY",NY,2012,61194,55903,5291,8.6,-560
"Chautauqua County, NY",NY,2011,61754,56660,5094,8.2,-2222
"Chautauqua County, NY",NY,2010,63976,58211,5765,9.0,0
"Chaves County, NM",NM,2021,27776,25813,1963,7.1,159
"Chaves County, NM",NM,2020,27617,25452,2165,7.8,20
"Chaves County, NM",NM,2019,27597,26235,1362,4.9,193
"Chaves County, NM",NM,2018,27404,26085,1319,4.8,-358
"Chaves County, NM",NM,2017,27762,25999,1763,6.4,-495
"Chaves County, NM",NM,2016,28257,26338,1919,6.8,356
"Chaves County, NM",NM,2015,27901,26121,1780,6.4,653
"Chaves County, NM",NM,2014,27248,25604,1644,6.0,456
"Chaves County, NM",NM,2013,26792,25117,1675,6.3,-211
"Chaves County, NM",NM,2012,27003,25287,1716,6.4,-444
"Chaves County, NM",NM,2011,27447,25668,1779,6.5,-382
"Chaves County, NM",NM,2010,27829,25820,2009,7.2,0
"Cheatham County, TN",TN,2021,22015,21330,685,3.1,649
"Cheatham County, TN",TN,2020,21366,20160,1206,5.6,-582
"Cheatham County, TN",TN,2019,21948,21368,580,2.6,570
"Cheatham County, TN",TN,2018,21378,20789,589,2.8,510
"Cheatham County, TN",TN,2017,20868,20229,639,3.1,597
"Cheatham County, TN",TN,2016,20271,19462,809,4.0,363
"Cheatham County, TN",TN,2015,19908,18953,955,4.8,50
"Cheatham County, TN",TN,2014,19858,18765,1093,5.5,-149
"Cheatham County, TN",TN,2013,20007,18692,1315,6.6,-137
"Cheatham County, TN",TN,2012,20144,18667,1477,7.3,-130
"Cheatham County, TN",TN,2011,20274,18533,1741,8.6,53
"Cheatham County, TN",TN,2010,20221,18380,1841,9.1,0
"Cheboygan County, MI",MI,2021,9941,9113,828,8.3,-374
"Cheboygan County, MI",MI,2020,10315,8770,1545,15.0,-212
"Cheboygan County, MI",MI,2019,10527,9596,931,8.8,-194
"Cheboygan County, MI",MI,2018,10721,9728,993,9.3,-87
"Cheboygan County, MI",MI,2017,10808,9739,1069,9.9,-43
"Cheboygan County, MI",MI,2016,10851,9821,1030,9.5,109
"Cheboygan County, MI",MI,2015,10742,9750,992,9.2,41
"Cheboygan County, MI",MI,2014,10701,9551,1150,10.7,164
"Cheboygan County, MI",MI,2013,10537,9331,1206,11.4,-5
"Cheboygan County, MI",MI,2012,10542,9304,1238,11.7,-266
"Cheboygan County, MI",MI,2011,10808,9530,1278,11.8,-430
"Cheboygan County, MI",MI,2010,11238,9719,1519,13.5,0
"Chelan County, WA",WA,2021,44869,42496,2373,5.3,183
"Chelan County, WA",WA,2020,44686,41025,3661,8.2,-806
"Chelan County, WA",WA,2019,45492,43236,2256,5.0,111
"Chelan County, WA",WA,2018,45381,43317,2064,4.5,896
"Chelan County, WA",WA,2017,44485,42367,2118,4.8,1172
"Chelan County, WA",WA,2016,43313,40878,2435,5.6,667
"Chelan County, WA",WA,2015,42646,40344,2302,5.4,1529
"Chelan County, WA",WA,2014,41117,38656,2461,6.0,754
"Chelan County, WA",WA,2013,40363,37491,2872,7.1,-885
"Chelan County, WA",WA,2012,41248,38238,3010,7.3,199
"Chelan County, WA",WA,2011,41049,37941,3108,7.6,-251
"Chelan County, WA",WA,2010,41300,37974,3326,8.1,0
"Chemung County, NY",NY,2021,34549,32734,1815,5.3,-1363
"Chemung County, NY",NY,2020,35912,32893,3019,8.4,-72
"Chemung County, NY",NY,2019,35984,34542,1442,4.0,-127
"Chemung County, NY",NY,2018,36111,34451,1660,4.6,-218
"Chemung County, NY",NY,2017,36329,34337,1992,5.5,97
"Chemung County, NY",NY,2016,36232,34123,2109,5.8,-1174
"Chemung County, NY",NY,2015,37406,35195,2211,5.9,-715
"Chemung County, NY",NY,2014,38121,35717,2404,6.3,-1451
"Chemung County, NY",NY,2013,39572,36364,3208,8.1,-925
"Chemung County, NY",NY,2012,40497,37041,3456,8.5,-366
"Chemung County, NY",NY,2011,40863,37636,3227,7.9,-775
"Chemung County, NY",NY,2010,41638,38073,3565,8.6,0
"Chenango County, NY",NY,2021,21630,20678,952,4.4,-487
"Chenango County, NY",NY,2020,22117,20650,1467,6.6,-306
"Chenango County, NY",NY,2019,22423,21464,959,4.3,-380
"Chenango County, NY",NY,2018,22803,21748,1055,4.6,58
"Chenango County, NY",NY,2017,22745,21537,1208,5.3,-99
"Chenango County, NY",NY,2016,22844,21668,1176,5.1,-203
"Chenango County, NY",NY,2015,23047,21780,1267,5.5,-108
"Chenango County, NY",NY,2014,23155,21704,1451,6.3,-916
"Chenango County, NY",NY,2013,24071,22265,1806,7.5,-22
"Chenango County, NY",NY,2012,24093,21984,2109,8.8,228
"Chenango County, NY",NY,2011,23865,21777,2088,8.7,148
"Chenango County, NY",NY,2010,23717,21490,2227,9.4,0
"Cherokee County, AL",AL,2021,11808,11512,296,2.5,136
"Cherokee County, AL",AL,2020,11672,11073,599,5.1,-234
"Cherokee County, AL",AL,2019,11906,11546,360,3.0,93
"Cherokee County, AL",AL,2018,11813,11394,419,3.5,343
"Cherokee County, AL",AL,2017,11470,10993,477,4.2,229
"Cherokee County, AL",AL,2016,11241,10671,570,5.1,109
"Cherokee County, AL",AL,2015,11132,10521,611,5.5,-275
"Cherokee County, AL",AL,2014,11407,10748,659,5.8,15
"Cherokee County, AL",AL,2013,11392,10627,765,6.7,114
"Cherokee County, AL",AL,2012,11278,10350,928,8.2,-195
"Cherokee County, AL",AL,2011,11473,10369,1104,9.6,7
"Cherokee County, AL",AL,2010,11466,10267,1199,10.5,0
"Cherokee County, GA",GA,2021,139406,135761,3645,2.6,4345
"Cherokee County, GA",GA,2020,135061,128633,6428,4.8,-2352
"Cherokee County, GA",GA,2019,137413,133463,3950,2.9,2173
"Cherokee County, GA",GA,2018,135240,130961,4279,3.2,2932
"Cherokee County, GA",GA,2017,132308,127318,4990,3.8,6425
"Cherokee County, GA",GA,2016,125883,120452,5431,4.3,6930
"Cherokee County, GA",GA,2015,118953,113293,5660,4.8,1134
"Cherokee County, GA",GA,2014,117819,111330,6489,5.5,2273
"Cherokee County, GA",GA,2013,115546,108491,7055,6.1,864
"Cherokee County, GA",GA,2012,114682,106681,8001,7.0,1052
"Cherokee County, GA",GA,2011,113630,104432,9198,8.1,778
"Cherokee County, GA",GA,2010,112852,102814,10038,8.9,0
"Cherokee County, IA",IA,2021,6119,5912,207,3.4,-116
"Cherokee County, IA",IA,2020,6235,6004,231,3.7,-40
"Cherokee County, IA",IA,2019,6275,6126,149,2.4,205
"Cherokee County, IA",IA,2018,6070,5940,130,2.1,-35
"Cherokee County, IA",IA,2017,6105,5954,151,2.5,-248
"Cherokee County, IA",IA,2016,6353,6124,229,3.6,13
"Cherokee County, IA",IA,2015,6340,6015,325,5.1,-290
"Cherokee County, IA",IA,2014,6630,6294,336,5.1,-220
"Cherokee County, IA",IA,2013,6850,6555,295,4.3,-35
"Cherokee County, IA",IA,2012,6885,6585,300,4.4,-80
"Cherokee County, IA",IA,2011,6965,6628,337,4.8,-104
"Cherokee County, IA",IA,2010,7069,6745,324,4.6,0
"Cherokee County, KS",KS,2021,9907,9617,290,2.9,-67
"Cherokee County, KS",KS,2020,9974,9469,505,5.1,-214
"Cherokee County, KS",KS,2019,10188,9842,346,3.4,101
"Cherokee County, KS",KS,2018,10087,9720,367,3.6,-82
"Cherokee County, KS",KS,2017,10169,9774,395,3.9,-167
"Cherokee County, KS",KS,2016,10336,9879,457,4.4,-105
"Cherokee County, KS",KS,2015,10441,9978,463,4.4,75
"Cherokee County, KS",KS,2014,10366,9848,518,5.0,-157
"Cherokee County, KS",KS,2013,10523,9851,672,6.4,-88
"Cherokee County, KS",KS,2012,10611,9783,828,7.8,-240
"Cherokee County, KS",KS,2011,10851,9982,869,8.0,55
"Cherokee County, KS",KS,2010,10796,9826,970,9.0,0
"Cherokee County, NC",NC,2021,10592,10066,526,5.0,-62
"Cherokee County, NC",NC,2020,10654,9832,822,7.7,-468
"Cherokee County, NC",NC,2019,11122,10633,489,4.4,10
"Cherokee County, NC",NC,2018,11112,10608,504,4.5,97
"Cherokee County, NC",NC,2017,11015,10467,548,5.0,-96
"Cherokee County, NC",NC,2016,11111,10479,632,5.7,3
"Cherokee County, NC",NC,2015,11108,10400,708,6.4,6
"Cherokee County, NC",NC,2014,11102,10337,765,6.9,-179
"Cherokee County, NC",NC,2013,11281,10269,1012,9.0,-244
"Cherokee County, NC",NC,2012,11525,10232,1293,11.2,-132
"Cherokee County, NC",NC,2011,11657,10277,1380,11.8,-37
"Cherokee County, NC",NC,2010,11694,10200,1494,12.8,0
"Cherokee County, OK",OK,2021,19939,19116,823,4.1,450
"Cherokee County, OK",OK,2020,19489,18401,1088,5.6,769
"Cherokee County, OK",OK,2019,18720,18012,708,3.8,-20
"Cherokee County, OK",OK,2018,18740,17980,760,4.1,-344
"Cherokee County, OK",OK,2017,19084,18109,975,5.1,-175
"Cherokee County, OK",OK,2016,19259,18237,1022,5.3,10
"Cherokee County, OK",OK,2015,19249,18279,970,5.0,743
"Cherokee County, OK",OK,2014,18506,17427,1079,5.8,-190
"Cherokee County, OK",OK,2013,18696,17433,1263,6.8,-187
"Cherokee County, OK",OK,2012,18883,17593,1290,6.8,-281
"Cherokee County, OK",OK,2011,19164,17833,1331,6.9,-267
"Cherokee County, OK",OK,2010,19431,18001,1430,7.4,0
"Cherokee County, SC",SC,2021,24817,23561,1256,5.1,81
"Cherokee County, SC",SC,2020,24736,22807,1929,7.8,95
"Cherokee County, SC",SC,2019,24641,23905,736,3.0,139
"Cherokee County, SC",SC,2018,24502,23625,877,3.6,1176
"Cherokee County, SC",SC,2017,23326,22187,1139,4.9,-130
"Cherokee County, SC",SC,2016,23456,22085,1371,5.8,10
"Cherokee County, SC",SC,2015,23446,21792,1654,7.1,-201
"Cherokee County, SC",SC,2014,23647,21735,1912,8.1,-140
"Cherokee County, SC",SC,2013,23787,21355,2432,10.2,19
"Cherokee County, SC",SC,2012,23768,20782,2986,12.6,32
"Cherokee County, SC",SC,2011,23736,20283,3453,14.5,-174
"Cherokee County, SC",SC,2010,23910,20096,3814,16.0,0
"Cherokee County, TX",TX,2021,20864,19527,1337,6.4,-116
"Cherokee County, TX",TX,2020,20980,19316,1664,7.9,220
"Cherokee County, TX",TX,2019,20760,19975,785,3.8,62
"Cherokee County, TX",TX,2018,20698,19839,859,4.2,72
"Cherokee County, TX",TX,2017,20626,19682,944,4.6,-582
"Cherokee County, TX",TX,2016,21208,20128,1080,5.1,300
"Cherokee County, TX",TX,2015,20908,19820,1088,5.2,-245
"Cherokee County, TX",TX,2014,21153,19910,1243,5.9,-340
"Cherokee County, TX",TX,2013,21493,19991,1502,7.0,-432
"Cherokee County, TX",TX,2012,21925,20347,1578,7.2,-277
"Cherokee County, TX",TX,2011,22202,20340,1862,8.4,277
"Cherokee County, TX",TX,2010,21925,19980,1945,8.9,0
"Cherry County, NE",NE,2021,3473,3418,55,1.6,73
"Cherry County, NE",NE,2020,3400,3318,82,2.4,-6
"Cherry County, NE",NE,2019,3406,3325,81,2.4,37
"Cherry County, NE",NE,2018,3369,3294,75,2.2,-54
"Cherry County, NE",NE,2017,3423,3343,80,2.3,-68
"Cherry County, NE",NE,2016,3491,3412,79,2.3,28
"Cherry County, NE",NE,2015,3463,3384,79,2.3,46
"Cherry County, NE",NE,2014,3417,3334,83,2.4,-63
"Cherry County, NE",NE,2013,3480,3386,94,2.7,4
"Cherry County, NE",NE,2012,3476,3379,97,2.8,22
"Cherry County, NE",NE,2011,3454,3349,105,3.0,76
"Cherry County, NE",NE,2010,3378,3277,101,3.0,0
"Chesapeake city, VA",VA,2021,119733,115125,4608,3.8,-3281
"Chesapeake city, VA",VA,2020,123014,115546,7468,6.1,-2813
"Chesapeake city, VA",VA,2019,125827,122255,3572,2.8,2307
"Chesapeake city, VA",VA,2018,123520,119816,3704,3.0,1500
"Chesapeake city, VA",VA,2017,122020,117462,4558,3.7,3934
"Chesapeake city, VA",VA,2016,118086,113123,4963,4.2,1309
"Chesapeake city, VA",VA,2015,116777,111550,5227,4.5,-893
"Chesapeake city, VA",VA,2014,117670,111586,6084,5.2,1307
"Chesapeake city, VA",VA,2013,116363,109643,6720,5.8,1356
"Chesapeake city, VA",VA,2012,115007,107776,7231,6.3,540
"Chesapeake city, VA",VA,2011,114467,106576,7891,6.9,985
"Chesapeake city, VA",VA,2010,113482,105121,8361,7.4,0
"Cheshire County, NH",NH,2021,39426,37904,1522,3.9,-163
"Cheshire County, NH",NH,2020,39589,37126,2463,6.2,-1278
"Cheshire County, NH",NH,2019,40867,39780,1087,2.7,-125
"Cheshire County, NH",NH,2018,40992,39910,1082,2.6,-182
"Cheshire County, NH",NH,2017,41174,40065,1109,2.7,-284
"Cheshire County, NH",NH,2016,41458,40323,1135,2.7,-152
"Cheshire County, NH",NH,2015,41610,40280,1330,3.2,-515
"Cheshire County, NH",NH,2014,42125,40413,1712,4.1,83
"Cheshire County, NH",NH,2013,42042,39987,2055,4.9,-558
"Cheshire County, NH",NH,2012,42600,40455,2145,5.0,29
"Cheshire County, NH",NH,2011,42571,40413,2158,5.1,-111
"Cheshire County, NH",NH,2010,42682,40207,2475,5.8,0
"Chester County, PA",PA,2021,286372,274342,12030,4.2,1224
"Chester County, PA",PA,2020,285148,266873,18275,6.4,-5633
"Chester County, PA",PA,2019,290781,281287,9494,3.3,4988
"Chester County, PA",PA,2018,285793,276376,9417,3.3,2240
"Chester County, PA",PA,2017,283553,273197,10356,3.7,2756
"Chester County, PA",PA,2016,280797,270039,10758,3.8,3699
"Chester County, PA",PA,2015,277098,266346,10752,3.9,3565
"Chester County, PA",PA,2014,273533,262015,11518,4.2,743
"Chester County, PA",PA,2013,272790,258850,13940,5.1,257
"Chester County, PA",PA,2012,272533,257539,14994,5.5,2936
"Chester County, PA",PA,2011,269597,254367,15230,5.6,744
"Chester County, PA",PA,2010,268853,252588,16265,6.0,0
"Chester County, SC",SC,2021,13279,12490,789,5.9,125
"Chester County, SC",SC,2020,13154,11997,1157,8.8,227
"Chester County, SC",SC,2019,12927,12397,530,4.1,126
"Chester County, SC",SC,2018,12801,12183,618,4.8,-229
"Chester County, SC",SC,2017,13030,12245,785,6.0,-314
"Chester County, SC",SC,2016,13344,12404,940,7.0,-99
"Chester County, SC",SC,2015,13443,12328,1115,8.3,25
"Chester County, SC",SC,2014,13418,12154,1264,9.4,-285
"Chester County, SC",SC,2013,13703,12069,1634,11.9,-336
"Chester County, SC",SC,2012,14039,12005,2034,14.5,-423
"Chester County, SC",SC,2011,14462,11985,2477,17.1,-375
"Chester County, SC",SC,2010,14837,11943,2894,19.5,0
"Chester County, TN",TN,2021,8507,8228,279,3.3,34
"Chester County, TN",TN,2020,8473,8007,466,5.5,-150
"Chester County, TN",TN,2019,8623,8327,296,3.4,107
"Chester County, TN",TN,2018,8516,8197,319,3.7,173
"Chester County, TN",TN,2017,8343,8011,332,4.0,-107
"Chester County, TN",TN,2016,8450,8028,422,5.0,208
"Chester County, TN",TN,2015,8242,7762,480,5.8,77
"Chester County, TN",TN,2014,8165,7609,556,6.8,-128
"Chester County, TN",TN,2013,8293,7623,670,8.1,-71
"Chester County, TN",TN,2012,8364,7697,667,8.0,-146
"Chester County, TN",TN,2011,8510,7725,785,9.2,140
"Chester County, TN",TN,2010,8370,7521,849,10.1,0
"Chesterfield County, SC",SC,2021,21543,20570,973,4.5,245
"Chesterfield County, SC",SC,2020,21298,20043,1255,5.9,-241
"Chesterfield County, SC",SC,2019,21539,20926,613,2.8,145
"Chesterfield County, SC",SC,2018,21394,20710,684,3.2,350
"Chesterfield County, SC",SC,2017,21044,20149,895,4.3,-524
"Chesterfield County, SC",SC,2016,21568,20516,1052,4.9,137
"Chesterfield County, SC",SC,2015,21431,20145,1286,6.0,216
"Chesterfield County, SC",SC,2014,21215,19798,1417,6.7,165
"Chesterfield County, SC",SC,2013,21050,19167,1883,8.9,-19
"Chesterfield County, SC",SC,2012,21069,18724,2345,11.1,-182
"Chesterfield County, SC",SC,2011,21251,18553,2698,12.7,-236
"Chesterfield County, SC",SC,2010,21487,18356,3131,14.6,0
"Chesterfield County, VA",VA,2021,183962,177248,6714,3.6,-4407
"Chesterfield County, VA",VA,2020,188369,177388,10981,5.8,-3402
"Chesterfield County, VA",VA,2019,191771,186569,5202,2.7,3787
"Chesterfield County, VA",VA,2018,187984,182542,5442,2.9,2589
"Chesterfield County, VA",VA,2017,185395,178778,6617,3.6,4423
"Chesterfield County, VA",VA,2016,180972,174105,6867,3.8,2297
"Chesterfield County, VA",VA,2015,178675,171090,7585,4.2,632
"Chesterfield County, VA",VA,2014,178043,169093,8950,5.0,3324
"Chesterfield County, VA",VA,2013,174719,165077,9642,5.5,1989
"Chesterfield County, VA",VA,2012,172730,162399,10331,6.0,1461
"Chesterfield County, VA",VA,2011,171269,159724,11545,6.7,2419
"Chesterfield County, VA",VA,2010,168850,156230,12620,7.5,0
"Cheyenne County, CO",CO,2021,1105,1080,25,2.3,22
"Cheyenne County, CO",CO,2020,1083,1058,25,2.3,-46
"Cheyenne County, CO",CO,2019,1129,1112,17,1.5,0
"Cheyenne County, CO",CO,2018,1129,1110,19,1.7,5
"Cheyenne County, CO",CO,2017,1124,1106,18,1.6,43
"Cheyenne County, CO",CO,2016,1081,1058,23,2.1,70
"Cheyenne County, CO",CO,2015,1011,985,26,2.6,40
"Cheyenne County, CO",CO,2014,971,943,28,2.9,2
"Cheyenne County, CO",CO,2013,969,929,40,4.1,-37
"Cheyenne County, CO",CO,2012,1006,960,46,4.6,-41
"Cheyenne County, CO",CO,2011,1047,1001,46,4.4,5
"Cheyenne County, CO",CO,2010,1042,996,46,4.4,0
"Cheyenne County, KS",KS,2021,1299,1276,23,1.8,-3
"Cheyenne County, KS",KS,2020,1302,1274,28,2.2,-11
"Cheyenne County, KS",KS,2019,1313,1282,31,2.4,-4
"Cheyenne County, KS",KS,2018,1317,1287,30,2.3,-4
"Cheyenne County, KS",KS,2017,1321,1287,34,2.6,-30
"Cheyenne County, KS",KS,2016,1351,1313,38,2.8,-10
"Cheyenne County, KS",KS,2015,1361,1324,37,2.7,44
"Cheyenne County, KS",KS,2014,1317,1276,41,3.1,5
"Cheyenne County, KS",KS,2013,1312,1267,45,3.4,-23
"Cheyenne County, KS",KS,2012,1335,1287,48,3.6,-19
"Cheyenne County, KS",KS,2011,1354,1296,58,4.3,-51
"Cheyenne County, KS",KS,2010,1405,1349,56,4.0,0
"Cheyenne County, NE",NE,2021,4261,4142,119,2.8,-26
"Cheyenne County, NE",NE,2020,4287,4102,185,4.3,-149
"Cheyenne County, NE",NE,2019,4436,4276,160,3.6,-311
"Cheyenne County, NE",NE,2018,4747,4611,136,2.9,-400
"Cheyenne County, NE",NE,2017,5147,4997,150,2.9,-336
"Cheyenne County, NE",NE,2016,5483,5329,154,2.8,-287
"Cheyenne County, NE",NE,2015,5770,5645,125,2.2,19
"Cheyenne County, NE",NE,2014,5751,5627,124,2.2,-50
"Cheyenne County, NE",NE,2013,5801,5641,160,2.8,23
"Cheyenne County, NE",NE,2012,5778,5622,156,2.7,93
"Cheyenne County, NE",NE,2011,5685,5512,173,3.0,136
"Cheyenne County, NE",NE,2010,5549,5344,205,3.7,0
"Chickasaw County, IA",IA,2021,6373,6146,227,3.6,47
"Chickasaw County, IA",IA,2020,6326,6038,288,4.6,-286
"Chickasaw County, IA",IA,2019,6612,6432,180,2.7,103
"Chickasaw County, IA",IA,2018,6509,6335,174,2.7,77
"Chickasaw County, IA",IA,2017,6432,6230,202,3.1,-26
"Chickasaw County, IA",IA,2016,6458,6175,283,4.4,3
"Chickasaw County, IA",IA,2015,6455,6167,288,4.5,-23
"Chickasaw County, IA",IA,2014,6478,6172,306,4.7,103
"Chickasaw County, IA",IA,2013,6375,6057,318,5.0,54
"Chickasaw County, IA",IA,2012,6321,5991,330,5.2,-199
"Chickasaw County, IA",IA,2011,6520,6104,416,6.4,-23
"Chickasaw County, IA",IA,2010,6543,6047,496,7.6,0
"Chickasaw County, MS",MS,2021,6870,6437,433,6.3,3
"Chickasaw County, MS",MS,2020,6867,6140,727,10.6,-59
"Chickasaw County, MS",MS,2019,6926,6531,395,5.7,-76
"Chickasaw County, MS",MS,2018,7002,6642,360,5.1,-50
"Chickasaw County, MS",MS,2017,7052,6673,379,5.4,-10
"Chickasaw County, MS",MS,2016,7062,6588,474,6.7,-68
"Chickasaw County, MS",MS,2015,7130,6575,555,7.8,-56
"Chickasaw County, MS",MS,2014,7186,6480,706,9.8,-429
"Chickasaw County, MS",MS,2013,7615,6805,810,10.6,-458
"Chickasaw County, MS",MS,2012,8073,7263,810,10.0,-198
"Chickasaw County, MS",MS,2011,8271,7347,924,11.2,316
"Chickasaw County, MS",MS,2010,7955,7025,930,11.7,0
"Chicot County, AR",AR,2021,3084,2820,264,8.6,-129
"Chicot County, AR",AR,2020,3213,2876,337,10.5,-41
"Chicot County, AR",AR,2019,3254,3034,220,6.8,-101
"Chicot County, AR",AR,2018,3355,3130,225,6.7,-110
"Chicot County, AR",AR,2017,3465,3238,227,6.6,-125
"Chicot County, AR",AR,2016,3590,3353,237,6.6,-153
"Chicot County, AR",AR,2015,3743,3408,335,9.0,-134
"Chicot County, AR",AR,2014,3877,3480,397,10.2,14
"Chicot County, AR",AR,2013,3863,3425,438,11.3,-211
"Chicot County, AR",AR,2012,4074,3628,446,10.9,-187
"Chicot County, AR",AR,2011,4261,3726,535,12.6,-10
"Chicot County, AR",AR,2010,4271,3763,508,11.9,0
"Childress County, TX",TX,2021,3011,2903,108,3.6,16
"Childress County, TX",TX,2020,2995,2884,111,3.7,72
"Childress County, TX",TX,2019,2923,2844,79,2.7,0
"Childress County, TX",TX,2018,2923,2845,78,2.7,35
"Childress County, TX",TX,2017,2888,2802,86,3.0,-73
"Childress County, TX",TX,2016,2961,2872,89,3.0,91
"Childress County, TX",TX,2015,2870,2780,90,3.1,11
"Childress County, TX",TX,2014,2859,2753,106,3.7,-71
"Childress County, TX",TX,2013,2930,2804,126,4.3,-32
"Childress County, TX",TX,2012,2962,2832,130,4.4,-118
"Childress County, TX",TX,2011,3080,2916,164,5.3,-82
"Childress County, TX",TX,2010,3162,2982,180,5.7,0
"Chilton County, AL",AL,2021,19811,19246,565,2.9,-125
"Chilton County, AL",AL,2020,19936,18839,1097,5.5,-209
"Chilton County, AL",AL,2019,20145,19567,578,2.9,311
"Chilton County, AL",AL,2018,19834,19121,713,3.6,356
"Chilton County, AL",AL,2017,19478,18667,811,4.2,449
"Chilton County, AL",AL,2016,19029,17982,1047,5.5,-60
"Chilton County, AL",AL,2015,19089,18005,1084,5.7,-41
"Chilton County, AL",AL,2014,19130,17938,1192,6.2,-209
"Chilton County, AL",AL,2013,19339,18052,1287,6.7,-57
"Chilton County, AL",AL,2012,19396,17960,1436,7.4,-140
"Chilton County, AL",AL,2011,19536,17761,1775,9.1,62
"Chilton County, AL",AL,2010,19474,17502,1972,10.1,0
"Chippewa County, MI",MI,2021,15786,14754,1032,6.5,-119
"Chippewa County, MI",MI,2020,15905,14400,1505,9.5,-207
"Chippewa County, MI",MI,2019,16112,15082,1030,6.4,-144
"Chippewa County, MI",MI,2018,16256,15168,1088,6.7,-96
"Chippewa County, MI",MI,2017,16352,15115,1237,7.6,-86
"Chippewa County, MI",MI,2016,16438,15165,1273,7.7,-338
"Chippewa County, MI",MI,2015,16776,15455,1321,7.9,-136
"Chippewa County, MI",MI,2014,16912,15304,1608,9.5,-140
"Chippewa County, MI",MI,2013,17052,15286,1766,10.4,-117
"Chippewa County, MI",MI,2012,17169,15465,1704,9.9,-179
"Chippewa County, MI",MI,2011,17348,15539,1809,10.4,-289
"Chippewa County, MI",MI,2010,17637,15595,2042,11.6,0
"Chippewa County, MN",MN,2021,6462,6271,191,3.0,-340
"Chippewa County, MN",MN,2020,6802,6443,359,5.3,-173
"Chippewa County, MN",MN,2019,6975,6687,288,4.1,62
"Chippewa County, MN",MN,2018,6913,6677,236,3.4,-44
"Chippewa County, MN",MN,2017,6957,6678,279,4.0,-6
"Chippewa County, MN",MN,2016,6963,6648,315,4.5,0
"Chippewa County, MN",MN,2015,6963,6651,312,4.5,50
"Chippewa County, MN",MN,2014,6913,6592,321,4.6,-40
"Chippewa County, MN",MN,2013,6953,6590,363,5.2,-114
"Chippewa County, MN",MN,2012,7067,6690,377,5.3,-132
"Chippewa County, MN",MN,2011,7199,6743,456,6.3,42
"Chippewa County, MN",MN,2010,7157,6631,526,7.3,0
"Chippewa County, WI",WI,2021,33814,32489,1325,3.9,566
"Chippewa County, WI",WI,2020,33248,31163,2085,6.3,-269
"Chippewa County, WI",WI,2019,33517,32308,1209,3.6,58
"Chippewa County, WI",WI,2018,33459,32370,1089,3.3,-89
"Chippewa County, WI",WI,2017,33548,32382,1166,3.5,285
"Chippewa County, WI",WI,2016,33263,31887,1376,4.1,199
"Chippewa County, WI",WI,2015,33064,31542,1522,4.6,42
"Chippewa County, WI",WI,2014,33022,31269,1753,5.3,56
"Chippewa County, WI",WI,2013,32966,30759,2207,6.7,-259
"Chippewa County, WI",WI,2012,33225,31011,2214,6.7,-78
"Chippewa County, WI",WI,2011,33303,30787,2516,7.6,110
"Chippewa County, WI",WI,2010,33193,30454,2739,8.3,0
"Chisago County, MN",MN,2021,29423,28335,1088,3.7,-960
"Chisago County, MN",MN,2020,30383,28317,2066,6.8,-220
"Chisago County, MN",MN,2019,30603,29380,1223,4.0,665
"Chisago County, MN",MN,2018,29938,28863,1075,3.6,321
"Chisago County, MN",MN,2017,29617,28431,1186,4.0,489
"Chisago County, MN",MN,2016,29128,27869,1259,4.3,323
"Chisago County, MN",MN,2015,28805,27577,1228,4.3,154
"Chisago County, MN",MN,2014,28651,27270,1381,4.8,94
"Chisago County, MN",MN,2013,28557,26939,1618,5.7,-36
"Chisago County, MN",MN,2012,28593,26703,1890,6.6,-453
"Chisago County, MN",MN,2011,29046,26827,2219,7.6,-287
"Chisago County, MN",MN,2010,29333,26721,2612,8.9,0
"Chittenden County, VT",VT,2021,92865,90238,2627,2.8,-3328
"Chittenden County, VT",VT,2020,96193,91705,4488,4.7,-4029
"Chittenden County, VT",VT,2019,100222,98451,1771,1.8,13
"Chittenden County, VT",VT,2018,100209,98196,2013,2.0,749
"Chittenden County, VT",VT,2017,99460,97209,2251,2.3,3900
"Chittenden County, VT",VT,2016,95560,93248,2312,2.4,194
"Chittenden County, VT",VT,2015,95366,92799,2567,2.7,-598
"Chittenden County, VT",VT,2014,95964,93018,2946,3.1,955
"Chittenden County, VT",VT,2013,95009,91747,3262,3.4,-614
"Chittenden County, VT",VT,2012,95623,92113,3510,3.7,250
"Chittenden County, VT",VT,2011,95373,91300,4073,4.3,765
"Chittenden County, VT",VT,2010,94608,89890,4718,5.0,0
"Choctaw County, AL",AL,2021,4591,4391,200,4.4,-108
"Choctaw County, AL",AL,2020,4699,4351,348,7.4,-23
"Choctaw County, AL",AL,2019,4722,4490,232,4.9,-78
"Choctaw County, AL",AL,2018,4800,4539,261,5.4,340
"Choctaw County, AL",AL,2017,4460,4172,288,6.5,168
"Choctaw County, AL",AL,2016,4292,3926,366,8.5,-77
"Choctaw County, AL",AL,2015,4369,3969,400,9.2,-132
"Choctaw County, AL",AL,2014,4501,4098,403,9.0,-200
"Choctaw County, AL",AL,2013,4701,4261,440,9.4,-97
"Choctaw County, AL",AL,2012,4798,4292,506,10.5,38
"Choctaw County, AL",AL,2011,4760,4140,620,13.0,-97
"Choctaw County, AL",AL,2010,4857,4225,632,13.0,0
"Choctaw County, MS",MS,2021,3565,3394,171,4.8,20
"Choctaw County, MS",MS,2020,3545,3324,221,6.2,-161
"Choctaw County, MS",MS,2019,3706,3500,206,5.6,-2
"Choctaw County, MS",MS,2018,3708,3521,187,5.0,98
"Choctaw County, MS",MS,2017,3610,3425,185,5.1,-100
"Choctaw County, MS",MS,2016,3710,3496,214,5.8,10
"Choctaw County, MS",MS,2015,3700,3465,235,6.4,133
"Choctaw County, MS",MS,2014,3567,3273,294,8.2,-182
"Choctaw County, MS",MS,2013,3749,3431,318,8.5,-17
"Choctaw County, MS",MS,2012,3766,3429,337,8.9,-51
"Choctaw County, MS",MS,2011,3817,3436,381,10.0,45
"Choctaw County, MS",MS,2010,3772,3339,433,11.5,0
"Choctaw County, OK",OK,2021,5940,5633,307,5.2,388
"Choctaw County, OK",OK,2020,5552,5128,424,7.6,144
"Choctaw County, OK",OK,2019,5408,5158,250,4.6,-260
"Choctaw County, OK",OK,2018,5668,5395,273,4.8,-28
"Choctaw County, OK",OK,2017,5696,5364,332,5.8,-46
"Choctaw County, OK",OK,2016,5742,5319,423,7.4,-164
"Choctaw County, OK",OK,2015,5906,5464,442,7.5,102
"Choctaw County, OK",OK,2014,5804,5339,465,8.0,-157
"Choctaw County, OK",OK,2013,5961,5469,492,8.3,162
"Choctaw County, OK",OK,2012,5799,5324,475,8.2,-201
"Choctaw County, OK",OK,2011,6000,5485,515,8.6,-109
"Choctaw County, OK",OK,2010,6109,5574,535,8.8,0
"Chouteau County, MT",MT,2021,2459,2392,67,2.7,-14
"Chouteau County, MT",MT,2020,2473,2379,94,3.8,-11
"Chouteau County, MT",MT,2019,2484,2415,69,2.8,-10
"Chouteau County, MT",MT,2018,2494,2419,75,3.0,-13
"Chouteau County, MT",MT,2017,2507,2423,84,3.4,-6
"Chouteau County, MT",MT,2016,2513,2415,98,3.9,-12
"Chouteau County, MT",MT,2015,2525,2440,85,3.4,-67
"Chouteau County, MT",MT,2014,2592,2508,84,3.2,4
"Chouteau County, MT",MT,2013,2588,2494,94,3.6,-81
"Chouteau County, MT",MT,2012,2669,2568,101,3.8,15
"Chouteau County, MT",MT,2011,2654,2539,115,4.3,-86
"Chouteau County, MT",MT,2010,2740,2622,118,4.3,0
"Chowan County, NC",NC,2021,5510,5238,272,4.9,209
"Chowan County, NC",NC,2020,5301,4987,314,5.9,-199
"Chowan County, NC",NC,2019,5500,5250,250,4.5,-6
"Chowan County, NC",NC,2018,5506,5258,248,4.5,-14
"Chowan County, NC",NC,2017,5520,5228,292,5.3,-65
"Chowan County, NC",NC,2016,5585,5227,358,6.4,-49
"Chowan County, NC",NC,2015,5634,5236,398,7.1,-42
"Chowan County, NC",NC,2014,5676,5241,435,7.7,-52
"Chowan County, NC",NC,2013,5728,5180,548,9.6,-230
"Chowan County, NC",NC,2012,5958,5294,664,11.1,-31
"Chowan County, NC",NC,2011,5989,5261,728,12.2,-184
"Chowan County, NC",NC,2010,6173,5440,733,11.9,0
"Christian County, IL",IL,2021,13401,12671,730,5.4,-97
"Christian County, IL",IL,2020,13498,12378,1120,8.3,-1021
"Christian County, IL",IL,2019,14519,13849,670,4.6,-289
"Christian County, IL",IL,2018,14808,14033,775,5.2,28
"Christian County, IL",IL,2017,14780,13994,786,5.3,-575
"Christian County, IL",IL,2016,15355,14373,982,6.4,-73
"Christian County, IL",IL,2015,15428,14406,1022,6.6,-300
"Christian County, IL",IL,2014,15728,14519,1209,7.7,-243
"Christian County, IL",IL,2013,15971,14421,1550,9.7,-463
"Christian County, IL",IL,2012,16434,14887,1547,9.4,-411
"Christian County, IL",IL,2011,16845,15223,1622,9.6,-287
"Christian County, IL",IL,2010,17132,15382,1750,10.2,0
"Christian County, KY",KY,2021,24795,23351,1444,5.8,335
"Christian County, KY",KY,2020,24460,22573,1887,7.7,-29
"Christian County, KY",KY,2019,24489,23180,1309,5.3,-40
"Christian County, KY",KY,2018,24529,23248,1281,5.2,58
"Christian County, KY",KY,2017,24471,22999,1472,6.0,-418
"Christian County, KY",KY,2016,24889,23381,1508,6.1,-43
"Christian County, KY",KY,2015,24932,23368,1564,6.3,-499
"Christian County, KY",KY,2014,25431,23505,1926,7.6,-1174
"Christian County, KY",KY,2013,26605,24122,2483,9.3,-150
"Christian County, KY",KY,2012,26755,24248,2507,9.4,-121
"Christian County, KY",KY,2011,26876,23983,2893,10.8,-570
"Christian County, KY",KY,2010,27446,24207,3239,11.8,0
"Christian County, MO",MO,2021,46547,45043,1504,3.2,939
"Christian County, MO",MO,2020,45608,43392,2216,4.9,304
"Christian County, MO",MO,2019,45304,44140,1164,2.6,1331
"Christian County, MO",MO,2018,43973,42855,1118,2.5,856
"Christian County, MO",MO,2017,43117,41787,1330,3.1,-190
"Christian County, MO",MO,2016,43307,41613,1694,3.9,521
"Christian County, MO",MO,2015,42786,40943,1843,4.3,744
"Christian County, MO",MO,2014,42042,39964,2078,4.9,1135
"Christian County, MO",MO,2013,40907,38654,2253,5.5,389
"Christian County, MO",MO,2012,40518,38083,2435,6.0,-182
"Christian County, MO",MO,2011,40700,37617,3083,7.6,13
"Christian County, MO",MO,2010,40687,37289,3398,8.4,0
"Chugach Census Area, AK",AK,2021,3412,3182,230,6.7,161
"Chugach Census Area, AK",AK,2020,3251,2972,279,8.6,-7979
"Churchill County, NV",NV,2021,11230,10839,391,3.5,185
"Churchill County, NV",NV,2020,11045,10411,634,5.7,-20
"Churchill County, NV",NV,2019,11065,10663,402,3.6,120
"Churchill County, NV",NV,2018,10945,10528,417,3.8,500
"Churchill County, NV",NV,2017,10445,9978,467,4.5,141
"Churchill County, NV",NV,2016,10304,9724,580,5.6,28
"Churchill County, NV",NV,2015,10276,9545,731,7.1,-229
"Churchill County, NV",NV,2014,10505,9664,841,8.0,-327
"Churchill County, NV",NV,2013,10832,9768,1064,9.8,-198
"Churchill County, NV",NV,2012,11030,9768,1262,11.4,-109
"Churchill County, NV",NV,2011,11139,9716,1423,12.8,-84
"Churchill County, NV",NV,2010,11223,9817,1406,12.5,0
"Ciales Municipio, PR",PR,2021,3941,3479,462,11.7,
"Ciales Municipio, PR",PR,2020,N.A.,N.A.,N.A.,N.A.,
"Ciales Municipio, PR",PR,2019,3678,3271,407,11.1,-4
"Ciales Municipio, PR",PR,2018,3682,3223,459,12.5,-152
"Ciales Municipio, PR",PR,2017,3834,3215,619,16.1,-5
"Ciales Municipio, PR",PR,2016,3839,3220,619,16.1,-76
"Ciales Municipio, PR",PR,2015,3915,3235,680,17.4,-274
"Ciales Municipio, PR",PR,2014,4189,3225,964,23.0,-276
"Ciales Municipio, PR",PR,2013,4465,3317,1148,25.7,180
"Ciales Municipio, PR",PR,2012,4285,3356,929,21.7,-187
"Ciales Municipio, PR",PR,2011,4472,3382,1090,24.4,-320
"Ciales Municipio, PR",PR,2010,4792,3500,1292,27.0,0
"Cibola County, NM",NM,2021,8875,8050,825,9.3,-93
"Cibola County, NM",NM,2020,8968,8168,800,8.9,-112
"Cibola County, NM",NM,2019,9080,8503,577,6.4,68
"Cibola County, NM",NM,2018,9012,8455,557,6.2,-194
"Cibola County, NM",NM,2017,9206,8501,705,7.7,-173
"Cibola County, NM",NM,2016,9379,8600,779,8.3,45
"Cibola County, NM",NM,2015,9334,8578,756,8.1,212
"Cibola County, NM",NM,2014,9122,8347,775,8.5,-51
"Cibola County, NM",NM,2013,9173,8383,790,8.6,-129
"Cibola County, NM",NM,2012,9302,8516,786,8.4,86
"Cibola County, NM",NM,2011,9216,8376,840,9.1,-30
"Cibola County, NM",NM,2010,9246,8396,850,9.2,0
"Cidra Municipio, PR",PR,2021,16380,15454,926,5.7,
"Cidra Municipio, PR",PR,2020,N.A.,N.A.,N.A.,N.A.,
"Cidra Municipio, PR",PR,2019,15455,14400,1055,6.8,182
"Cidra Municipio, PR",PR,2018,15273,14114,1159,7.6,27
"Cidra Municipio, PR",PR,2017,15246,13964,1282,8.4,-334
"Cidra Municipio, PR",PR,2016,15580,13986,1594,10.2,34
"Cidra Municipio, PR",PR,2015,15546,14001,1545,9.9,-218
"Cidra Municipio, PR",PR,2014,15764,13876,1888,12.0,-516
"Cidra Municipio, PR",PR,2013,16280,14210,2070,12.7,-581
"Cidra Municipio, PR",PR,2012,16861,14413,2448,14.5,-96
"Cidra Municipio, PR",PR,2011,16957,14318,2639,15.6,-530
"Cidra Municipio, PR",PR,2010,17487,14742,2745,15.7,0
"Cimarron County, OK",OK,2021,1503,1476,27,1.8,106
"Cimarron County, OK",OK,2020,1397,1368,29,2.1,75
"Cimarron County, OK",OK,2019,1322,1300,22,1.7,-51
"Cimarron County, OK",OK,2018,1373,1348,25,1.8,-41
"Cimarron County, OK",OK,2017,1414,1382,32,2.3,-2
"Cimarron County, OK",OK,2016,1416,1382,34,2.4,41
"Cimarron County, OK",OK,2015,1375,1345,30,2.2,100
"Cimarron County, OK",OK,2014,1275,1240,35,2.7,42
"Cimarron County, OK",OK,2013,1233,1194,39,3.2,-53
"Cimarron County, OK",OK,2012,1286,1246,40,3.1,-83
"Cimarron County, OK",OK,2011,1369,1325,44,3.2,-88
"Cimarron County, OK",OK,2010,1457,1408,49,3.4,0
"Citrus County, FL",FL,2021,47343,44656,2687,5.7,755
"Citrus County, FL",FL,2020,46588,42350,4238,9.1,-367
"Citrus County, FL",FL,2019,46955,44621,2334,5.0,-195
"Citrus County, FL",FL,2018,47150,44605,2545,5.4,-348
"Citrus County, FL",FL,2017,47498,44662,2836,6.0,-508
"Citrus County, FL",FL,2016,48006,44748,3258,6.8,0
"Citrus County, FL",FL,2015,48006,44364,3642,7.6,-180
"Citrus County, FL",FL,2014,48186,43951,4235,8.8,-1116
"Citrus County, FL",FL,2013,49302,44323,4979,10.1,-1955
"Citrus County, FL",FL,2012,51257,45575,5682,11.1,-499
"Citrus County, FL",FL,2011,51756,45289,6467,12.5,-595
"Citrus County, FL",FL,2010,52351,45375,6976,13.3,0
"Clackamas County, OR",OR,2021,222815,212018,10797,4.8,4458
"Clackamas County, OR",OR,2020,218357,202544,15813,7.2,-31
"Clackamas County, OR",OR,2019,218388,211061,7327,3.4,1943
"Clackamas County, OR",OR,2018,216445,208578,7867,3.6,345
"Clackamas County, OR",OR,2017,216100,208169,7931,3.7,3912
"Clackamas County, OR",OR,2016,212188,203105,9083,4.3,6867
"Clackamas County, OR",OR,2015,205321,195069,10252,5.0,3239
"Clackamas County, OR",OR,2014,202082,189892,12190,6.0,3766
"Clackamas County, OR",OR,2013,198316,184482,13834,7.0,-3262
"Clackamas County, OR",OR,2012,201578,185371,16207,8.0,-2744
"Clackamas County, OR",OR,2011,204322,186042,18280,8.9,908
"Clackamas County, OR",OR,2010,203414,182789,20625,10.1,0
"Claiborne County, MS",MS,2021,2980,2632,348,11.7,-82
"Claiborne County, MS",MS,2020,3062,2630,432,14.1,-33
"Claiborne County, MS",MS,2019,3095,2766,329,10.6,80
"Claiborne County, MS",MS,2018,3015,2731,284,9.4,-6
"Claiborne County, MS",MS,2017,3021,2718,303,10.0,-61
"Claiborne County, MS",MS,2016,3082,2725,357,11.6,-30
"Claiborne County, MS",MS,2015,3112,2716,396,12.7,9
"Claiborne County, MS",MS,2014,3103,2645,458,14.8,-196
"Claiborne County, MS",MS,2013,3299,2741,558,16.9,-263
"Claiborne County, MS",MS,2012,3562,3023,539,15.1,-131
"Claiborne County, MS",MS,2011,3693,3117,576,15.6,112
"Claiborne County, MS",MS,2010,3581,2998,583,16.3,0
"Claiborne County, TN",TN,2021,12760,12237,523,4.1,-26
"Claiborne County, TN",TN,2020,12786,11840,946,7.4,-357
"Claiborne County, TN",TN,2019,13143,12591,552,4.2,142
"Claiborne County, TN",TN,2018,13001,12449,552,4.2,280
"Claiborne County, TN",TN,2017,12721,12120,601,4.7,15
"Claiborne County, TN",TN,2016,12706,11913,793,6.2,105
"Claiborne County, TN",TN,2015,12601,11696,905,7.2,-108
"Claiborne County, TN",TN,2014,12709,11606,1103,8.7,-343
"Claiborne County, TN",TN,2013,13052,11656,1396,10.7,-267
"Claiborne County, TN",TN,2012,13319,11985,1334,10.0,-337
"Claiborne County, TN",TN,2011,13656,12125,1531,11.2,23
"Claiborne County, TN",TN,2010,13633,12136,1497,11.0,0
"Claiborne Parish, LA",LA,2021,5456,5190,266,4.9,-2
"Claiborne Parish, LA",LA,2020,5458,5069,389,7.1,-387
"Claiborne Parish, LA",LA,2019,5845,5530,315,5.4,17
"Claiborne Parish, LA",LA,2018,5828,5529,299,5.1,-39
"Claiborne Parish, LA",LA,2017,5867,5554,313,5.3,-91
"Claiborne Parish, LA",LA,2016,5958,5560,398,6.7,-203
"Claiborne Parish, LA",LA,2015,6161,5713,448,7.3,-168
"Claiborne Parish, LA",LA,2014,6329,5868,461,7.3,-195
"Claiborne Parish, LA",LA,2013,6524,6056,468,7.2,-530
"Claiborne Parish, LA",LA,2012,7054,6550,504,7.1,161
"Claiborne Parish, LA",LA,2011,6893,6345,548,8.0,6
"Claiborne Parish, LA",LA,2010,6887,6315,572,8.3,0
"Clallam County, WA",WA,2021,29371,27460,1911,6.5,467
"Clallam County, WA",WA,2020,28904,25951,2953,10.2,-230
"Clallam County, WA",WA,2019,29134,27175,1959,6.7,865
"Clallam County, WA",WA,2018,28269,26474,1795,6.3,385
"Clallam County, WA",WA,2017,27884,26016,1868,6.7,552
"Clallam County, WA",WA,2016,27332,25285,2047,7.5,548
"Clallam County, WA",WA,2015,26784,24680,2104,7.9,102
"Clallam County, WA",WA,2014,26682,24504,2178,8.2,-617
"Clallam County, WA",WA,2013,27299,24731,2568,9.4,-698
"Clallam County, WA",WA,2012,27997,25310,2687,9.6,-176
"Clallam County, WA",WA,2011,28173,25391,2782,9.9,-833
"Clallam County, WA",WA,2010,29006,26094,2912,10.0,0
"Clare County, MI",MI,2021,11148,10251,897,8.0,-552
"Clare County, MI",MI,2020,11700,10288,1412,12.1,-109
"Clare County, MI",MI,2019,11809,11078,731,6.2,-15
"Clare County, MI",MI,2018,11824,11096,728,6.2,-133
"Clare County, MI",MI,2017,11957,11136,821,6.9,-34
"Clare County, MI",MI,2016,11991,11106,885,7.4,150
"Clare County, MI",MI,2015,11841,10912,929,7.8,-104
"Clare County, MI",MI,2014,11945,10767,1178,9.9,32
"Clare County, MI",MI,2013,11913,10530,1383,11.6,-91
"Clare County, MI",MI,2012,12004,10599,1405,11.7,-122
"Clare County, MI",MI,2011,12126,10588,1538,12.7,-281
"Clare County, MI",MI,2010,12407,10533,1874,15.1,0
"Clarendon County, SC",SC,2021,12307,11701,606,4.9,-131
"Clarendon County, SC",SC,2020,12438,11621,817,6.6,50
"Clarendon County, SC",SC,2019,12388,11918,470,3.8,107
"Clarendon County, SC",SC,2018,12281,11714,567,4.6,160
"Clarendon County, SC",SC,2017,12121,11409,712,5.9,-556
"Clarendon County, SC",SC,2016,12677,11849,828,6.5,-379
"Clarendon County, SC",SC,2015,13056,12061,995,7.6,78
"Clarendon County, SC",SC,2014,12978,11920,1058,8.2,-36
"Clarendon County, SC",SC,2013,13014,11705,1309,10.1,-278
"Clarendon County, SC",SC,2012,13292,11621,1671,12.6,-401
"Clarendon County, SC",SC,2011,13693,11731,1962,14.3,-317
"Clarendon County, SC",SC,2010,14010,12020,1990,14.2,0
"Clarion County, PA",PA,2021,16640,15565,1075,6.5,-355
"Clarion County, PA",PA,2020,16995,15585,1410,8.3,-278
"Clarion County, PA",PA,2019,17273,16407,866,5.0,-316
"Clarion County, PA",PA,2018,17589,16710,879,5.0,-302
"Clarion County, PA",PA,2017,17891,16866,1025,5.7,-162
"Clarion County, PA",PA,2016,18053,16953,1100,6.1,-225
"Clarion County, PA",PA,2015,18278,17167,1111,6.1,-142
"Clarion County, PA",PA,2014,18420,17251,1169,6.3,-190
"Clarion County, PA",PA,2013,18610,17150,1460,7.8,-346
"Clarion County, PA",PA,2012,18956,17290,1666,8.8,-102
"Clarion County, PA",PA,2011,19058,17202,1856,9.7,-450
"Clarion County, PA",PA,2010,19508,17564,1944,10.0,0
"Clark County, AR",AR,2021,8805,8390,415,4.7,-458
"Clark County, AR",AR,2020,9263,8711,552,6.0,-440
"Clark County, AR",AR,2019,9703,9341,362,3.7,14
"Clark County, AR",AR,2018,9689,9337,352,3.6,115
"Clark County, AR",AR,2017,9574,9199,375,3.9,-15
"Clark County, AR",AR,2016,9589,9173,416,4.3,-74
"Clark County, AR",AR,2015,9663,9144,519,5.4,-86
"Clark County, AR",AR,2014,9749,9100,649,6.7,-406
"Clark County, AR",AR,2013,10155,9280,875,8.6,-186
"Clark County, AR",AR,2012,10341,9355,986,9.5,-70
"Clark County, AR",AR,2011,10411,9392,1019,9.8,45
"Clark County, AR",AR,2010,10366,9526,840,8.1,0
"Clark County, ID",ID,2021,377,365,12,3.2,-1
"Clark County, ID",ID,2020,378,363,15,4.0,-2
"Clark County, ID",ID,2019,380,365,15,3.9,-4
"Clark County, ID",ID,2018,384,372,12,3.1,-17
"Clark County, ID",ID,2017,401,389,12,3.0,8
"Clark County, ID",ID,2016,393,381,12,3.1,-3
"Clark County, ID",ID,2015,396,382,14,3.5,-45
"Clark County, ID",ID,2014,441,422,19,4.3,13
"Clark County, ID",ID,2013,428,398,30,7.0,2
"Clark County, ID",ID,2012,426,393,33,7.7,-89
"Clark County, ID",ID,2011,515,470,45,8.7,-22
"Clark County, ID",ID,2010,537,488,49,9.1,0
"Clark County, IL",IL,2021,7233,6870,363,5.0,-52
"Clark County, IL",IL,2020,7285,6699,586,8.0,-371
"Clark County, IL",IL,2019,7656,7315,341,4.5,-176
"Clark County, IL",IL,2018,7832,7415,417,5.3,-71
"Clark County, IL",IL,2017,7903,7504,399,5.0,-294
"Clark County, IL",IL,2016,8197,7720,477,5.8,102
"Clark County, IL",IL,2015,8095,7591,504,6.2,132
"Clark County, IL",IL,2014,7963,7391,572,7.2,30
"Clark County, IL",IL,2013,7933,7198,735,9.3,-65
"Clark County, IL",IL,2012,7998,7226,772,9.7,-116
"Clark County, IL",IL,2011,8114,7271,843,10.4,-191
"Clark County, IL",IL,2010,8305,7328,977,11.8,0
"Clark County, IN",IN,2021,61556,59580,1976,3.2,-106
"Clark County, IN",IN,2020,61662,57175,4487,7.3,-858
"Clark County, IN",IN,2019,62520,60480,2040,3.3,573
"Clark County, IN",IN,2018,61947,59852,2095,3.4,1064
"Clark County, IN",IN,2017,60883,58780,2103,3.5,290
"Clark County, IN",IN,2016,60593,58105,2488,4.1,1816
"Clark County, IN",IN,2015,58777,56146,2631,4.5,1137
"Clark County, IN",IN,2014,57640,54537,3103,5.4,1311
"Clark County, IN",IN,2013,56329,52510,3819,6.8,872
"Clark County, IN",IN,2012,55457,51182,4275,7.7,-219
"Clark County, IN",IN,2011,55676,50825,4851,8.7,346
"Clark County, IN",IN,2010,55330,50206,5124,9.3,0
"Clark County, KS",KS,2021,1139,1118,21,1.8,4
"Clark County, KS",KS,2020,1135,1113,22,1.9,61
"Clark County, KS",KS,2019,1074,1049,25,2.3,6
"Clark County, KS",KS,2018,1068,1043,25,2.3,-23
"Clark County, KS",KS,2017,1091,1064,27,2.5,-30
"Clark County, KS",KS,2016,1121,1090,31,2.8,-41
"Clark County, KS",KS,2015,1162,1134,28,2.4,16
"Clark County, KS",KS,2014,1146,1116,30,2.6,-45
"Clark County, KS",KS,2013,1191,1154,37,3.1,-14
"Clark County, KS",KS,2012,1205,1163,42,3.5,-13
"Clark County, KS",KS,2011,1218,1172,46,3.8,-6
"Clark County, KS",KS,2010,1224,1170,54,4.4,0
"Clark County, KY",KY,2021,17054,16304,750,4.4,94
"Clark County, KY",KY,2020,16960,15887,1073,6.3,-317
"Clark County, KY",KY,2019,17277,16636,641,3.7,145
"Clark County, KY",KY,2018,17132,16445,687,4.0,-153
"Clark County, KY",KY,2017,17285,16500,785,4.5,262
"Clark County, KY",KY,2016,17023,16215,808,4.7,153
"Clark County, KY",KY,2015,16870,16002,868,5.1,-113
"Clark County, KY",KY,2014,16983,15948,1035,6.1,-289
"Clark County, KY",KY,2013,17272,15984,1288,7.5,-152
"Clark County, KY",KY,2012,17424,15997,1427,8.2,-155
"Clark County, KY",KY,2011,17579,15849,1730,9.8,-287
"Clark County, KY",KY,2010,17866,15927,1939,10.9,0
"Clark County, MO",MO,2021,3127,2982,145,4.6,-30
"Clark County, MO",MO,2020,3157,2968,189,6.0,-11
"Clark County, MO",MO,2019,3168,3061,107,3.4,-29
"Clark County, MO",MO,2018,3197,3076,121,3.8,-3
"Clark County, MO",MO,2017,3200,3022,178,5.6,-166
"Clark County, MO",MO,2016,3366,3119,247,7.3,-49
"Clark County, MO",MO,2015,3415,3166,249,7.3,-12
"Clark County, MO",MO,2014,3427,3188,239,7.0,76
"Clark County, MO",MO,2013,3351,3083,268,8.0,27
"Clark County, MO",MO,2012,3324,3047,277,8.3,-66
"Clark County, MO",MO,2011,3390,3044,346,10.2,-57
"Clark County, MO",MO,2010,3447,3022,425,12.3,0
"Clark County, NV",NV,2021,1100264,1009020,91244,8.3,-4124
"Clark County, NV",NV,2020,1104388,932852,171536,15.5,-27176
"Clark County, NV",NV,2019,1131564,1084237,47327,4.2,37576
"Clark County, NV",NV,2018,1093988,1043615,50373,4.6,33395
"Clark County, NV",NV,2017,1060593,1005370,55223,5.2,20301
"Clark County, NV",NV,2016,1040292,978799,61493,5.9,13002
"Clark County, NV",NV,2015,1027290,956238,71052,6.9,17237
"Clark County, NV",NV,2014,1010053,926938,83115,8.2,11958
"Clark County, NV",NV,2013,998095,898037,100058,10.0,6095
"Clark County, NV",NV,2012,992000,875964,116036,11.7,5698
"Clark County, NV",NV,2011,986302,852943,133359,13.5,1590
"Clark County, NV",NV,2010,984712,846856,137856,14.0,0
"Clark County, OH",OH,2021,62458,59135,3323,5.3,-142
"Clark County, OH",OH,2020,62600,57507,5093,8.1,-1221
"Clark County, OH",OH,2019,63821,61044,2777,4.4,427
"Clark County, OH",OH,2018,63394,60505,2889,4.6,-646
"Clark County, OH",OH,2017,64040,60940,3100,4.8,213
"Clark County, OH",OH,2016,63827,60463,3364,5.3,-466
"Clark County, OH",OH,2015,64293,61045,3248,5.1,-858
"Clark County, OH",OH,2014,65151,61379,3772,5.8,-756
"Clark County, OH",OH,2013,65907,60952,4955,7.5,10
"Clark County, OH",OH,2012,65897,60768,5129,7.8,-1472
"Clark County, OH",OH,2011,67369,60968,6401,9.5,-1020
"Clark County, OH",OH,2010,68389,60809,7580,11.1,0
"Clark County, SD",SD,2021,1925,1853,72,3.7,-217
"Clark County, SD",SD,2020,2142,2062,80,3.7,247
"Clark County, SD",SD,2019,1895,1830,65,3.4,-4
"Clark County, SD",SD,2018,1899,1829,70,3.7,17
"Clark County, SD",SD,2017,1882,1801,81,4.3,-48
"Clark County, SD",SD,2016,1930,1854,76,3.9,-48
"Clark County, SD",SD,2015,1978,1907,71,3.6,-24
"Clark County, SD",SD,2014,2002,1926,76,3.8,10
"Clark County, SD",SD,2013,1992,1915,77,3.9,50
"Clark County, SD",SD,2012,1942,1862,80,4.1,-24
"Clark County, SD",SD,2011,1966,1875,91,4.6,-20
"Clark County, SD",SD,2010,1986,1885,101,5.1,0
"Clark County, WA",WA,2021,246019,232586,13433,5.5,2191
"Clark County, WA",WA,2020,243828,223280,20548,8.4,-3466
"Clark County, WA",WA,2019,247294,235442,11852,4.8,12892
"Clark County, WA",WA,2018,234402,223243,11159,4.8,5555
"Clark County, WA",WA,2017,228847,217404,11443,5.0,7851
"Clark County, WA",WA,2016,220996,207736,13260,6.0,6669
"Clark County, WA",WA,2015,214327,200966,13361,6.2,5386
"Clark County, WA",WA,2014,208941,194712,14229,6.8,844
"Clark County, WA",WA,2013,208097,190863,17234,8.3,-330
"Clark County, WA",WA,2012,208427,190460,17967,8.6,-475
"Clark County, WA",WA,2011,208902,186966,21936,10.5,-2666
"Clark County, WA",WA,2010,211568,186782,24786,11.7,0
"Clark County, WI",WI,2021,17911,17339,572,3.2,281
"Clark County, WI",WI,2020,17630,16830,800,4.5,-171
"Clark County, WI",WI,2019,17801,17244,557,3.1,-284
"Clark County, WI",WI,2018,18085,17570,515,2.8,65
"Clark County, WI",WI,2017,18020,17477,543,3.0,539
"Clark County, WI",WI,2016,17481,16817,664,3.8,97
"Clark County, WI",WI,2015,17384,16641,743,4.3,437
"Clark County, WI",WI,2014,16947,16035,912,5.4,-175
"Clark County, WI",WI,2013,17122,15923,1199,7.0,45
"Clark County, WI",WI,2012,17077,15829,1248,7.3,-199
"Clark County, WI",WI,2011,17276,15861,1415,8.2,11
"Clark County, WI",WI,2010,17265,15514,1751,10.1,0
"Clarke County, AL",AL,2021,7726,7264,462,6.0,-173
"Clarke County, AL",AL,2020,7899,7116,783,9.9,184
"Clarke County, AL",AL,2019,7715,7251,464,6.0,-27
"Clarke County, AL",AL,2018,7742,7170,572,7.4,-90
"Clarke County, AL",AL,2017,7832,7153,679,8.7,-57
"Clarke County, AL",AL,2016,7889,7030,859,10.9,-87
"Clarke County, AL",AL,2015,7976,7036,940,11.8,-190
"Clarke County, AL",AL,2014,8166,7177,989,12.1,-120
"Clarke County, AL",AL,2013,8286,7130,1156,14.0,-111
"Clarke County, AL",AL,2012,8397,7107,1290,15.4,-430
"Clarke County, AL",AL,2011,8827,7185,1642,18.6,-261
"Clarke County, AL",AL,2010,9088,7316,1772,19.5,0
"Clarke County, GA",GA,2021,59167,56922,2245,3.8,1171
"Clarke County, GA",GA,2020,57996,54293,3703,6.4,-1795
"Clarke County, GA",GA,2019,59791,57559,2232,3.7,-1229
"Clarke County, GA",GA,2018,61020,58558,2462,4.0,-484
"Clarke County, GA",GA,2017,61504,58562,2942,4.8,2737
"Clarke County, GA",GA,2016,58767,55484,3283,5.6,2282
"Clarke County, GA",GA,2015,56485,52987,3498,6.2,349
"Clarke County, GA",GA,2014,56136,52226,3910,7.0,-1669
"Clarke County, GA",GA,2013,57805,53315,4490,7.8,-143
"Clarke County, GA",GA,2012,57948,52974,4974,8.6,879
"Clarke County, GA",GA,2011,57069,51801,5268,9.2,290
"Clarke County, GA",GA,2010,56779,51424,5355,9.4,0
"Clarke County, IA",IA,2021,4833,4624,209,4.3,29
"Clarke County, IA",IA,2020,4804,4552,252,5.2,-180
"Clarke County, IA",IA,2019,4984,4847,137,2.7,99
"Clarke County, IA",IA,2018,4885,4747,138,2.8,54
"Clarke County, IA",IA,2017,4831,4683,148,3.1,-24
"Clarke County, IA",IA,2016,4855,4693,162,3.3,87
"Clarke County, IA",IA,2015,4768,4575,193,4.0,90
"Clarke County, IA",IA,2014,4678,4469,209,4.5,87
"Clarke County, IA",IA,2013,4591,4338,253,5.5,-38
"Clarke County, IA",IA,2012,4629,4350,279,6.0,-78
"Clarke County, IA",IA,2011,4707,4371,336,7.1,-67
"Clarke County, IA",IA,2010,4774,4402,372,7.8,0
"Clarke County, MS",MS,2021,5669,5313,356,6.3,-32
"Clarke County, MS",MS,2020,5701,5230,471,8.3,-253
"Clarke County, MS",MS,2019,5954,5583,371,6.2,10
"Clarke County, MS",MS,2018,5944,5605,339,5.7,-202
"Clarke County, MS",MS,2017,6146,5766,380,6.2,97
"Clarke County, MS",MS,2016,6049,5631,418,6.9,-11
"Clarke County, MS",MS,2015,6060,5577,483,8.0,-191
"Clarke County, MS",MS,2014,6251,5682,569,9.1,-407
"Clarke County, MS",MS,2013,6658,5998,660,9.9,-140
"Clarke County, MS",MS,2012,6798,6081,717,10.5,31
"Clarke County, MS",MS,2011,6767,5987,780,11.5,152
"Clarke County, MS",MS,2010,6615,5806,809,12.2,0
"Clarke County, VA",VA,2021,7383,7155,228,3.1,-96
"Clarke County, VA",VA,2020,7479,7138,341,4.6,-283
"Clarke County, VA",VA,2019,7762,7573,189,2.4,186
"Clarke County, VA",VA,2018,7576,7359,217,2.9,55
"Clarke County, VA",VA,2017,7521,7266,255,3.4,75
"Clarke County, VA",VA,2016,7446,7184,262,3.5,-15
"Clarke County, VA",VA,2015,7461,7168,293,3.9,-111
"Clarke County, VA",VA,2014,7572,7246,326,4.3,-54
"Clarke County, VA",VA,2013,7626,7273,353,4.6,-102
"Clarke County, VA",VA,2012,7728,7331,397,5.1,-33
"Clarke County, VA",VA,2011,7761,7318,443,5.7,56
"Clarke County, VA",VA,2010,7705,7178,527,6.8,0
"Clatsop County, OR",OR,2021,19452,18284,1168,6.0,183
"Clatsop County, OR",OR,2020,19269,17441,1828,9.5,-33
"Clatsop County, OR",OR,2019,19302,18586,716,3.7,190
"Clatsop County, OR",OR,2018,19112,18354,758,4.0,16
"Clatsop County, OR",OR,2017,19096,18325,771,4.0,121
"Clatsop County, OR",OR,2016,18975,18097,878,4.6,612
"Clatsop County, OR",OR,2015,18363,17385,978,5.3,233
"Clatsop County, OR",OR,2014,18130,16956,1174,6.5,139
"Clatsop County, OR",OR,2013,17991,16608,1383,7.7,-656
"Clatsop County, OR",OR,2012,18647,17017,1630,8.7,-410
"Clatsop County, OR",OR,2011,19057,17242,1815,9.5,-92
"Clatsop County, OR",OR,2010,19149,17222,1927,10.1,0
"Clay County, AL",AL,2021,6095,5930,165,2.7,-45
"Clay County, AL",AL,2020,6140,5865,275,4.5,-21
"Clay County, AL",AL,2019,6161,5969,192,3.1,85
"Clay County, AL",AL,2018,6076,5845,231,3.8,213
"Clay County, AL",AL,2017,5863,5603,260,4.4,284
"Clay County, AL",AL,2016,5579,5247,332,6.0,44
"Clay County, AL",AL,2015,5535,5194,341,6.2,14
"Clay County, AL",AL,2014,5521,5128,393,7.1,131
"Clay County, AL",AL,2013,5390,4933,457,8.5,-29
"Clay County, AL",AL,2012,5419,4899,520,9.6,-174
"Clay County, AL",AL,2011,5593,4937,656,11.7,-251
"Clay County, AL",AL,2010,5844,5016,828,14.2,0
"Clay County, AR",AR,2021,5391,5178,213,4.0,-155
"Clay County, AR",AR,2020,5546,5209,337,6.1,-128
"Clay County, AR",AR,2019,5674,5403,271,4.8,-127
"Clay County, AR",AR,2018,5801,5551,250,4.3,-82
"Clay County, AR",AR,2017,5883,5614,269,4.6,-165
"Clay County, AR",AR,2016,6048,5706,342,5.7,-275
"Clay County, AR",AR,2015,6323,5911,412,6.5,-136
"Clay County, AR",AR,2014,6459,5964,495,7.7,-103
"Clay County, AR",AR,2013,6562,5938,624,9.5,-322
"Clay County, AR",AR,2012,6884,6156,728,10.6,-379
"Clay County, AR",AR,2011,7263,6420,843,11.6,-201
"Clay County, AR",AR,2010,7464,6673,791,10.6,0
"Clay County, FL",FL,2021,107819,104015,3804,3.5,3239
"Clay County, FL",FL,2020,104580,98510,6070,5.8,-2003
"Clay County, FL",FL,2019,106583,103260,3323,3.1,1581
"Clay County, FL",FL,2018,105002,101420,3582,3.4,1666
"Clay County, FL",FL,2017,103336,99254,4082,4.0,1991
"Clay County, FL",FL,2016,101345,96747,4598,4.5,2508
"Clay County, FL",FL,2015,98837,93804,5033,5.1,1194
"Clay County, FL",FL,2014,97643,91867,5776,5.9,985
"Clay County, FL",FL,2013,96658,90255,6403,6.6,972
"Clay County, FL",FL,2012,95686,88172,7514,7.9,91
"Clay County, FL",FL,2011,95595,86914,8681,9.1,526
"Clay County, FL",FL,2010,95069,85944,9125,9.6,0
"Clay County, GA",GA,2021,884,794,90,10.2,-17
"Clay County, GA",GA,2020,901,791,110,12.2,18
"Clay County, GA",GA,2019,883,820,63,7.1,31
"Clay County, GA",GA,2018,852,787,65,7.6,-24
"Clay County, GA",GA,2017,876,796,80,9.1,-8
"Clay County, GA",GA,2016,884,791,93,10.5,33
"Clay County, GA",GA,2015,851,749,102,12.0,-63
"Clay County, GA",GA,2014,914,810,104,11.4,-40
"Clay County, GA",GA,2013,954,846,108,11.3,-51
"Clay County, GA",GA,2012,1005,881,124,12.3,-58
"Clay County, GA",GA,2011,1063,934,129,12.1,-41
"Clay County, GA",GA,2010,1104,974,130,11.8,0
"Clay County, IA",IA,2021,8479,8170,309,3.6,41
"Clay County, IA",IA,2020,8438,8068,370,4.4,-229
"Clay County, IA",IA,2019,8667,8440,227,2.6,18
"Clay County, IA",IA,2018,8649,8372,277,3.2,4
"Clay County, IA",IA,2017,8645,8328,317,3.7,-119
"Clay County, IA",IA,2016,8764,8429,335,3.8,-86
"Clay County, IA",IA,2015,8850,8533,317,3.6,-92
"Clay County, IA",IA,2014,8942,8569,373,4.2,115
"Clay County, IA",IA,2013,8827,8429,398,4.5,-93
"Clay County, IA",IA,2012,8920,8468,452,5.1,-373
"Clay County, IA",IA,2011,9293,8778,515,5.5,-30
"Clay County, IA",IA,2010,9323,8767,556,6.0,0
"Clay County, IL",IL,2021,5900,5574,326,5.5,-294
"Clay County, IL",IL,2020,6194,5601,593,9.6,-284
"Clay County, IL",IL,2019,6478,6197,281,4.3,-217
"Clay County, IL",IL,2018,6695,6348,347,5.2,40
"Clay County, IL",IL,2017,6655,6301,354,5.3,-79
"Clay County, IL",IL,2016,6734,6274,460,6.8,104
"Clay County, IL",IL,2015,6630,6160,470,7.1,190
"Clay County, IL",IL,2014,6440,5921,519,8.1,127
"Clay County, IL",IL,2013,6313,5689,624,9.9,-310
"Clay County, IL",IL,2012,6623,5981,642,9.7,-66
"Clay County, IL",IL,2011,6689,5977,712,10.6,-124
"Clay County, IL",IL,2010,6813,6038,775,11.4,0
"Clay County, IN",IN,2021,11473,11063,410,3.6,-120
"Clay County, IN",IN,2020,11593,10826,767,6.6,-229
"Clay County, IN",IN,2019,11822,11394,428,3.6,-516
"Clay County, IN",IN,2018,12338,11862,476,3.9,54
"Clay County, IN",IN,2017,12284,11831,453,3.7,-115
"Clay County, IN",IN,2016,12399,11826,573,4.6,34
"Clay County, IN",IN,2015,12365,11715,650,5.3,-75
"Clay County, IN",IN,2014,12440,11604,836,6.7,-158
"Clay County, IN",IN,2013,12598,11495,1103,8.8,-217
"Clay County, IN",IN,2012,12815,11570,1245,9.7,-208
"Clay County, IN",IN,2011,13023,11696,1327,10.2,-159
"Clay County, IN",IN,2010,13182,11750,1432,10.9,0
"Clay County, KS",KS,2021,3795,3698,97,2.6,-13
"Clay County, KS",KS,2020,3808,3644,164,4.3,8
"Clay County, KS",KS,2019,3800,3681,119,3.1,-5
"Clay County, KS",KS,2018,3805,3686,119,3.1,-29
"Clay County, KS",KS,2017,3834,3692,142,3.7,-219
"Clay County, KS",KS,2016,4053,3888,165,4.1,-75
"Clay County, KS",KS,2015,4128,3951,177,4.3,-48
"Clay County, KS",KS,2014,4176,3993,183,4.4,-28
"Clay County, KS",KS,2013,4204,3992,212,5.0,-59
"Clay County, KS",KS,2012,4263,4043,220,5.2,-147
"Clay County, KS",KS,2011,4410,4165,245,5.6,-222
"Clay County, KS",KS,2010,4632,4378,254,5.5,0
"Clay County, KY",KY,2021,5187,4835,352,6.8,19
"Clay County, KY",KY,2020,5168,4742,426,8.2,-2
"Clay County, KY",KY,2019,5170,4827,343,6.6,-39
"Clay County, KY",KY,2018,5209,4853,356,6.8,-148
"Clay County, KY",KY,2017,5357,4894,463,8.6,-92
"Clay County, KY",KY,2016,5449,4904,545,10.0,167
"Clay County, KY",KY,2015,5282,4775,507,9.6,-273
"Clay County, KY",KY,2014,5555,4936,619,11.1,-193
"Clay County, KY",KY,2013,5748,4934,814,14.2,-213
"Clay County, KY",KY,2012,5961,5123,838,14.1,-105
"Clay County, KY",KY,2011,6066,5157,909,15.0,2
"Clay County, KY",KY,2010,6064,5175,889,14.7,0
"Clay County, MN",MN,2021,36092,35108,984,2.7,-524
"Clay County, MN",MN,2020,36616,34987,1629,4.4,110
"Clay County, MN",MN,2019,36506,35325,1181,3.2,690
"Clay County, MN",MN,2018,35816,34714,1102,3.1,-10
"Clay County, MN",MN,2017,35826,34662,1164,3.2,235
"Clay County, MN",MN,2016,35591,34368,1223,3.4,-32
"Clay County, MN",MN,2015,35623,34494,1129,3.2,317
"Clay County, MN",MN,2014,35306,34076,1230,3.5,444
"Clay County, MN",MN,2013,34862,33345,1517,4.4,-199
"Clay County, MN",MN,2012,35061,33358,1703,4.9,363
"Clay County, MN",MN,2011,34698,32764,1934,5.6,791
"Clay County, MN",MN,2010,33907,32025,1882,5.6,0
"Clay County, MO",MO,2021,138370,131555,6815,4.9,1983
"Clay County, MO",MO,2020,136387,128154,8233,6.0,-510
"Clay County, MO",MO,2019,136897,133199,3698,2.7,2223
"Clay County, MO",MO,2018,134674,130804,3870,2.9,159
"Clay County, MO",MO,2017,134515,129677,4838,3.6,660
"Clay County, MO",MO,2016,133855,128647,5208,3.9,2471
"Clay County, MO",MO,2015,131384,125297,6087,4.6,2449
"Clay County, MO",MO,2014,128935,121912,7023,5.4,2512
"Clay County, MO",MO,2013,126423,118669,7754,6.1,814
"Clay County, MO",MO,2012,125609,117708,7901,6.3,601
"Clay County, MO",MO,2011,125008,115592,9416,7.5,532
"Clay County, MO",MO,2010,124476,114132,10344,8.3,0
"Clay County, MS",MS,2021,8027,7453,574,7.2,210
"Clay County, MS",MS,2020,7817,6925,892,11.4,-32
"Clay County, MS",MS,2019,7849,7264,585,7.5,163
"Clay County, MS",MS,2018,7686,7207,479,6.2,-36
"Clay County, MS",MS,2017,7722,7184,538,7.0,-266
"Clay County, MS",MS,2016,7988,7326,662,8.3,-9
"Clay County, MS",MS,2015,7997,7221,776,9.7,35
"Clay County, MS",MS,2014,7962,6895,1067,13.4,-428
"Clay County, MS",MS,2013,8390,7101,1289,15.4,-278
"Clay County, MS",MS,2012,8668,7472,1196,13.8,-39
"Clay County, MS",MS,2011,8707,7437,1270,14.6,23
"Clay County, MS",MS,2010,8684,7295,1389,16.0,0
"Clay County, NC",NC,2021,3970,3775,195,4.9,-3
"Clay County, NC",NC,2020,3973,3687,286,7.2,-141
"Clay County, NC",NC,2019,4114,3931,183,4.4,48
"Clay County, NC",NC,2018,4066,3886,180,4.4,170
"Clay County, NC",NC,2017,3896,3702,194,5.0,-143
"Clay County, NC",NC,2016,4039,3818,221,5.5,1
"Clay County, NC",NC,2015,4038,3795,243,6.0,-65
"Clay County, NC",NC,2014,4103,3842,261,6.4,42
"Clay County, NC",NC,2013,4061,3715,346,8.5,-143
"Clay County, NC",NC,2012,4204,3758,446,10.6,36
"Clay County, NC",NC,2011,4168,3687,481,11.5,-89
"Clay County, NC",NC,2010,4257,3730,527,12.4,0
"Clay County, NE",NE,2021,3259,3185,74,2.3,-44
"Clay County, NE",NE,2020,3303,3197,106,3.2,-30
"Clay County, NE",NE,2019,3333,3227,106,3.2,51
"Clay County, NE",NE,2018,3282,3177,105,3.2,-26
"Clay County, NE",NE,2017,3308,3204,104,3.1,-32
"Clay County, NE",NE,2016,3340,3237,103,3.1,-47
"Clay County, NE",NE,2015,3387,3289,98,2.9,-76
"Clay County, NE",NE,2014,3463,3351,112,3.2,-29
"Clay County, NE",NE,2013,3492,3375,117,3.4,13
"Clay County, NE",NE,2012,3479,3353,126,3.6,-6
"Clay County, NE",NE,2011,3485,3340,145,4.2,57
"Clay County, NE",NE,2010,3428,3279,149,4.3,0
"Clay County, SD",SD,2021,7331,7114,217,3.0,218
"Clay County, SD",SD,2020,7113,6810,303,4.3,-273
"Clay County, SD",SD,2019,7386,7177,209,2.8,163
"Clay County, SD",SD,2018,7223,7032,191,2.6,110
"Clay County, SD",SD,2017,7113,6898,215,3.0,90
"Clay County, SD",SD,2016,7023,6810,213,3.0,-32
"Clay County, SD",SD,2015,7055,6842,213,3.0,-83
"Clay County, SD",SD,2014,7138,6898,240,3.4,6
"Clay County, SD",SD,2013,7132,6874,258,3.6,-375
"Clay County, SD",SD,2012,7507,7235,272,3.6,-61
"Clay County, SD",SD,2011,7568,7270,298,3.9,141
"Clay County, SD",SD,2010,7427,7117,310,4.2,0
"Clay County, TN",TN,2021,2757,2612,145,5.3,53
"Clay County, TN",TN,2020,2704,2495,209,7.7,-89
"Clay County, TN",TN,2019,2793,2626,167,6.0,-82
"Clay County, TN",TN,2018,2875,2734,141,4.9,-161
"Clay County, TN",TN,2017,3036,2880,156,5.1,-8
"Clay County, TN",TN,2016,3044,2844,200,6.6,40
"Clay County, TN",TN,2015,3004,2740,264,8.8,0
"Clay County, TN",TN,2014,3004,2730,274,9.1,-102
"Clay County, TN",TN,2013,3106,2773,333,10.7,-212
"Clay County, TN",TN,2012,3318,2980,338,10.2,-91
"Clay County, TN",TN,2011,3409,3042,367,10.8,92
"Clay County, TN",TN,2010,3317,2909,408,12.3,0
"Clay County, TX",TX,2021,4831,4593,238,4.9,59
"Clay County, TX",TX,2020,4772,4508,264,5.5,-81
"Clay County, TX",TX,2019,4853,4704,149,3.1,-24
"Clay County, TX",TX,2018,4877,4722,155,3.2,10
"Clay County, TX",TX,2017,4867,4694,173,3.6,70
"Clay County, TX",TX,2016,4797,4587,210,4.4,-117
"Clay County, TX",TX,2015,4914,4697,217,4.4,-98
"Clay County, TX",TX,2014,5012,4780,232,4.6,-119
"Clay County, TX",TX,2013,5131,4845,286,5.6,-176
"Clay County, TX",TX,2012,5307,5011,296,5.6,-204
"Clay County, TX",TX,2011,5511,5142,369,6.7,-35
"Clay County, TX",TX,2010,5546,5129,417,7.5,0
"Clay County, WV",WV,2021,3051,2815,236,7.7,-54
"Clay County, WV",WV,2020,3105,2723,382,12.3,-44
"Clay County, WV",WV,2019,3149,2879,270,8.6,0
"Clay County, WV",WV,2018,3149,2888,261,8.3,-21
"Clay County, WV",WV,2017,3170,2896,274,8.6,-99
"Clay County, WV",WV,2016,3269,2930,339,10.4,-38
"Clay County, WV",WV,2015,3307,2946,361,10.9,-40
"Clay County, WV",WV,2014,3347,2989,358,10.7,-135
"Clay County, WV",WV,2013,3482,3068,414,11.9,-43
"Clay County, WV",WV,2012,3525,3114,411,11.7,-41
"Clay County, WV",WV,2011,3566,3137,429,12.0,-77
"Clay County, WV",WV,2010,3643,3127,516,14.2,0
"Clayton County, GA",GA,2021,140309,131120,9189,6.5,1605
"Clayton County, GA",GA,2020,138704,124431,14273,10.3,421
"Clayton County, GA",GA,2019,138283,132129,6154,4.5,723
"Clayton County, GA",GA,2018,137560,130725,6835,5.0,1094
"Clayton County, GA",GA,2017,136466,128439,8027,5.9,5666
"Clayton County, GA",GA,2016,130800,122049,8751,6.7,5812
"Clayton County, GA",GA,2015,124988,115296,9692,7.8,464
"Clayton County, GA",GA,2014,124524,112890,11634,9.3,-322
"Clayton County, GA",GA,2013,124846,111468,13378,10.7,-2313
"Clayton County, GA",GA,2012,127159,112073,15086,11.9,449
"Clayton County, GA",GA,2011,126710,109832,16878,13.3,1128
"Clayton County, GA",GA,2010,125582,108377,17205,13.7,0
"Clayton County, IA",IA,2021,9632,9139,493,5.1,-107
"Clayton County, IA",IA,2020,9739,9197,542,5.6,-610
"Clayton County, IA",IA,2019,10349,9991,358,3.5,61
"Clayton County, IA",IA,2018,10288,9963,325,3.2,12
"Clayton County, IA",IA,2017,10276,9877,399,3.9,-78
"Clayton County, IA",IA,2016,10354,9918,436,4.2,64
"Clayton County, IA",IA,2015,10290,9868,422,4.1,102
"Clayton County, IA",IA,2014,10188,9682,506,5.0,100
"Clayton County, IA",IA,2013,10088,9519,569,5.6,-119
"Clayton County, IA",IA,2012,10207,9625,582,5.7,-179
"Clayton County, IA",IA,2011,10386,9735,651,6.3,-75
"Clayton County, IA",IA,2010,10461,9702,759,7.3,0
"Clear Creek County, CO",CO,2021,6023,5689,334,5.5,59
"Clear Creek County, CO",CO,2020,5964,5475,489,8.2,-45
"Clear Creek County, CO",CO,2019,6009,5870,139,2.3,91
"Clear Creek County, CO",CO,2018,5918,5752,166,2.8,99
"Clear Creek County, CO",CO,2017,5819,5679,140,2.4,133
"Clear Creek County, CO",CO,2016,5686,5513,173,3.0,141
"Clear Creek County, CO",CO,2015,5545,5349,196,3.5,30
"Clear Creek County, CO",CO,2014,5515,5260,255,4.6,75
"Clear Creek County, CO",CO,2013,5440,5104,336,6.2,-30
"Clear Creek County, CO",CO,2012,5470,5080,390,7.1,-15
"Clear Creek County, CO",CO,2011,5485,5066,419,7.6,-112
"Clear Creek County, CO",CO,2010,5597,5126,471,8.4,0
"Clearfield County, PA",PA,2021,35498,33007,2491,7.0,-595
"Clearfield County, PA",PA,2020,36093,32772,3321,9.2,-251
"Clearfield County, PA",PA,2019,36344,34409,1935,5.3,223
"Clearfield County, PA",PA,2018,36121,34250,1871,5.2,-79
"Clearfield County, PA",PA,2017,36200,34022,2178,6.0,-154
"Clearfield County, PA",PA,2016,36354,33733,2621,7.2,-81
"Clearfield County, PA",PA,2015,36435,33969,2466,6.8,-232
"Clearfield County, PA",PA,2014,36667,33991,2676,7.3,-972
"Clearfield County, PA",PA,2013,37639,34350,3289,8.7,-498
"Clearfield County, PA",PA,2012,38137,34645,3492,9.2,175
"Clearfield County, PA",PA,2011,37962,34462,3500,9.2,29
"Clearfield County, PA",PA,2010,37933,34087,3846,10.1,0
"Clearwater County, ID",ID,2021,3033,2837,196,6.5,-11
"Clearwater County, ID",ID,2020,3044,2787,257,8.4,120
"Clearwater County, ID",ID,2019,2924,2724,200,6.8,-10
"Clearwater County, ID",ID,2018,2934,2732,202,6.9,-92
"Clearwater County, ID",ID,2017,3026,2815,211,7.0,-19
"Clearwater County, ID",ID,2016,3045,2830,215,7.1,-33
"Clearwater County, ID",ID,2015,3078,2848,230,7.5,-27
"Clearwater County, ID",ID,2014,3105,2842,263,8.5,-130
"Clearwater County, ID",ID,2013,3235,2832,403,12.5,-52
"Clearwater County, ID",ID,2012,3287,2865,422,12.8,-57
"Clearwater County, ID",ID,2011,3344,2897,447,13.4,-76
"Clearwater County, ID",ID,2010,3420,2932,488,14.3,0
"Clearwater County, MN",MN,2021,4409,4153,256,5.8,-153
"Clearwater County, MN",MN,2020,4562,4101,461,10.1,31
"Clearwater County, MN",MN,2019,4531,4136,395,8.7,32
"Clearwater County, MN",MN,2018,4499,4111,388,8.6,-126
"Clearwater County, MN",MN,2017,4625,4215,410,8.9,-88
"Clearwater County, MN",MN,2016,4713,4260,453,9.6,69
"Clearwater County, MN",MN,2015,4644,4214,430,9.3,82
"Clearwater County, MN",MN,2014,4562,4075,487,10.7,81
"Clearwater County, MN",MN,2013,4481,3998,483,10.8,65
"Clearwater County, MN",MN,2012,4416,3947,469,10.6,-167
"Clearwater County, MN",MN,2011,4583,4037,546,11.9,-11
"Clearwater County, MN",MN,2010,4594,3990,604,13.1,0
"Cleburne County, AL",AL,2021,5890,5739,151,2.6,38
"Cleburne County, AL",AL,2020,5852,5556,296,5.1,-11
"Cleburne County, AL",AL,2019,5863,5669,194,3.3,6
"Cleburne County, AL",AL,2018,5857,5610,247,4.2,65
"Cleburne County, AL",AL,2017,5792,5525,267,4.6,54
"Cleburne County, AL",AL,2016,5738,5394,344,6.0,74
"Cleburne County, AL",AL,2015,5664,5321,343,6.1,-200
"Cleburne County, AL",AL,2014,5864,5479,385,6.6,39
"Cleburne County, AL",AL,2013,5825,5372,453,7.8,-17
"Cleburne County, AL",AL,2012,5842,5351,491,8.4,-97
"Cleburne County, AL",AL,2011,5939,5367,572,9.6,-96
"Cleburne County, AL",AL,2010,6035,5441,594,9.8,0
"Cleburne County, AR",AR,2021,8970,8559,411,4.6,-220
"Cleburne County, AR",AR,2020,9190,8489,701,7.6,-40
"Cleburne County, AR",AR,2019,9230,8823,407,4.4,112
"Cleburne County, AR",AR,2018,9118,8712,406,4.5,-168
"Cleburne County, AR",AR,2017,9286,8826,460,5.0,-214
"Cleburne County, AR",AR,2016,9500,8935,565,5.9,-155
"Cleburne County, AR",AR,2015,9655,8996,659,6.8,-166
"Cleburne County, AR",AR,2014,9821,9028,793,8.1,-272
"Cleburne County, AR",AR,2013,10093,9253,840,8.3,-363
"Cleburne County, AR",AR,2012,10456,9603,853,8.2,-75
"Cleburne County, AR",AR,2011,10531,9609,922,8.8,183
"Cleburne County, AR",AR,2010,10348,9491,857,8.3,0
"Clermont County, OH",OH,2021,106976,102346,4630,4.3,1208
"Clermont County, OH",OH,2020,105768,98483,7285,6.9,-2428
"Clermont County, OH",OH,2019,108196,104115,4081,3.8,1673
"Clermont County, OH",OH,2018,106523,102163,4360,4.1,655
"Clermont County, OH",OH,2017,105868,101228,4640,4.4,1555
"Clermont County, OH",OH,2016,104313,99654,4659,4.5,1306
"Clermont County, OH",OH,2015,103007,98315,4692,4.6,155
"Clermont County, OH",OH,2014,102852,97223,5629,5.5,417
"Clermont County, OH",OH,2013,102435,94913,7522,7.3,283
"Clermont County, OH",OH,2012,102152,94544,7608,7.4,-1212
"Clermont County, OH",OH,2011,103364,93892,9472,9.2,-1667
"Clermont County, OH",OH,2010,105031,94081,10950,10.4,0
"Cleveland County, AR",AR,2021,3108,2985,123,4.0,-144
"Cleveland County, AR",AR,2020,3252,3055,197,6.1,7
"Cleveland County, AR",AR,2019,3245,3121,124,3.8,-19
"Cleveland County, AR",AR,2018,3264,3141,123,3.8,-63
"Cleveland County, AR",AR,2017,3327,3182,145,4.4,-22
"Cleveland County, AR",AR,2016,3349,3198,151,4.5,-22
"Cleveland County, AR",AR,2015,3371,3184,187,5.5,-110
"Cleveland County, AR",AR,2014,3481,3249,232,6.7,-139
"Cleveland County, AR",AR,2013,3620,3353,267,7.4,-147
"Cleveland County, AR",AR,2012,3767,3500,267,7.1,-100
"Cleveland County, AR",AR,2011,3867,3551,316,8.2,-17
"Cleveland County, AR",AR,2010,3884,3570,314,8.1,0
"Cleveland County, NC",NC,2021,47667,45132,2535,5.3,565
"Cleveland County, NC",NC,2020,47102,43522,3580,7.6,-1139
"Cleveland County, NC",NC,2019,48241,46361,1880,3.9,1021
"Cleveland County, NC",NC,2018,47220,45326,1894,4.0,408
"Cleveland County, NC",NC,2017,46812,44647,2165,4.6,143
"Cleveland County, NC",NC,2016,46669,44114,2555,5.5,632
"Cleveland County, NC",NC,2015,46037,43129,2908,6.3,69
"Cleveland County, NC",NC,2014,45968,42710,3258,7.1,-624
"Cleveland County, NC",NC,2013,46592,42291,4301,9.2,427
"Cleveland County, NC",NC,2012,46165,40947,5218,11.3,47
"Cleveland County, NC",NC,2011,46118,40419,5699,12.4,339
"Cleveland County, NC",NC,2010,45779,39084,6695,14.6,0
"Cleveland County, OK",OK,2021,144386,139744,4642,3.2,2330
"Cleveland County, OK",OK,2020,142056,134026,8030,5.7,-854
"Cleveland County, OK",OK,2019,142910,139052,3858,2.7,1843
"Cleveland County, OK",OK,2018,141067,137134,3933,2.8,1781
"Cleveland County, OK",OK,2017,139286,134646,4640,3.3,250
"Cleveland County, OK",OK,2016,139036,133913,5123,3.7,953
"Cleveland County, OK",OK,2015,138083,133326,4757,3.4,2364
"Cleveland County, OK",OK,2014,135719,130898,4821,3.6,-1175
"Cleveland County, OK",OK,2013,136894,131213,5681,4.1,1157
"Cleveland County, OK",OK,2012,135737,130292,5445,4.0,2875
"Cleveland County, OK",OK,2011,132862,127115,5747,4.3,1836
"Cleveland County, OK",OK,2010,131026,124374,6652,5.1,0
"Clinch County, GA",GA,2021,3022,2933,89,2.9,61
"Clinch County, GA",GA,2020,2961,2846,115,3.9,138
"Clinch County, GA",GA,2019,2823,2715,108,3.8,54
"Clinch County, GA",GA,2018,2769,2642,127,4.6,-35
"Clinch County, GA",GA,2017,2804,2647,157,5.6,35
"Clinch County, GA",GA,2016,2769,2596,173,6.2,27
"Clinch County, GA",GA,2015,2742,2546,196,7.1,-81
"Clinch County, GA",GA,2014,2823,2585,238,8.4,-3
"Clinch County, GA",GA,2013,2826,2569,257,9.1,-80
"Clinch County, GA",GA,2012,2906,2628,278,9.6,24
"Clinch County, GA",GA,2011,2882,2569,313,10.9,-25
"Clinch County, GA",GA,2010,2907,2582,325,11.2,0
"Clinton County, IA",IA,2021,21967,20798,1169,5.3,-215
"Clinton County, IA",IA,2020,22182,20724,1458,6.6,-1088
"Clinton County, IA",IA,2019,23270,22448,822,3.5,279
"Clinton County, IA",IA,2018,22991,22256,735,3.2,-405
"Clinton County, IA",IA,2017,23396,22462,934,4.0,-540
"Clinton County, IA",IA,2016,23936,22765,1171,4.9,-492
"Clinton County, IA",IA,2015,24428,23219,1209,4.9,-355
"Clinton County, IA",IA,2014,24783,23484,1299,5.2,-174
"Clinton County, IA",IA,2013,24957,23520,1437,5.8,-244
"Clinton County, IA",IA,2012,25201,23642,1559,6.2,-776
"Clinton County, IA",IA,2011,25977,24224,1753,6.7,-420
"Clinton County, IA",IA,2010,26397,24505,1892,7.2,0
"Clinton County, IL",IL,2021,19742,19061,681,3.4,89
"Clinton County, IL",IL,2020,19653,18485,1168,5.9,-981
"Clinton County, IL",IL,2019,20634,20022,612,3.0,145
"Clinton County, IL",IL,2018,20489,19766,723,3.5,158
"Clinton County, IL",IL,2017,20331,19610,721,3.5,-206
"Clinton County, IL",IL,2016,20537,19621,916,4.5,423
"Clinton County, IL",IL,2015,20114,19206,908,4.5,164
"Clinton County, IL",IL,2014,19950,18859,1091,5.5,21
"Clinton County, IL",IL,2013,19929,18583,1346,6.8,-346
"Clinton County, IL",IL,2012,20275,18920,1355,6.7,-420
"Clinton County, IL",IL,2011,20695,19300,1395,6.7,192
"Clinton County, IL",IL,2010,20503,18999,1504,7.3,0
"Clinton County, IN",IN,2021,16723,16261,462,2.8,-15
"Clinton County, IN",IN,2020,16738,15785,953,5.7,-538
"Clinton County, IN",IN,2019,17276,16818,458,2.7,72
"Clinton County, IN",IN,2018,17204,16723,481,2.8,228
"Clinton County, IN",IN,2017,16976,16460,516,3.0,-194
"Clinton County, IN",IN,2016,17170,16512,658,3.8,253
"Clinton County, IN",IN,2015,16917,16241,676,4.0,254
"Clinton County, IN",IN,2014,16663,15812,851,5.1,214
"Clinton County, IN",IN,2013,16449,15304,1145,7.0,-135
"Clinton County, IN",IN,2012,16584,15273,1311,7.9,-204
"Clinton County, IN",IN,2011,16788,15370,1418,8.4,-117
"Clinton County, IN",IN,2010,16905,15234,1671,9.9,0
"Clinton County, KY",KY,2021,3960,3784,176,4.4,8
"Clinton County, KY",KY,2020,3952,3757,195,4.9,-35
"Clinton County, KY",KY,2019,3987,3780,207,5.2,122
"Clinton County, KY",KY,2018,3865,3660,205,5.3,4
"Clinton County, KY",KY,2017,3861,3613,248,6.4,112
"Clinton County, KY",KY,2016,3749,3470,279,7.4,-42
"Clinton County, KY",KY,2015,3791,3477,314,8.3,-214
"Clinton County, KY",KY,2014,4005,3645,360,9.0,-108
"Clinton County, KY",KY,2013,4113,3687,426,10.4,-141
"Clinton County, KY",KY,2012,4254,3788,466,11.0,-38
"Clinton County, KY",KY,2011,4292,3804,488,11.4,-4
"Clinton County, KY",KY,2010,4296,3819,477,11.1,0
"Clinton County, MI",MI,2021,38904,37179,1725,4.4,-1279
"Clinton County, MI",MI,2020,40183,37457,2726,6.8,-1135
"Clinton County, MI",MI,2019,41318,40055,1263,3.1,161
"Clinton County, MI",MI,2018,41157,39835,1322,3.2,178
"Clinton County, MI",MI,2017,40979,39511,1468,3.6,372
"Clinton County, MI",MI,2016,40607,39093,1514,3.7,680
"Clinton County, MI",MI,2015,39927,38344,1583,4.0,254
"Clinton County, MI",MI,2014,39673,37671,2002,5.0,502
"Clinton County, MI",MI,2013,39171,36827,2344,6.0,506
"Clinton County, MI",MI,2012,38665,36337,2328,6.0,-235
"Clinton County, MI",MI,2011,38900,36314,2586,6.6,-402
"Clinton County, MI",MI,2010,39302,36106,3196,8.1,0
"Clinton County, MO",MO,2021,10660,10096,564,5.3,163
"Clinton County, MO",MO,2020,10497,9880,617,5.9,-73
"Clinton County, MO",MO,2019,10570,10265,305,2.9,-79
"Clinton County, MO",MO,2018,10649,10311,338,3.2,-208
"Clinton County, MO",MO,2017,10857,10426,431,4.0,-142
"Clinton County, MO",MO,2016,10999,10536,463,4.2,74
"Clinton County, MO",MO,2015,10925,10384,541,5.0,278
"Clinton County, MO",MO,2014,10647,10019,628,5.9,-74
"Clinton County, MO",MO,2013,10721,10005,716,6.7,-59
"Clinton County, MO",MO,2012,10780,10000,780,7.2,-197
"Clinton County, MO",MO,2011,10977,9983,994,9.1,-43
"Clinton County, MO",MO,2010,11020,9967,1053,9.6,0
"Clinton County, NY",NY,2021,35269,33639,1630,4.6,-821
"Clinton County, NY",NY,2020,36090,33328,2762,7.7,-939
"Clinton County, NY",NY,2019,37029,35474,1555,4.2,-17
"Clinton County, NY",NY,2018,37046,35431,1615,4.4,236
"Clinton County, NY",NY,2017,36810,34880,1930,5.2,988
"Clinton County, NY",NY,2016,35822,33869,1953,5.5,-39
"Clinton County, NY",NY,2015,35861,33758,2103,5.9,-77
"Clinton County, NY",NY,2014,35938,33543,2395,6.7,-1207
"Clinton County, NY",NY,2013,37145,33977,3168,8.5,-807
"Clinton County, NY",NY,2012,37952,34331,3621,9.5,-516
"Clinton County, NY",NY,2011,38468,34756,3712,9.6,-1280
"Clinton County, NY",NY,2010,39748,35778,3970,10.0,0
"Clinton County, OH",OH,2021,17953,16971,982,5.5,277
"Clinton County, OH",OH,2020,17676,16197,1479,8.4,-161
"Clinton County, OH",OH,2019,17837,16990,847,4.7,199
"Clinton County, OH",OH,2018,17638,16714,924,5.2,114
"Clinton County, OH",OH,2017,17524,16566,958,5.5,286
"Clinton County, OH",OH,2016,17238,16228,1010,5.9,494
"Clinton County, OH",OH,2015,16744,15693,1051,6.3,-245
"Clinton County, OH",OH,2014,16989,15683,1306,7.7,-89
"Clinton County, OH",OH,2013,17078,15299,1779,10.4,-211
"Clinton County, OH",OH,2012,17289,15434,1855,10.7,-704
"Clinton County, OH",OH,2011,17993,15570,2423,13.5,-1287
"Clinton County, OH",OH,2010,19280,15992,3288,17.1,0
"Clinton County, PA",PA,2021,17226,16076,1150,6.7,-684
"Clinton County, PA",PA,2020,17910,16349,1561,8.7,-592
"Clinton County, PA",PA,2019,18502,17474,1028,5.6,-60
"Clinton County, PA",PA,2018,18562,17539,1023,5.5,36
"Clinton County, PA",PA,2017,18526,17372,1154,6.2,-53
"Clinton County, PA",PA,2016,18579,17278,1301,7.0,-199
"Clinton County, PA",PA,2015,18778,17460,1318,7.0,-174
"Clinton County, PA",PA,2014,18952,17553,1399,7.4,-260
"Clinton County, PA",PA,2013,19212,17528,1684,8.8,-203
"Clinton County, PA",PA,2012,19415,17736,1679,8.6,279
"Clinton County, PA",PA,2011,19136,17569,1567,8.2,454
"Clinton County, PA",PA,2010,18682,16980,1702,9.1,0
"Cloud County, KS",KS,2021,3902,3794,108,2.8,61
"Cloud County, KS",KS,2020,3841,3690,151,3.9,33
"Cloud County, KS",KS,2019,3808,3686,122,3.2,3
"Cloud County, KS",KS,2018,3805,3677,128,3.4,-102
"Cloud County, KS",KS,2017,3907,3740,167,4.3,-368
"Cloud County, KS",KS,2016,4275,4100,175,4.1,-48
"Cloud County, KS",KS,2015,4323,4159,164,3.8,-74
"Cloud County, KS",KS,2014,4397,4213,184,4.2,-65
"Cloud County, KS",KS,2013,4462,4268,194,4.3,-128
"Cloud County, KS",KS,2012,4590,4362,228,5.0,41
"Cloud County, KS",KS,2011,4549,4304,245,5.4,-106
"Cloud County, KS",KS,2010,4655,4396,259,5.6,0
"Coahoma County, MS",MS,2021,8022,7316,706,8.8,-240
"Coahoma County, MS",MS,2020,8262,7255,1007,12.2,-68
"Coahoma County, MS",MS,2019,8330,7691,639,7.7,-48
"Coahoma County, MS",MS,2018,8378,7774,604,7.2,-226
"Coahoma County, MS",MS,2017,8604,7947,657,7.6,-577
"Coahoma County, MS",MS,2016,9181,8368,813,8.9,-246
"Coahoma County, MS",MS,2015,9427,8466,961,10.2,-105
"Coahoma County, MS",MS,2014,9532,8399,1133,11.9,-283
"Coahoma County, MS",MS,2013,9815,8555,1260,12.8,-502
"Coahoma County, MS",MS,2012,10317,9043,1274,12.3,-384
"Coahoma County, MS",MS,2011,10701,9251,1450,13.6,212
"Coahoma County, MS",MS,2010,10489,9091,1398,13.3,0
"Coal County, OK",OK,2021,2292,2188,104,4.5,17
"Coal County, OK",OK,2020,2275,2117,158,6.9,-171
"Coal County, OK",OK,2019,2446,2355,91,3.7,162
"Coal County, OK",OK,2018,2284,2203,81,3.5,21
"Coal County, OK",OK,2017,2263,2148,115,5.1,-54
"Coal County, OK",OK,2016,2317,2153,164,7.1,1
"Coal County, OK",OK,2015,2316,2144,172,7.4,20
"Coal County, OK",OK,2014,2296,2147,149,6.5,47
"Coal County, OK",OK,2013,2249,2083,166,7.4,-106
"Coal County, OK",OK,2012,2355,2193,162,6.9,13
"Coal County, OK",OK,2011,2342,2154,188,8.0,53
"Coal County, OK",OK,2010,2289,2088,201,8.8,0
"Coamo Municipio, PR",PR,2021,10923,9935,988,9.0,
"Coamo Municipio, PR",PR,2020,N.A.,N.A.,N.A.,N.A.,
"Coamo Municipio, PR",PR,2019,9909,8686,1223,12.3,-4
"Coamo Municipio, PR",PR,2018,9913,8540,1373,13.9,-436
"Coamo Municipio, PR",PR,2017,10349,8669,1680,16.2,-519
"Coamo Municipio, PR",PR,2016,10868,8903,1965,18.1,-152
"Coamo Municipio, PR",PR,2015,11020,8939,2081,18.9,-2
"Coamo Municipio, PR",PR,2014,11022,8702,2320,21.0,-392
"Coamo Municipio, PR",PR,2013,11414,9106,2308,20.2,-402
"Coamo Municipio, PR",PR,2012,11816,9339,2477,21.0,-364
"Coamo Municipio, PR",PR,2011,12180,9471,2709,22.2,6
"Coamo Municipio, PR",PR,2010,12174,9506,2668,21.9,0
"Cobb County, GA",GA,2021,423126,409319,13807,3.3,11011
"Cobb County, GA",GA,2020,412115,387938,24177,5.9,-12280
"Cobb County, GA",GA,2019,424395,411105,13290,3.1,762
"Cobb County, GA",GA,2018,423633,408917,14716,3.5,-1386
"Cobb County, GA",GA,2017,425019,407484,17535,4.1,14936
"Cobb County, GA",GA,2016,410083,390988,19095,4.7,16401
"Cobb County, GA",GA,2015,393682,373383,20299,5.2,848
"Cobb County, GA",GA,2014,392834,369474,23360,5.9,4506
"Cobb County, GA",GA,2013,388328,362523,25805,6.6,943
"Cobb County, GA",GA,2012,387385,357927,29458,7.6,3410
"Cobb County, GA",GA,2011,383975,350357,33618,8.8,2730
"Cobb County, GA",GA,2010,381245,345298,35947,9.4,0
"Cochise County, AZ",AZ,2021,49027,46667,2360,4.8,-1063
"Cochise County, AZ",AZ,2020,50090,46659,3431,6.8,1305
"Cochise County, AZ",AZ,2019,48785,45963,2822,5.8,670
"Cochise County, AZ",AZ,2018,48115,45431,2684,5.6,-10
"Cochise County, AZ",AZ,2017,48125,45406,2719,5.6,-1674
"Cochise County, AZ",AZ,2016,49799,46647,3152,6.3,-787
"Cochise County, AZ",AZ,2015,50586,46891,3695,7.3,-687
"Cochise County, AZ",AZ,2014,51273,46954,4319,8.4,-627
"Cochise County, AZ",AZ,2013,51900,47097,4803,9.3,-2443
"Cochise County, AZ",AZ,2012,54343,49438,4905,9.0,-1847
"Cochise County, AZ",AZ,2011,56190,50870,5320,9.5,-956
"Cochise County, AZ",AZ,2010,57146,51843,5303,9.3,0
"Cochran County, TX",TX,2021,1072,1004,68,6.3,-33
"Cochran County, TX",TX,2020,1105,1026,79,7.1,-8
"Cochran County, TX",TX,2019,1113,1075,38,3.4,24
"Cochran County, TX",TX,2018,1089,1041,48,4.4,-36
"Cochran County, TX",TX,2017,1125,1073,52,4.6,-49
"Cochran County, TX",TX,2016,1174,1115,59,5.0,-144
"Cochran County, TX",TX,2015,1318,1250,68,5.2,-78
"Cochran County, TX",TX,2014,1396,1324,72,5.2,-4
"Cochran County, TX",TX,2013,1400,1306,94,6.7,-43
"Cochran County, TX",TX,2012,1443,1335,108,7.5,-54
"Cochran County, TX",TX,2011,1497,1366,131,8.8,-29
"Cochran County, TX",TX,2010,1526,1401,125,8.2,0
"Cocke County, TN",TN,2021,14771,13952,819,5.5,-93
"Cocke County, TN",TN,2020,14864,13333,1531,10.3,-207
"Cocke County, TN",TN,2019,15071,14383,688,4.6,144
"Cocke County, TN",TN,2018,14927,14229,698,4.7,309
"Cocke County, TN",TN,2017,14618,13850,768,5.3,158
"Cocke County, TN",TN,2016,14460,13543,917,6.3,27
"Cocke County, TN",TN,2015,14433,13321,1112,7.7,-136
"Cocke County, TN",TN,2014,14569,13248,1321,9.1,-460
"Cocke County, TN",TN,2013,15029,13397,1632,10.9,-429
"Cocke County, TN",TN,2012,15458,13657,1801,11.7,-293
"Cocke County, TN",TN,2011,15751,13645,2106,13.4,-153
"Cocke County, TN",TN,2010,15904,13702,2202,13.8,0
"Coconino County, AZ",AZ,2021,72223,67857,4366,6.0,207
"Coconino County, AZ",AZ,2020,72016,65193,6823,9.5,-2766
"Coconino County, AZ",AZ,2019,74782,70489,4293,5.7,752
"Coconino County, AZ",AZ,2018,74030,69968,4062,5.5,467
"Coconino County, AZ",AZ,2017,73563,69435,4128,5.6,-921
"Coconino County, AZ",AZ,2016,74484,69930,4554,6.1,815
"Coconino County, AZ",AZ,2015,73669,68861,4808,6.5,998
"Coconino County, AZ",AZ,2014,72671,67508,5163,7.1,973
"Coconino County, AZ",AZ,2013,71698,65825,5873,8.2,72
"Coconino County, AZ",AZ,2012,71626,65467,6159,8.6,-410
"Coconino County, AZ",AZ,2011,72036,65208,6828,9.5,-962
"Coconino County, AZ",AZ,2010,72998,65838,7160,9.8,0
"Codington County, SD",SD,2021,15673,15188,485,3.1,303
"Codington County, SD",SD,2020,15370,14665,705,4.6,-71
"Codington County, SD",SD,2019,15441,15024,417,2.7,151
"Codington County, SD",SD,2018,15290,14864,426,2.8,97
"Codington County, SD",SD,2017,15193,14724,469,3.1,-90
"Codington County, SD",SD,2016,15283,14808,475,3.1,-135
"Codington County, SD",SD,2015,15418,14951,467,3.0,-50
"Codington County, SD",SD,2014,15468,14969,499,3.2,-88
"Codington County, SD",SD,2013,15556,15010,546,3.5,-96
"Codington County, SD",SD,2012,15652,15076,576,3.7,143
"Codington County, SD",SD,2011,15509,14823,686,4.4,381
"Codington County, SD",SD,2010,15128,14356,772,5.1,0
"Coffee County, AL",AL,2021,21853,21243,610,2.8,-155
"Coffee County, AL",AL,2020,22008,20938,1070,4.9,-68
"Coffee County, AL",AL,2019,22076,21405,671,3.0,843
"Coffee County, AL",AL,2018,21233,20403,830,3.9,105
"Coffee County, AL",AL,2017,21128,20179,949,4.5,699
"Coffee County, AL",AL,2016,20429,19227,1202,5.9,207
"Coffee County, AL",AL,2015,20222,19010,1212,6.0,-42
"Coffee County, AL",AL,2014,20264,18926,1338,6.6,-231
"Coffee County, AL",AL,2013,20495,19065,1430,7.0,-130
"Coffee County, AL",AL,2012,20625,19135,1490,7.2,-120
"Coffee County, AL",AL,2011,20745,19068,1677,8.1,-354
"Coffee County, AL",AL,2010,21099,19313,1786,8.5,0
"Coffee County, GA",GA,2021,18845,18079,766,4.1,-96
"Coffee County, GA",GA,2020,18941,17845,1096,5.8,-310
"Coffee County, GA",GA,2019,19251,18477,774,4.0,374
"Coffee County, GA",GA,2018,18877,18017,860,4.6,244
"Coffee County, GA",GA,2017,18633,17675,958,5.1,541
"Coffee County, GA",GA,2016,18092,17024,1068,5.9,996
"Coffee County, GA",GA,2015,17096,15926,1170,6.8,-515
"Coffee County, GA",GA,2014,17611,16172,1439,8.2,125
"Coffee County, GA",GA,2013,17486,15761,1725,9.9,78
"Coffee County, GA",GA,2012,17408,15452,1956,11.2,-155
"Coffee County, GA",GA,2011,17563,15320,2243,12.8,303
"Coffee County, GA",GA,2010,17260,14502,2758,16.0,0
"Coffee County, TN",TN,2021,25220,24192,1028,4.1,-456
"Coffee County, TN",TN,2020,25676,23646,2030,7.9,-67
"Coffee County, TN",TN,2019,25743,24883,860,3.3,913
"Coffee County, TN",TN,2018,24830,23953,877,3.5,-144
"Coffee County, TN",TN,2017,24974,24059,915,3.7,504
"Coffee County, TN",TN,2016,24470,23310,1160,4.7,125
"Coffee County, TN",TN,2015,24345,23004,1341,5.5,-159
"Coffee County, TN",TN,2014,24504,22932,1572,6.4,-26
"Coffee County, TN",TN,2013,24530,22618,1912,7.8,-90
"Coffee County, TN",TN,2012,24620,22558,2062,8.4,-42
"Coffee County, TN",TN,2011,24662,22175,2487,10.1,372
"Coffee County, TN",TN,2010,24290,21624,2666,11.0,0
"Coffey County, KS",KS,2021,3960,3832,128,3.2,26
"Coffey County, KS",KS,2020,3934,3737,197,5.0,-86
"Coffey County, KS",KS,2019,4020,3842,178,4.4,-87
"Coffey County, KS",KS,2018,4107,3919,188,4.6,-29
"Coffey County, KS",KS,2017,4136,3920,216,5.2,-167
"Coffey County, KS",KS,2016,4303,4037,266,6.2,-450
"Coffey County, KS",KS,2015,4753,4482,271,5.7,-149
"Coffey County, KS",KS,2014,4902,4624,278,5.7,-52
"Coffey County, KS",KS,2013,4954,4661,293,5.9,416
"Coffey County, KS",KS,2012,4538,4220,318,7.0,-132
"Coffey County, KS",KS,2011,4670,4309,361,7.7,-176
"Coffey County, KS",KS,2010,4846,4483,363,7.5,0
"Coke County, TX",TX,2021,1365,1300,65,4.8,12
"Coke County, TX",TX,2020,1353,1279,74,5.5,-81
"Coke County, TX",TX,2019,1434,1387,47,3.3,-7
"Coke County, TX",TX,2018,1441,1391,50,3.5,51
"Coke County, TX",TX,2017,1390,1338,52,3.7,-32
"Coke County, TX",TX,2016,1422,1363,59,4.1,23
"Coke County, TX",TX,2015,1399,1342,57,4.1,-37
"Coke County, TX",TX,2014,1436,1373,63,4.4,-20
"Coke County, TX",TX,2013,1456,1382,74,5.1,-13
"Coke County, TX",TX,2012,1469,1395,74,5.0,-65
"Coke County, TX",TX,2011,1534,1444,90,5.9,-42
"Coke County, TX",TX,2010,1576,1480,96,6.1,0
"Colbert County, AL",AL,2021,23460,22524,936,4.0,-435
"Colbert County, AL",AL,2020,23895,22152,1743,7.3,-184
"Colbert County, AL",AL,2019,24079,23131,948,3.9,281
"Colbert County, AL",AL,2018,23798,22713,1085,4.6,273
"Colbert County, AL",AL,2017,23525,22273,1252,5.3,264
"Colbert County, AL",AL,2016,23261,21640,1621,7.0,-289
"Colbert County, AL",AL,2015,23550,21673,1877,8.0,-519
"Colbert County, AL",AL,2014,24069,22082,1987,8.3,190
"Colbert County, AL",AL,2013,23879,21891,1988,8.3,-178
"Colbert County, AL",AL,2012,24057,21895,2162,9.0,-328
"Colbert County, AL",AL,2011,24385,21915,2470,10.1,156
"Colbert County, AL",AL,2010,24229,21499,2730,11.3,0
"Cole County, MO",MO,2021,38648,37445,1203,3.1,-117
"Cole County, MO",MO,2020,38765,37065,1700,4.4,-246
"Cole County, MO",MO,2019,39011,38059,952,2.4,591
"Cole County, MO",MO,2018,38420,37480,940,2.4,-319
"Cole County, MO",MO,2017,38739,37607,1132,2.9,-641
"Cole County, MO",MO,2016,39380,37982,1398,3.6,247
"Cole County, MO",MO,2015,39133,37538,1595,4.1,-375
"Cole County, MO",MO,2014,39508,37516,1992,5.0,-118
"Cole County, MO",MO,2013,39626,37530,2096,5.3,29
"Cole County, MO",MO,2012,39597,37493,2104,5.3,-570
"Cole County, MO",MO,2011,40167,37594,2573,6.4,-353
"Cole County, MO",MO,2010,40520,37762,2758,6.8,0
"Coleman County, TX",TX,2021,2937,2761,176,6.0,93
"Coleman County, TX",TX,2020,2844,2635,209,7.3,18
"Coleman County, TX",TX,2019,2826,2711,115,4.1,-85
"Coleman County, TX",TX,2018,2911,2796,115,4.0,-134
"Coleman County, TX",TX,2017,3045,2908,137,4.5,-22
"Coleman County, TX",TX,2016,3067,2888,179,5.8,16
"Coleman County, TX",TX,2015,3051,2881,170,5.6,-66
"Coleman County, TX",TX,2014,3117,2925,192,6.2,-33
"Coleman County, TX",TX,2013,3150,2912,238,7.6,-158
"Coleman County, TX",TX,2012,3308,3061,247,7.5,-92
"Coleman County, TX",TX,2011,3400,3091,309,9.1,-88
"Coleman County, TX",TX,2010,3488,3171,317,9.1,0
"Coles County, IL",IL,2021,22756,21591,1165,5.1,-303
"Coles County, IL",IL,2020,23059,21314,1745,7.6,-824
"Coles County, IL",IL,2019,23883,22966,917,3.8,-374
"Coles County, IL",IL,2018,24257,23125,1132,4.7,-232
"Coles County, IL",IL,2017,24489,23344,1145,4.7,-139
"Coles County, IL",IL,2016,24628,23173,1455,5.9,497
"Coles County, IL",IL,2015,24131,22667,1464,6.1,-149
"Coles County, IL",IL,2014,24280,22621,1659,6.8,-118
"Coles County, IL",IL,2013,24398,22260,2138,8.8,-341
"Coles County, IL",IL,2012,24739,22555,2184,8.8,-48
"Coles County, IL",IL,2011,24787,22449,2338,9.4,-847
"Coles County, IL",IL,2010,25634,23089,2545,9.9,0
"Colfax County, NE",NE,2021,5728,5619,109,1.9,52
"Colfax County, NE",NE,2020,5676,5516,160,2.8,26
"Colfax County, NE",NE,2019,5650,5498,152,2.7,3
"Colfax County, NE",NE,2018,5647,5508,139,2.5,-4
"Colfax County, NE",NE,2017,5651,5513,138,2.4,69
"Colfax County, NE",NE,2016,5582,5424,158,2.8,10
"Colfax County, NE",NE,2015,5572,5427,145,2.6,-53
"Colfax County, NE",NE,2014,5625,5458,167,3.0,18
"Colfax County, NE",NE,2013,5607,5414,193,3.4,-46
"Colfax County, NE",NE,2012,5653,5458,195,3.4,-33
"Colfax County, NE",NE,2011,5686,5465,221,3.9,36
"Colfax County, NE",NE,2010,5650,5423,227,4.0,0
"Colfax County, NM",NM,2021,5645,5313,332,5.9,547
"Colfax County, NM",NM,2020,5098,4747,351,6.9,-461
"Colfax County, NM",NM,2019,5559,5297,262,4.7,8
"Colfax County, NM",NM,2018,5551,5282,269,4.8,-200
"Colfax County, NM",NM,2017,5751,5411,340,5.9,-123
"Colfax County, NM",NM,2016,5874,5517,357,6.1,-204
"Colfax County, NM",NM,2015,6078,5709,369,6.1,-107
"Colfax County, NM",NM,2014,6185,5801,384,6.2,-25
"Colfax County, NM",NM,2013,6210,5772,438,7.1,74
"Colfax County, NM",NM,2012,6136,5664,472,7.7,-145
"Colfax County, NM",NM,2011,6281,5790,491,7.8,-33
"Colfax County, NM",NM,2010,6314,5806,508,8.0,0
"Colleton County, SC",SC,2021,16178,15470,708,4.4,-55
"Colleton County, SC",SC,2020,16233,15272,961,5.9,-180
"Colleton County, SC",SC,2019,16413,15903,510,3.1,75
"Colleton County, SC",SC,2018,16338,15695,643,3.9,82
"Colleton County, SC",SC,2017,16256,15490,766,4.7,-447
"Colleton County, SC",SC,2016,16703,15788,915,5.5,-4
"Colleton County, SC",SC,2015,16707,15554,1153,6.9,69
"Colleton County, SC",SC,2014,16638,15401,1237,7.4,256
"Colleton County, SC",SC,2013,16382,14795,1587,9.7,-88
"Colleton County, SC",SC,2012,16470,14519,1951,11.8,-257
"Colleton County, SC",SC,2011,16727,14394,2333,13.9,-256
"Colleton County, SC",SC,2010,16983,14614,2369,13.9,0
"Collier County, FL",FL,2021,180891,174274,6617,3.7,4570
"Collier County, FL",FL,2020,176321,163139,13182,7.5,-2688
"Collier County, FL",FL,2019,179009,173276,5733,3.2,2657
"Collier County, FL",FL,2018,176352,170050,6302,3.6,4400
"Collier County, FL",FL,2017,171952,164712,7240,4.2,2194
"Collier County, FL",FL,2016,169758,161752,8006,4.7,5428
"Collier County, FL",FL,2015,164330,155607,8723,5.3,4531
"Collier County, FL",FL,2014,159799,149982,9817,6.1,4612
"Collier County, FL",FL,2013,155187,143731,11456,7.4,3417
"Collier County, FL",FL,2012,151770,138572,13198,8.7,3829
"Collier County, FL",FL,2011,147941,132970,14971,10.1,3885
"Collier County, FL",FL,2010,144056,127810,16246,11.3,0
"Collin County, TX",TX,2021,599164,573302,25862,4.3,23285
"Collin County, TX",TX,2020,575879,539871,36008,6.3,10815
"Collin County, TX",TX,2019,565064,547629,17435,3.1,18929
"Collin County, TX",TX,2018,546135,527817,18318,3.4,17983
"Collin County, TX",TX,2017,528152,509750,18402,3.5,14927
"Collin County, TX",TX,2016,513225,495061,18164,3.5,24415
"Collin County, TX",TX,2015,488810,470919,17891,3.7,15408
"Collin County, TX",TX,2014,473402,451569,21833,4.6,16485
"Collin County, TX",TX,2013,456917,431462,25455,5.6,11220
"Collin County, TX",TX,2012,445697,419576,26121,5.9,7341
"Collin County, TX",TX,2011,438356,407778,30578,7.0,12411
"Collin County, TX",TX,2010,425945,394975,30970,7.3,0
"Collingsworth County, TX",TX,2021,1090,1043,47,4.3,29
"Collingsworth County, TX",TX,2020,1061,1016,45,4.2,-72
"Collingsworth County, TX",TX,2019,1133,1098,35,3.1,-38
"Collingsworth County, TX",TX,2018,1171,1134,37,3.2,14
"Collingsworth County, TX",TX,2017,1157,1116,41,3.5,-59
"Collingsworth County, TX",TX,2016,1216,1174,42,3.5,-55
"Collingsworth County, TX",TX,2015,1271,1224,47,3.7,13
"Collingsworth County, TX",TX,2014,1258,1206,52,4.1,44
"Collingsworth County, TX",TX,2013,1214,1151,63,5.2,-30
"Collingsworth County, TX",TX,2012,1244,1183,61,4.9,-61
"Collingsworth County, TX",TX,2011,1305,1227,78,6.0,-37
"Collingsworth County, TX",TX,2010,1342,1267,75,5.6,0
"Colonial Heights city, VA",VA,2021,8169,7778,391,4.8,-213
"Colonial Heights city, VA",VA,2020,8382,7783,599,7.1,-289
"Colonial Heights city, VA",VA,2019,8671,8393,278,3.2,-153
"Colonial Heights city, VA",VA,2018,8824,8533,291,3.3,-7
"Colonial Heights city, VA",VA,2017,8831,8477,354,4.0,108
"Colonial Heights city, VA",VA,2016,8723,8338,385,4.4,23
"Colonial Heights city, VA",VA,2015,8700,8295,405,4.7,-32
"Colonial Heights city, VA",VA,2014,8732,8236,496,5.7,70
"Colonial Heights city, VA",VA,2013,8662,8112,550,6.3,60
"Colonial Heights city, VA",VA,2012,8602,8016,586,6.8,55
"Colonial Heights city, VA",VA,2011,8547,7904,643,7.5,-1
"Colonial Heights city, VA",VA,2010,8548,7824,724,8.5,0
"Colorado County, TX",TX,2021,9907,9436,471,4.8,303
"Colorado County, TX",TX,2020,9604,9070,534,5.6,-125
"Colorado County, TX",TX,2019,9729,9427,302,3.1,146
"Colorado County, TX",TX,2018,9583,9264,319,3.3,-91
"Colorado County, TX",TX,2017,9674,9285,389,4.0,-124
"Colorado County, TX",TX,2016,9798,9336,462,4.7,-113
"Colorado County, TX",TX,2015,9911,9517,394,4.0,-351
"Colorado County, TX",TX,2014,10262,9799,463,4.5,180
"Colorado County, TX",TX,2013,10082,9496,586,5.8,-78
"Colorado County, TX",TX,2012,10160,9517,643,6.3,53
"Colorado County, TX",TX,2011,10107,9297,810,8.0,497
"Colorado County, TX",TX,2010,9610,8824,786,8.2,0
"Colquitt County, GA",GA,2021,22227,21514,713,3.2,364
"Colquitt County, GA",GA,2020,21863,20888,975,4.5,70
"Colquitt County, GA",GA,2019,21793,21082,711,3.3,199
"Colquitt County, GA",GA,2018,21594,20773,821,3.8,-694
"Colquitt County, GA",GA,2017,22288,21276,1012,4.5,1185
"Colquitt County, GA",GA,2016,21103,19979,1124,5.3,1280
"Colquitt County, GA",GA,2015,19823,18535,1288,6.5,-229
"Colquitt County, GA",GA,2014,20052,18425,1627,8.1,-247
"Colquitt County, GA",GA,2013,20299,18532,1767,8.7,-634
"Colquitt County, GA",GA,2012,20933,19123,1810,8.6,-256
"Colquitt County, GA",GA,2011,21189,19197,1992,9.4,-180
"Colquitt County, GA",GA,2010,21369,19271,2098,9.8,0
"Columbia County, AR",AR,2021,8814,8345,469,5.3,-244
"Columbia County, AR",AR,2020,9058,8437,621,6.9,-148
"Columbia County, AR",AR,2019,9206,8806,400,4.3,192
"Columbia County, AR",AR,2018,9014,8594,420,4.7,-63
"Columbia County, AR",AR,2017,9077,8616,461,5.1,-236
"Columbia County, AR",AR,2016,9313,8781,532,5.7,-286
"Columbia County, AR",AR,2015,9599,8982,617,6.4,-31
"Columbia County, AR",AR,2014,9630,8957,673,7.0,-125
"Columbia County, AR",AR,2013,9755,8920,835,8.6,-407
"Columbia County, AR",AR,2012,10162,9282,880,8.7,-224
"Columbia County, AR",AR,2011,10386,9390,996,9.6,-130
"Columbia County, AR",AR,2010,10516,9504,1012,9.6,0
"Columbia County, FL",FL,2021,29220,27896,1324,4.5,-215
"Columbia County, FL",FL,2020,29435,27537,1898,6.4,-133
"Columbia County, FL",FL,2019,29568,28578,990,3.3,373
"Columbia County, FL",FL,2018,29195,28056,1139,3.9,97
"Columbia County, FL",FL,2017,29098,27806,1292,4.4,-758
"Columbia County, FL",FL,2016,29856,28387,1469,4.9,767
"Columbia County, FL",FL,2015,29089,27474,1615,5.6,768
"Columbia County, FL",FL,2014,28321,26384,1937,6.8,516
"Columbia County, FL",FL,2013,27805,25607,2198,7.9,-59
"Columbia County, FL",FL,2012,27864,25329,2535,9.1,-216
"Columbia County, FL",FL,2011,28080,25194,2886,10.3,-467
"Columbia County, FL",FL,2010,28547,25546,3001,10.5,0
"Columbia County, GA",GA,2021,76478,74420,2058,2.7,1171
"Columbia County, GA",GA,2020,75307,72176,3131,4.2,-912
"Columbia County, GA",GA,2019,76219,73803,2416,3.2,323
"Columbia County, GA",GA,2018,75896,73226,2670,3.5,929
"Columbia County, GA",GA,2017,74967,71853,3114,4.2,3931
"Columbia County, GA",GA,2016,71036,67691,3345,4.7,3185
"Columbia County, GA",GA,2015,67851,64390,3461,5.1,1525
"Columbia County, GA",GA,2014,66326,62459,3867,5.8,838
"Columbia County, GA",GA,2013,65488,61274,4214,6.4,985
"Columbia County, GA",GA,2012,64503,60067,4436,6.9,1291
"Columbia County, GA",GA,2011,63212,58606,4606,7.3,1550
"Columbia County, GA",GA,2010,61662,57098,4564,7.4,0
"Columbia County, NY",NY,2021,30238,29085,1153,3.8,-631
"Columbia County, NY",NY,2020,30869,29034,1835,5.9,-996
"Columbia County, NY",NY,2019,31865,30883,982,3.1,-63
"Columbia County, NY",NY,2018,31928,30872,1056,3.3,243
"Columbia County, NY",NY,2017,31685,30493,1192,3.8,212
"Columbia County, NY",NY,2016,31473,30294,1179,3.7,121
"Columbia County, NY",NY,2015,31352,30094,1258,4.0,71
"Columbia County, NY",NY,2014,31281,29794,1487,4.8,-520
"Columbia County, NY",NY,2013,31801,29841,1960,6.2,168
"Columbia County, NY",NY,2012,31633,29371,2262,7.2,135
"Columbia County, NY",NY,2011,31498,29238,2260,7.2,-664
"Columbia County, NY",NY,2010,32162,29763,2399,7.5,0
"Columbia County, OR",OR,2021,24640,23222,1418,5.8,510
"Columbia County, OR",OR,2020,24130,22221,1909,7.9,-62
"Columbia County, OR",OR,2019,24192,23118,1074,4.4,68
"Columbia County, OR",OR,2018,24124,22943,1181,4.9,30
"Columbia County, OR",OR,2017,24094,22876,1218,5.1,537
"Columbia County, OR",OR,2016,23557,22143,1414,6.0,869
"Columbia County, OR",OR,2015,22688,21104,1584,7.0,178
"Columbia County, OR",OR,2014,22510,20649,1861,8.3,54
"Columbia County, OR",OR,2013,22456,20320,2136,9.5,-597
"Columbia County, OR",OR,2012,23053,20584,2469,10.7,-547
"Columbia County, OR",OR,2011,23600,20905,2695,11.4,-144
"Columbia County, OR",OR,2010,23744,20657,3087,13.0,0
"Columbia County, PA",PA,2021,33275,31328,1947,5.9,-509
"Columbia County, PA",PA,2020,33784,31042,2742,8.1,-56
"Columbia County, PA",PA,2019,33840,32189,1651,4.9,-13
"Columbia County, PA",PA,2018,33853,32187,1666,4.9,-175
"Columbia County, PA",PA,2017,34028,32235,1793,5.3,78
"Columbia County, PA",PA,2016,33950,32091,1859,5.5,199
"Columbia County, PA",PA,2015,33751,31808,1943,5.8,-446
"Columbia County, PA",PA,2014,34197,32047,2150,6.3,-1012
"Columbia County, PA",PA,2013,35209,32588,2621,7.4,-224
"Columbia County, PA",PA,2012,35433,32540,2893,8.2,724
"Columbia County, PA",PA,2011,34709,31768,2941,8.5,89
"Columbia County, PA",PA,2010,34620,31483,3137,9.1,0
"Columbia County, WA",WA,2021,1813,1718,95,5.2,27
"Columbia County, WA",WA,2020,1786,1661,125,7.0,-52
"Columbia County, WA",WA,2019,1838,1737,101,5.5,36
"Columbia County, WA",WA,2018,1802,1703,99,5.5,20
"Columbia County, WA",WA,2017,1782,1684,98,5.5,62
"Columbia County, WA",WA,2016,1720,1610,110,6.4,27
"Columbia County, WA",WA,2015,1693,1586,107,6.3,-45
"Columbia County, WA",WA,2014,1738,1617,121,7.0,-27
"Columbia County, WA",WA,2013,1765,1627,138,7.8,-48
"Columbia County, WA",WA,2012,1813,1676,137,7.6,-23
"Columbia County, WA",WA,2011,1836,1682,154,8.4,-83
"Columbia County, WA",WA,2010,1919,1756,163,8.5,0
"Columbia County, WI",WI,2021,31978,30897,1081,3.4,446
"Columbia County, WI",WI,2020,31532,29655,1877,6.0,-287
"Columbia County, WI",WI,2019,31819,30890,929,2.9,247
"Columbia County, WI",WI,2018,31572,30724,848,2.7,-244
"Columbia County, WI",WI,2017,31816,30883,933,2.9,326
"Columbia County, WI",WI,2016,31490,30384,1106,3.5,225
"Columbia County, WI",WI,2015,31265,29930,1335,4.3,108
"Columbia County, WI",WI,2014,31157,29537,1620,5.2,-64
"Columbia County, WI",WI,2013,31221,29195,2026,6.5,-68
"Columbia County, WI",WI,2012,31289,29056,2233,7.1,-421
"Columbia County, WI",WI,2011,31710,29271,2439,7.7,-379
"Columbia County, WI",WI,2010,32089,29428,2661,8.3,0
"Columbiana County, OH",OH,2021,45832,43202,2630,5.7,-1202
"Columbiana County, OH",OH,2020,47034,42612,4422,9.4,-759
"Columbiana County, OH",OH,2019,47793,45468,2325,4.9,322
"Columbiana County, OH",OH,2018,47471,45032,2439,5.1,-479
"Columbiana County, OH",OH,2017,47950,45100,2850,5.9,-627
"Columbiana County, OH",OH,2016,48577,45310,3267,6.7,-978
"Columbiana County, OH",OH,2015,49555,46616,2939,5.9,-679
"Columbiana County, OH",OH,2014,50234,46989,3245,6.5,-296
"Columbiana County, OH",OH,2013,50530,46381,4149,8.2,-385
"Columbiana County, OH",OH,2012,50915,46723,4192,8.2,-791
"Columbiana County, OH",OH,2011,51706,46470,5236,10.1,-1251
"Columbiana County, OH",OH,2010,52957,46274,6683,12.6,0
"Columbus County, NC",NC,2021,22400,20994,1406,6.3,471
"Columbus County, NC",NC,2020,21929,20209,1720,7.8,-654
"Columbus County, NC",NC,2019,22583,21485,1098,4.9,528
"Columbus County, NC",NC,2018,22055,20940,1115,5.1,82
"Columbus County, NC",NC,2017,21973,20772,1201,5.5,-555
"Columbus County, NC",NC,2016,22528,21081,1447,6.4,-53
"Columbus County, NC",NC,2015,22581,20901,1680,7.4,-428
"Columbus County, NC",NC,2014,23009,21106,1903,8.3,-1100
"Columbus County, NC",NC,2013,24109,21695,2414,10.0,709
"Columbus County, NC",NC,2012,23400,20464,2936,12.5,-667
"Columbus County, NC",NC,2011,24067,20847,3220,13.4,-198
"Columbus County, NC",NC,2010,24265,21046,3219,13.3,0
"Colusa County, CA",CA,2021,10740,9398,1342,12.5,133
"Colusa County, CA",CA,2020,10607,8853,1754,16.5,-386
"Colusa County, CA",CA,2019,10993,9566,1427,13.0,142
"Colusa County, CA",CA,2018,10851,9409,1442,13.3,35
"Colusa County, CA",CA,2017,10816,9267,1549,14.3,-92
"Colusa County, CA",CA,2016,10908,9205,1703,15.6,-143
"Colusa County, CA",CA,2015,11051,9342,1709,15.5,-27
"Colusa County, CA",CA,2014,11078,9131,1947,17.6,-190
"Colusa County, CA",CA,2013,11268,9113,2155,19.1,-2
"Colusa County, CA",CA,2012,11270,8900,2370,21.0,-110
"Colusa County, CA",CA,2011,11380,8924,2456,21.6,-180
"Colusa County, CA",CA,2010,11560,9095,2465,21.3,0
"Comal County, TX",TX,2021,79105,75529,3576,4.5,2295
"Comal County, TX",TX,2020,76810,72136,4674,6.1,1686
"Comal County, TX",TX,2019,75124,72890,2234,3.0,3447
"Comal County, TX",TX,2018,71677,69372,2305,3.2,3399
"Comal County, TX",TX,2017,68278,65963,2315,3.4,2758
"Comal County, TX",TX,2016,65520,63146,2374,3.6,3606
"Comal County, TX",TX,2015,61914,59623,2291,3.7,2155
"Comal County, TX",TX,2014,59759,57012,2747,4.6,1952
"Comal County, TX",TX,2013,57807,54335,3472,6.0,2023
"Comal County, TX",TX,2012,55784,52429,3355,6.0,1184
"Comal County, TX",TX,2011,54600,50722,3878,7.1,1041
"Comal County, TX",TX,2010,53559,49771,3788,7.1,0
"Comanche County, KS",KS,2021,891,872,19,2.1,26
"Comanche County, KS",KS,2020,865,837,28,3.2,-7
"Comanche County, KS",KS,2019,872,850,22,2.5,-17
"Comanche County, KS",KS,2018,889,868,21,2.4,-22
"Comanche County, KS",KS,2017,911,885,26,2.9,-64
"Comanche County, KS",KS,2016,975,945,30,3.1,-19
"Comanche County, KS",KS,2015,994,961,33,3.3,14
"Comanche County, KS",KS,2014,980,950,30,3.1,-56
"Comanche County, KS",KS,2013,1036,1000,36,3.5,33
"Comanche County, KS",KS,2012,1003,964,39,3.9,18
"Comanche County, KS",KS,2011,985,943,42,4.3,-9
"Comanche County, KS",KS,2010,994,950,44,4.4,0
"Comanche County, OK",OK,2021,47741,45802,1939,4.1,-79
"Comanche County, OK",OK,2020,47820,44578,3242,6.8,-151
"Comanche County, OK",OK,2019,47971,46303,1668,3.5,-181
"Comanche County, OK",OK,2018,48152,46342,1810,3.8,-585
"Comanche County, OK",OK,2017,48737,46703,2034,4.2,-654
"Comanche County, OK",OK,2016,49391,47196,2195,4.4,-216
"Comanche County, OK",OK,2015,49607,47502,2105,4.2,327
"Comanche County, OK",OK,2014,49280,47057,2223,4.5,-762
"Comanche County, OK",OK,2013,50042,47238,2804,5.6,-558
"Comanche County, OK",OK,2012,50600,47687,2913,5.8,59
"Comanche County, OK",OK,2011,50541,47782,2759,5.5,-905
"Comanche County, OK",OK,2010,51446,48604,2842,5.5,0
"Comanche County, TX",TX,2021,6032,5756,276,4.6,448
"Comanche County, TX",TX,2020,5584,5277,307,5.5,68
"Comanche County, TX",TX,2019,5516,5337,179,3.2,195
"Comanche County, TX",TX,2018,5321,5129,192,3.6,55
"Comanche County, TX",TX,2017,5266,5070,196,3.7,-94
"Comanche County, TX",TX,2016,5360,5129,231,4.3,-1
"Comanche County, TX",TX,2015,5361,5132,229,4.3,-167
"Comanche County, TX",TX,2014,5528,5258,270,4.9,-115
"Comanche County, TX",TX,2013,5643,5310,333,5.9,-132
"Comanche County, TX",TX,2012,5775,5410,365,6.3,-168
"Comanche County, TX",TX,2011,5943,5487,456,7.7,-90
"Comanche County, TX",TX,2010,6033,5575,458,7.6,0
"Comerio Municipio, PR",PR,2021,5242,4765,477,9.1,
"Comerio Municipio, PR",PR,2020,N.A.,N.A.,N.A.,N.A.,
"Comerio Municipio, PR",PR,2019,4899,4462,437,8.9,30
"Comerio Municipio, PR",PR,2018,4869,4368,501,10.3,-79
"Comerio Municipio, PR",PR,2017,4948,4366,582,11.8,-124
"Comerio Municipio, PR",PR,2016,5072,4389,683,13.5,-83
"Comerio Municipio, PR",PR,2015,5155,4370,785,15.2,-157
"Comerio Municipio, PR",PR,2014,5312,4315,997,18.8,-180
"Comerio Municipio, PR",PR,2013,5492,4395,1097,20.0,-76
"Comerio Municipio, PR",PR,2012,5568,4434,1134,20.4,-43
"Comerio Municipio, PR",PR,2011,5611,4421,1190,21.2,-252
"Comerio Municipio, PR",PR,2010,5863,4560,1303,22.2,0
"Concho County, TX",TX,2021,1350,1293,57,4.2,29
"Concho County, TX",TX,2020,1321,1262,59,4.5,82
"Concho County, TX",TX,2019,1239,1200,39,3.1,152
"Concho County, TX",TX,2018,1087,1047,40,3.7,-117
"Concho County, TX",TX,2017,1204,1153,51,4.2,-128
"Concho County, TX",TX,2016,1332,1287,45,3.4,-42
"Concho County, TX",TX,2015,1374,1329,45,3.3,-38
"Concho County, TX",TX,2014,1412,1369,43,3.0,-40
"Concho County, TX",TX,2013,1452,1394,58,4.0,-56
"Concho County, TX",TX,2012,1508,1445,63,4.2,-65
"Concho County, TX",TX,2011,1573,1498,75,4.8,5
"Concho County, TX",TX,2010,1568,1477,91,5.8,0
"Concordia Parish, LA",LA,2021,6906,6500,406,5.9,12
"Concordia Parish, LA",LA,2020,6894,6289,605,8.8,-117
"Concordia Parish, LA",LA,2019,7011,6575,436,6.2,-13
"Concordia Parish, LA",LA,2018,7024,6541,483,6.9,-141
"Concordia Parish, LA",LA,2017,7165,6603,562,7.8,-95
"Concordia Parish, LA",LA,2016,7260,6659,601,8.3,-251
"Concordia Parish, LA",LA,2015,7511,6863,648,8.6,-205
"Concordia Parish, LA",LA,2014,7716,7064,652,8.4,-86
"Concordia Parish, LA",LA,2013,7802,7166,636,8.2,-54
"Concordia Parish, LA",LA,2012,7856,7194,662,8.4,24
"Concordia Parish, LA",LA,2011,7832,7118,714,9.1,-28
"Concordia Parish, LA",LA,2010,7860,7122,738,9.4,0
"Conecuh County, AL",AL,2021,4376,4164,212,4.8,-206
"Conecuh County, AL",AL,2020,4582,4214,368,8.0,12
"Conecuh County, AL",AL,2019,4570,4380,190,4.2,10
"Conecuh County, AL",AL,2018,4560,4325,235,5.2,19
"Conecuh County, AL",AL,2017,4541,4257,284,6.3,29
"Conecuh County, AL",AL,2016,4512,4131,381,8.4,-159
"Conecuh County, AL",AL,2015,4671,4238,433,9.3,-53
"Conecuh County, AL",AL,2014,4724,4239,485,10.3,30
"Conecuh County, AL",AL,2013,4694,4183,511,10.9,51
"Conecuh County, AL",AL,2012,4643,4077,566,12.2,-135
"Conecuh County, AL",AL,2011,4778,4059,719,15.0,-204
"Conecuh County, AL",AL,2010,4982,4140,842,16.9,0
"Conejos County, CO",CO,2021,4102,3906,196,4.8,96
"Conejos County, CO",CO,2020,4006,3790,216,5.4,-120
"Conejos County, CO",CO,2019,4126,3985,141,3.4,71
"Conejos County, CO",CO,2018,4055,3896,159,3.9,168
"Conejos County, CO",CO,2017,3887,3737,150,3.9,118
"Conejos County, CO",CO,2016,3769,3594,175,4.6,173
"Conejos County, CO",CO,2015,3596,3398,198,5.5,-11
"Conejos County, CO",CO,2014,3607,3327,280,7.8,1
"Conejos County, CO",CO,2013,3606,3228,378,10.5,-97
"Conejos County, CO",CO,2012,3703,3304,399,10.8,-20
"Conejos County, CO",CO,2011,3723,3319,404,10.9,-21
"Conejos County, CO",CO,2010,3744,3368,376,10.0,0
"Contra Costa County, CA",CA,2021,542352,507874,34478,6.4,-3106
"Contra Costa County, CA",CA,2020,545458,495891,49567,9.1,-15251
"Contra Costa County, CA",CA,2019,560709,543096,17613,3.1,476
"Contra Costa County, CA",CA,2018,560233,542110,18123,3.2,2364
"Contra Costa County, CA",CA,2017,557869,536304,21565,3.9,4648
"Contra Costa County, CA",CA,2016,553221,528401,24820,4.5,8604
"Contra Costa County, CA",CA,2015,544617,517048,27569,5.1,6159
"Contra Costa County, CA",CA,2014,538458,504821,33637,6.2,2426
"Contra Costa County, CA",CA,2013,536032,495293,40739,7.6,1512
"Contra Costa County, CA",CA,2012,534520,485934,48586,9.1,6014
"Contra Costa County, CA",CA,2011,528506,473141,55365,10.5,2761
"Contra Costa County, CA",CA,2010,525745,466727,59018,11.2,0
"Converse County, WY",WY,2021,7496,7132,364,4.9,-504
"Converse County, WY",WY,2020,8000,7528,472,5.9,-658
"Converse County, WY",WY,2019,8658,8406,252,2.9,985
"Converse County, WY",WY,2018,7673,7390,283,3.7,170
"Converse County, WY",WY,2017,7503,7159,344,4.6,-376
"Converse County, WY",WY,2016,7879,7385,494,6.3,-368
"Converse County, WY",WY,2015,8247,7949,298,3.6,6
"Converse County, WY",WY,2014,8241,7980,261,3.2,250
"Converse County, WY",WY,2013,7991,7695,296,3.7,108
"Converse County, WY",WY,2012,7883,7534,349,4.4,325
"Converse County, WY",WY,2011,7558,7170,388,5.1,30
"Converse County, WY",WY,2010,7528,7085,443,5.9,0
"Conway County, AR",AR,2021,8231,7889,342,4.2,-182
"Conway County, AR",AR,2020,8413,7903,510,6.1,113
"Conway County, AR",AR,2019,8300,7950,350,4.2,137
"Conway County, AR",AR,2018,8163,7812,351,4.3,-66
"Conway County, AR",AR,2017,8229,7834,395,4.8,-239
"Conway County, AR",AR,2016,8468,7983,485,5.7,-214
"Conway County, AR",AR,2015,8682,8161,521,6.0,15
"Conway County, AR",AR,2014,8667,8061,606,7.0,-31
"Conway County, AR",AR,2013,8698,7917,781,9.0,-41
"Conway County, AR",AR,2012,8739,7968,771,8.8,-256
"Conway County, AR",AR,2011,8995,8146,849,9.4,-28
"Conway County, AR",AR,2010,9023,8183,840,9.3,0
"Cook County, GA",GA,2021,8237,7957,280,3.4,138
"Cook County, GA",GA,2020,8099,7715,384,4.7,-73
"Cook County, GA",GA,2019,8172,7887,285,3.5,303
"Cook County, GA",GA,2018,7869,7568,301,3.8,80
"Cook County, GA",GA,2017,7789,7433,356,4.6,265
"Cook County, GA",GA,2016,7524,7111,413,5.5,318
"Cook County, GA",GA,2015,7206,6716,490,6.8,-178
"Cook County, GA",GA,2014,7384,6783,601,8.1,-44
"Cook County, GA",GA,2013,7428,6798,630,8.5,-79
"Cook County, GA",GA,2012,7507,6807,700,9.3,-77
"Cook County, GA",GA,2011,7584,6739,845,11.1,-323
"Cook County, GA",GA,2010,7907,6975,932,11.8,0
"Cook County, IL",IL,2021,2594101,2411555,182546,7.0,-29951
"Cook County, IL",IL,2020,2624052,2351173,272879,10.4,-60378
"Cook County, IL",IL,2019,2684430,2578917,105513,3.9,11065
"Cook County, IL",IL,2018,2673365,2561204,112161,4.2,-15841
"Cook County, IL",IL,2017,2689206,2551081,138125,5.1,24449
"Cook County, IL",IL,2016,2664757,2500070,164687,6.2,16854
"Cook County, IL",IL,2015,2647903,2481137,166766,6.3,-10081
"Cook County, IL",IL,2014,2657984,2456426,201558,7.6,-19953
"Cook County, IL",IL,2013,2677937,2418142,259795,9.7,14567
"Cook County, IL",IL,2012,2663370,2406145,257225,9.7,41032
"Cook County, IL",IL,2011,2622338,2345151,277187,10.6,-18238
"Cook County, IL",IL,2010,2640576,2350480,290096,11.0,0
"Cook County, MN",MN,2021,2867,2738,129,4.5,-142
"Cook County, MN",MN,2020,3009,2753,256,8.5,-147
"Cook County, MN",MN,2019,3156,3012,144,4.6,97
"Cook County, MN",MN,2018,3059,2947,112,3.7,-63
"Cook County, MN",MN,2017,3122,3001,121,3.9,29
"Cook County, MN",MN,2016,3093,2952,141,4.6,-69
"Cook County, MN",MN,2015,3162,3020,142,4.5,97
"Cook County, MN",MN,2014,3065,2888,177,5.8,7
"Cook County, MN",MN,2013,3058,2878,180,5.9,6
"Cook County, MN",MN,2012,3052,2860,192,6.3,-6
"Cook County, MN",MN,2011,3058,2848,210,6.9,-1
"Cook County, MN",MN,2010,3059,2839,220,7.2,0
"Cooke County, TX",TX,2021,19360,18384,976,5.0,249
"Cooke County, TX",TX,2020,19111,17756,1355,7.1,-485
"Cooke County, TX",TX,2019,19596,19043,553,2.8,606
"Cooke County, TX",TX,2018,18990,18398,592,3.1,278
"Cooke County, TX",TX,2017,18712,18033,679,3.6,-211
"Cooke County, TX",TX,2016,18923,18171,752,4.0,-851
"Cooke County, TX",TX,2015,19774,19039,735,3.7,-738
"Cooke County, TX",TX,2014,20512,19711,801,3.9,69
"Cooke County, TX",TX,2013,20443,19414,1029,5.0,-202
"Cooke County, TX",TX,2012,20645,19614,1031,5.0,295
"Cooke County, TX",TX,2011,20350,19077,1273,6.3,782
"Cooke County, TX",TX,2010,19568,18137,1431,7.3,0
"Cooper County, MO",MO,2021,7080,6824,256,3.6,-75
"Cooper County, MO",MO,2020,7155,6767,388,5.4,-248
"Cooper County, MO",MO,2019,7403,7142,261,3.5,-5
"Cooper County, MO",MO,2018,7408,7182,226,3.1,-40
"Cooper County, MO",MO,2017,7448,7178,270,3.6,-25
"Cooper County, MO",MO,2016,7473,7106,367,4.9,-96
"Cooper County, MO",MO,2015,7569,7123,446,5.9,-53
"Cooper County, MO",MO,2014,7622,7165,457,6.0,-46
"Cooper County, MO",MO,2013,7668,7131,537,7.0,-92
"Cooper County, MO",MO,2012,7760,7188,572,7.4,-149
"Cooper County, MO",MO,2011,7909,7183,726,9.2,-17
"Cooper County, MO",MO,2010,7926,7159,767,9.7,0
"Coos County, NH",NH,2021,14322,13689,633,4.4,93
"Coos County, NH",NH,2020,14229,13091,1138,8.0,-545
"Coos County, NH",NH,2019,14774,14296,478,3.2,88
"Coos County, NH",NH,2018,14686,14197,489,3.3,146
"Coos County, NH",NH,2017,14540,14020,520,3.6,-122
"Coos County, NH",NH,2016,14662,14109,553,3.8,-182
"Coos County, NH",NH,2015,14844,14190,654,4.4,-345
"Coos County, NH",NH,2014,15189,14321,868,5.7,-780
"Coos County, NH",NH,2013,15969,14971,998,6.2,-112
"Coos County, NH",NH,2012,16081,14904,1177,7.3,-279
"Coos County, NH",NH,2011,16360,15157,1203,7.4,-265
"Coos County, NH",NH,2010,16625,15346,1279,7.7,0
"Coos County, OR",OR,2021,27033,25337,1696,6.3,453
"Coos County, OR",OR,2020,26580,24285,2295,8.6,464
"Coos County, OR",OR,2019,26116,24865,1251,4.8,88
"Coos County, OR",OR,2018,26028,24666,1362,5.2,-260
"Coos County, OR",OR,2017,26288,24866,1422,5.4,-82
"Coos County, OR",OR,2016,26370,24713,1657,6.3,417
"Coos County, OR",OR,2015,25953,24071,1882,7.3,-252
"Coos County, OR",OR,2014,26205,23898,2307,8.8,-315
"Coos County, OR",OR,2013,26520,23839,2681,10.1,-731
"Coos County, OR",OR,2012,27251,24232,3019,11.1,-752
"Coos County, OR",OR,2011,28003,24725,3278,11.7,152
"Coos County, OR",OR,2010,27851,24282,3569,12.8,0
"Coosa County, AL",AL,2021,4343,4209,134,3.1,-85
"Coosa County, AL",AL,2020,4428,4156,272,6.1,-147
"Coosa County, AL",AL,2019,4575,4432,143,3.1,100
"Coosa County, AL",AL,2018,4475,4291,184,4.1,45
"Coosa County, AL",AL,2017,4430,4218,212,4.8,86
"Coosa County, AL",AL,2016,4344,4084,260,6.0,-72
"Coosa County, AL",AL,2015,4416,4119,297,6.7,-58
"Coosa County, AL",AL,2014,4474,4082,392,8.8,25
"Coosa County, AL",AL,2013,4449,4036,413,9.3,-2
"Coosa County, AL",AL,2012,4451,4025,426,9.6,-21
"Coosa County, AL",AL,2011,4472,3920,552,12.3,-176
"Coosa County, AL",AL,2010,4648,3946,702,15.1,0
"Copiah County, MS",MS,2021,10772,10073,699,6.5,128
"Copiah County, MS",MS,2020,10644,9782,862,8.1,-446
"Copiah County, MS",MS,2019,11090,10353,737,6.6,-39
"Copiah County, MS",MS,2018,11129,10491,638,5.7,-97
"Copiah County, MS",MS,2017,11226,10569,657,5.9,-4
"Copiah County, MS",MS,2016,11230,10482,748,6.7,3
"Copiah County, MS",MS,2015,11227,10405,822,7.3,92
"Copiah County, MS",MS,2014,11135,10136,999,9.0,-343
"Copiah County, MS",MS,2013,11478,10278,1200,10.5,-515
"Copiah County, MS",MS,2012,11993,10695,1298,10.8,-286
"Copiah County, MS",MS,2011,12279,10893,1386,11.3,267
"Copiah County, MS",MS,2010,12012,10677,1335,11.1,0
"Copper River Census Area, AK",AK,2021,1356,1235,121,8.9,66
"Copper River Census Area, AK",AK,2020,1290,1153,137,10.6,-8268
"Corozal Municipio, PR",PR,2021,9558,8584,974,10.2,
"Corozal Municipio, PR",PR,2020,N.A.,N.A.,N.A.,N.A.,
"Corozal Municipio, PR",PR,2019,8921,8106,815,9.1,37
"Corozal Municipio, PR",PR,2018,8884,8046,838,9.4,-129
"Corozal Municipio, PR",PR,2017,9013,7994,1019,11.3,-237
"Corozal Municipio, PR",PR,2016,9250,8114,1136,12.3,-169
"Corozal Municipio, PR",PR,2015,9419,8152,1267,13.5,-116
"Corozal Municipio, PR",PR,2014,9535,8093,1442,15.1,-213
"Corozal Municipio, PR",PR,2013,9748,8285,1463,15.0,-84
"Corozal Municipio, PR",PR,2012,9832,8260,1572,16.0,-215
"Corozal Municipio, PR",PR,2011,10047,8267,1780,17.7,-139
"Corozal Municipio, PR",PR,2010,10186,8424,1762,17.3,0
"Corson County, SD",SD,2021,1314,1252,62,4.7,-2
"Corson County, SD",SD,2020,1316,1255,61,4.6,-25
"Corson County, SD",SD,2019,1341,1275,66,4.9,-41
"Corson County, SD",SD,2018,1382,1330,52,3.8,-37
"Corson County, SD",SD,2017,1419,1364,55,3.9,-42
"Corson County, SD",SD,2016,1461,1395,66,4.5,-38
"Corson County, SD",SD,2015,1499,1424,75,5.0,-2
"Corson County, SD",SD,2014,1501,1415,86,5.7,-17
"Corson County, SD",SD,2013,1518,1415,103,6.8,-7
"Corson County, SD",SD,2012,1525,1409,116,7.6,-24
"Corson County, SD",SD,2011,1549,1436,113,7.3,-1
"Corson County, SD",SD,2010,1550,1443,107,6.9,0
"Cortland County, NY",NY,2021,22100,20978,1122,5.1,-679
"Cortland County, NY",NY,2020,22779,21027,1752,7.7,-663
"Cortland County, NY",NY,2019,23442,22343,1099,4.7,99
"Cortland County, NY",NY,2018,23343,22161,1182,5.1,-37
"Cortland County, NY",NY,2017,23380,22035,1345,5.8,381
"Cortland County, NY",NY,2016,22999,21667,1332,5.8,-234
"Cortland County, NY",NY,2015,23233,21855,1378,5.9,-400
"Cortland County, NY",NY,2014,23633,22082,1551,6.6,-652
"Cortland County, NY",NY,2013,24285,22356,1929,7.9,-159
"Cortland County, NY",NY,2012,24444,22305,2139,8.8,64
"Cortland County, NY",NY,2011,24380,22301,2079,8.5,-124
"Cortland County, NY",NY,2010,24504,22286,2218,9.1,0
"Coryell County, TX",TX,2021,24346,22968,1378,5.7,712
"Coryell County, TX",TX,2020,23634,22070,1564,6.6,-73
"Coryell County, TX",TX,2019,23707,22764,943,4.0,40
"Coryell County, TX",TX,2018,23667,22667,1000,4.2,-551
"Coryell County, TX",TX,2017,24218,23149,1069,4.4,-210
"Coryell County, TX",TX,2016,24428,23285,1143,4.7,-88
"Coryell County, TX",TX,2015,24516,23338,1178,4.8,-174
"Coryell County, TX",TX,2014,24690,23199,1491,6.0,-483
"Coryell County, TX",TX,2013,25173,23352,1821,7.2,-158
"Coryell County, TX",TX,2012,25331,23481,1850,7.3,-316
"Coryell County, TX",TX,2011,25647,23613,2034,7.9,275
"Coryell County, TX",TX,2010,25372,23464,1908,7.5,0
"Coshocton County, OH",OH,2021,13772,12968,804,5.8,-318
"Coshocton County, OH",OH,2020,14090,12834,1256,8.9,-404
"Coshocton County, OH",OH,2019,14494,13637,857,5.9,16
"Coshocton County, OH",OH,2018,14478,13587,891,6.2,-283
"Coshocton County, OH",OH,2017,14761,13758,1003,6.8,-293
"Coshocton County, OH",OH,2016,15054,13980,1074,7.1,-853
"Coshocton County, OH",OH,2015,15907,14883,1024,6.4,94
"Coshocton County, OH",OH,2014,15813,14622,1191,7.5,-529
"Coshocton County, OH",OH,2013,16342,14750,1592,9.7,130
"Coshocton County, OH",OH,2012,16212,14584,1628,10.0,-536
"Coshocton County, OH",OH,2011,16748,14832,1916,11.4,-749
"Coshocton County, OH",OH,2010,17497,15278,2219,12.7,0
"Costilla County, CO",CO,2021,1885,1771,114,6.0,73
"Costilla County, CO",CO,2020,1812,1687,125,6.9,-40
"Costilla County, CO",CO,2019,1852,1783,69,3.7,31
"Costilla County, CO",CO,2018,1821,1747,74,4.1,16
"Costilla County, CO",CO,2017,1805,1746,59,3.3,77
"Costilla County, CO",CO,2016,1728,1648,80,4.6,107
"Costilla County, CO",CO,2015,1621,1521,100,6.2,13
"Costilla County, CO",CO,2014,1608,1463,145,9.0,14
"Costilla County, CO",CO,2013,1594,1418,176,11.0,-5
"Costilla County, CO",CO,2012,1599,1414,185,11.6,19
"Costilla County, CO",CO,2011,1580,1389,191,12.1,30
"Costilla County, CO",CO,2010,1550,1378,172,11.1,0
"Cottle County, TX",TX,2021,604,576,28,4.6,40
"Cottle County, TX",TX,2020,564,536,28,5.0,21
"Cottle County, TX",TX,2019,543,520,23,4.2,17
"Cottle County, TX",TX,2018,526,503,23,4.4,10
"Cottle County, TX",TX,2017,516,494,22,4.3,-9
"Cottle County, TX",TX,2016,525,498,27,5.1,-21
"Cottle County, TX",TX,2015,546,507,39,7.1,-59
"Cottle County, TX",TX,2014,605,567,38,6.3,-19
"Cottle County, TX",TX,2013,624,581,43,6.9,-40
"Cottle County, TX",TX,2012,664,615,49,7.4,-4
"Cottle County, TX",TX,2011,668,616,52,7.8,-1
"Cottle County, TX",TX,2010,669,622,47,7.0,0
"Cotton County, OK",OK,2021,2708,2598,110,4.1,4
"Cotton County, OK",OK,2020,2704,2511,193,7.1,52
"Cotton County, OK",OK,2019,2652,2571,81,3.1,-74
"Cotton County, OK",OK,2018,2726,2644,82,3.0,-62
"Cotton County, OK",OK,2017,2788,2682,106,3.8,-99
"Cotton County, OK",OK,2016,2887,2753,134,4.6,28
"Cotton County, OK",OK,2015,2859,2743,116,4.1,11
"Cotton County, OK",OK,2014,2848,2721,127,4.5,-10
"Cotton County, OK",OK,2013,2858,2702,156,5.5,-14
"Cotton County, OK",OK,2012,2872,2715,157,5.5,-33
"Cotton County, OK",OK,2011,2905,2737,168,5.8,-100
"Cotton County, OK",OK,2010,3005,2812,193,6.4,0
"Cottonwood County, MN",MN,2021,6409,6193,216,3.4,38
"Cottonwood County, MN",MN,2020,6371,6062,309,4.9,386
"Cottonwood County, MN",MN,2019,5985,5750,235,3.9,152
"Cottonwood County, MN",MN,2018,5833,5610,223,3.8,90
"Cottonwood County, MN",MN,2017,5743,5441,302,5.3,213
"Cottonwood County, MN",MN,2016,5530,5134,396,7.2,-274
"Cottonwood County, MN",MN,2015,5804,5521,283,4.9,208
"Cottonwood County, MN",MN,2014,5596,5295,301,5.4,-167
"Cottonwood County, MN",MN,2013,5763,5423,340,5.9,-191
"Cottonwood County, MN",MN,2012,5954,5565,389,6.5,-199
"Cottonwood County, MN",MN,2011,6153,5773,380,6.2,-79
"Cottonwood County, MN",MN,2010,6232,5825,407,6.5,0
"Covington city, VA",VA,2021,2279,2147,132,5.8,-135
"Covington city, VA",VA,2020,2414,2182,232,9.6,-24
"Covington city, VA",VA,2019,2438,2339,99,4.1,15
"Covington city, VA",VA,2018,2423,2311,112,4.6,-46
"Covington city, VA",VA,2017,2469,2322,147,6.0,84
"Covington city, VA",VA,2016,2385,2247,138,5.8,-42
"Covington city, VA",VA,2015,2427,2283,144,5.9,-68
"Covington city, VA",VA,2014,2495,2299,196,7.9,-65
"Covington city, VA",VA,2013,2560,2350,210,8.2,-79
"Covington city, VA",VA,2012,2639,2407,232,8.8,-19
"Covington city, VA",VA,2011,2658,2409,249,9.4,-36
"Covington city, VA",VA,2010,2694,2402,292,10.8,0
"Covington County, AL",AL,2021,15215,14756,459,3.0,-127
"Covington County, AL",AL,2020,15342,14500,842,5.5,-446
"Covington County, AL",AL,2019,15788,15218,570,3.6,-32
"Covington County, AL",AL,2018,15820,15101,719,4.5,-81
"Covington County, AL",AL,2017,15901,15054,847,5.3,535
"Covington County, AL",AL,2016,15366,14325,1041,6.8,-56
"Covington County, AL",AL,2015,15422,14314,1108,7.2,-518
"Covington County, AL",AL,2014,15940,14706,1234,7.7,-115
"Covington County, AL",AL,2013,16055,14737,1318,8.2,-309
"Covington County, AL",AL,2012,16364,14960,1404,8.6,-8
"Covington County, AL",AL,2011,16372,14772,1600,9.8,-56
"Covington County, AL",AL,2010,16428,14753,1675,10.2,0
"Covington County, MS",MS,2021,8214,7791,423,5.1,-11
"Covington County, MS",MS,2020,8225,7670,555,6.7,18
"Covington County, MS",MS,2019,8207,7811,396,4.8,141
"Covington County, MS",MS,2018,8066,7696,370,4.6,-17
"Covington County, MS",MS,2017,8083,7682,401,5.0,-33
"Covington County, MS",MS,2016,8116,7666,450,5.5,175
"Covington County, MS",MS,2015,7941,7471,470,5.9,128
"Covington County, MS",MS,2014,7813,7292,521,6.7,-147
"Covington County, MS",MS,2013,7960,7336,624,7.8,-489
"Covington County, MS",MS,2012,8449,7748,701,8.3,-109
"Covington County, MS",MS,2011,8558,7775,783,9.1,306
"Covington County, MS",MS,2010,8252,7440,812,9.8,0
"Coweta County, GA",GA,2021,76218,73661,2557,3.4,1803
"Coweta County, GA",GA,2020,74415,69877,4538,6.1,-1057
"Coweta County, GA",GA,2019,75472,73141,2331,3.1,1143
"Coweta County, GA",GA,2018,74329,71737,2592,3.5,987
"Coweta County, GA",GA,2017,73342,70242,3100,4.2,2939
"Coweta County, GA",GA,2016,70403,66854,3549,5.0,3330
"Coweta County, GA",GA,2015,67073,63448,3625,5.4,671
"Coweta County, GA",GA,2014,66402,62297,4105,6.2,668
"Coweta County, GA",GA,2013,65734,61173,4561,6.9,456
"Coweta County, GA",GA,2012,65278,60150,5128,7.9,394
"Coweta County, GA",GA,2011,64884,59061,5823,9.0,370
"Coweta County, GA",GA,2010,64514,58167,6347,9.8,0
"Cowley County, KS",KS,2021,16678,16106,572,3.4,-96
"Cowley County, KS",KS,2020,16774,15711,1063,6.3,364
"Cowley County, KS",KS,2019,16410,15868,542,3.3,-475
"Cowley County, KS",KS,2018,16885,16323,562,3.3,-156
"Cowley County, KS",KS,2017,17041,16397,644,3.8,56
"Cowley County, KS",KS,2016,16985,16236,749,4.4,-103
"Cowley County, KS",KS,2015,17088,16307,781,4.6,-200
"Cowley County, KS",KS,2014,17288,16493,795,4.6,84
"Cowley County, KS",KS,2013,17204,16204,1000,5.8,-77
"Cowley County, KS",KS,2012,17281,16216,1065,6.2,105
"Cowley County, KS",KS,2011,17176,15989,1187,6.9,-78
"Cowley County, KS",KS,2010,17254,15919,1335,7.7,0
"Cowlitz County, WA",WA,2021,48443,45358,3085,6.4,-485
"Cowlitz County, WA",WA,2020,48928,44453,4475,9.1,460
"Cowlitz County, WA",WA,2019,48468,45512,2956,6.1,1878
"Cowlitz County, WA",WA,2018,46590,43845,2745,5.9,660
"Cowlitz County, WA",WA,2017,45930,43184,2746,6.0,1054
"Cowlitz County, WA",WA,2016,44876,41712,3164,7.1,783
"Cowlitz County, WA",WA,2015,44093,40793,3300,7.5,559
"Cowlitz County, WA",WA,2014,43534,40120,3414,7.8,264
"Cowlitz County, WA",WA,2013,43270,39108,4162,9.6,-1027
"Cowlitz County, WA",WA,2012,44297,39950,4347,9.8,81
"Cowlitz County, WA",WA,2011,44216,39466,4750,10.7,-1133
"Cowlitz County, WA",WA,2010,45349,40039,5310,11.7,0
"Craig County, OK",OK,2021,5714,5506,208,3.6,-71
"Craig County, OK",OK,2020,5785,5468,317,5.5,-114
"Craig County, OK",OK,2019,5899,5700,199,3.4,-171
"Craig County, OK",OK,2018,6070,5867,203,3.3,1
"Craig County, OK",OK,2017,6069,5819,250,4.1,-176
"Craig County, OK",OK,2016,6245,5954,291,4.7,-11
"Craig County, OK",OK,2015,6256,5961,295,4.7,207
"Craig County, OK",OK,2014,6049,5726,323,5.3,-185
"Craig County, OK",OK,2013,6234,5841,393,6.3,-100
"Craig County, OK",OK,2012,6334,5987,347,5.5,7
"Craig County, OK",OK,2011,6327,5947,380,6.0,-256
"Craig County, OK",OK,2010,6583,6159,424,6.4,0
"Craig County, VA",VA,2021,2222,2148,74,3.3,-51
"Craig County, VA",VA,2020,2273,2157,116,5.1,-99
"Craig County, VA",VA,2019,2372,2298,74,3.1,59
"Craig County, VA",VA,2018,2313,2231,82,3.5,4
"Craig County, VA",VA,2017,2309,2210,99,4.3,-44
"Craig County, VA",VA,2016,2353,2243,110,4.7,-36
"Craig County, VA",VA,2015,2389,2259,130,5.4,-77
"Craig County, VA",VA,2014,2466,2312,154,6.2,10
"Craig County, VA",VA,2013,2456,2287,169,6.9,-5
"Craig County, VA",VA,2012,2461,2292,169,6.9,-16
"Craig County, VA",VA,2011,2477,2291,186,7.5,33
"Craig County, VA",VA,2010,2444,2245,199,8.1,0
"Craighead County, AR",AR,2021,55682,53861,1821,3.3,-627
"Craighead County, AR",AR,2020,56309,53304,3005,5.3,88
"Craighead County, AR",AR,2019,56221,54685,1536,2.7,1724
"Craighead County, AR",AR,2018,54497,52863,1634,3.0,918
"Craighead County, AR",AR,2017,53579,51961,1618,3.0,1264
"Craighead County, AR",AR,2016,52315,50613,1702,3.3,1101
"Craighead County, AR",AR,2015,51214,48977,2237,4.4,1352
"Craighead County, AR",AR,2014,49862,47210,2652,5.3,234
"Craighead County, AR",AR,2013,49628,46453,3175,6.4,353
"Craighead County, AR",AR,2012,49275,46024,3251,6.6,312
"Craighead County, AR",AR,2011,48963,45520,3443,7.0,1212
"Craighead County, AR",AR,2010,47751,44346,3405,7.1,0
"Crane County, TX",TX,2021,1626,1470,156,9.6,13
"Crane County, TX",TX,2020,1613,1393,220,13.6,65
"Crane County, TX",TX,2019,1548,1486,62,4.0,-215
"Crane County, TX",TX,2018,1763,1695,68,3.9,181
"Crane County, TX",TX,2017,1582,1498,84,5.3,-124
"Crane County, TX",TX,2016,1706,1560,146,8.6,-132
"Crane County, TX",TX,2015,1838,1731,107,5.8,-166
"Crane County, TX",TX,2014,2004,1922,82,4.1,-79
"Crane County, TX",TX,2013,2083,1989,94,4.5,27
"Crane County, TX",TX,2012,2056,1956,100,4.9,138
"Crane County, TX",TX,2011,1918,1786,132,6.9,96
"Crane County, TX",TX,2010,1822,1682,140,7.7,0
"Craven County, NC",NC,2021,40693,38789,1904,4.7,866
"Craven County, NC",NC,2020,39827,37305,2522,6.3,-1469
"Craven County, NC",NC,2019,41296,39649,1647,4.0,354
"Craven County, NC",NC,2018,40942,39187,1755,4.3,-220
"Craven County, NC",NC,2017,41162,39252,1910,4.6,-466
"Craven County, NC",NC,2016,41628,39448,2180,5.2,333
"Craven County, NC",NC,2015,41295,38826,2469,6.0,206
"Craven County, NC",NC,2014,41089,38332,2757,6.7,-439
"Craven County, NC",NC,2013,41528,38026,3502,8.4,-709
"Craven County, NC",NC,2012,42237,38135,4102,9.7,89
"Craven County, NC",NC,2011,42148,37703,4445,10.5,-290
"Craven County, NC",NC,2010,42438,37928,4510,10.6,0
"Crawford County, AR",AR,2021,25772,24851,921,3.6,-738
"Crawford County, AR",AR,2020,26510,25062,1448,5.5,-400
"Crawford County, AR",AR,2019,26910,26036,874,3.2,-62
"Crawford County, AR",AR,2018,26972,26027,945,3.5,47
"Crawford County, AR",AR,2017,26925,25971,954,3.5,-70
"Crawford County, AR",AR,2016,26995,25941,1054,3.9,33
"Crawford County, AR",AR,2015,26962,25582,1380,5.1,-44
"Crawford County, AR",AR,2014,27006,25426,1580,5.9,-202
"Crawford County, AR",AR,2013,27208,25179,2029,7.5,-512
"Crawford County, AR",AR,2012,27720,25599,2121,7.7,-154
"Crawford County, AR",AR,2011,27874,25519,2355,8.4,-412
"Crawford County, AR",AR,2010,28286,26053,2233,7.9,0
"Crawford County, GA",GA,2021,5523,5319,204,3.7,109
"Crawford County, GA",GA,2020,5414,5139,275,5.1,-239
"Crawford County, GA",GA,2019,5653,5440,213,3.8,-57
"Crawford County, GA",GA,2018,5710,5469,241,4.2,-76
"Crawford County, GA",GA,2017,5786,5499,287,5.0,108
"Crawford County, GA",GA,2016,5678,5339,339,6.0,164
"Crawford County, GA",GA,2015,5514,5160,354,6.4,-90
"Crawford County, GA",GA,2014,5604,5183,421,7.5,-77
"Crawford County, GA",GA,2013,5681,5181,500,8.8,-129
"Crawford County, GA",GA,2012,5810,5248,562,9.7,12
"Crawford County, GA",GA,2011,5798,5175,623,10.7,7
"Crawford County, GA",GA,2010,5791,5116,675,11.7,0
"Crawford County, IA",IA,2021,7867,7460,407,5.2,-125
"Crawford County, IA",IA,2020,7992,7580,412,5.2,-301
"Crawford County, IA",IA,2019,8293,8014,279,3.4,11
"Crawford County, IA",IA,2018,8282,8001,281,3.4,-50
"Crawford County, IA",IA,2017,8332,7996,336,4.0,-147
"Crawford County, IA",IA,2016,8479,8020,459,5.4,-270
"Crawford County, IA",IA,2015,8749,8386,363,4.1,17
"Crawford County, IA",IA,2014,8732,8377,355,4.1,-49
"Crawford County, IA",IA,2013,8781,8398,383,4.4,-11
"Crawford County, IA",IA,2012,8792,8398,394,4.5,-64
"Crawford County, IA",IA,2011,8856,8429,427,4.8,-102
"Crawford County, IA",IA,2010,8958,8530,428,4.8,0
"Crawford County, IL",IL,2021,8469,8043,426,5.0,84
"Crawford County, IL",IL,2020,8385,7789,596,7.1,-301
"Crawford County, IL",IL,2019,8686,8327,359,4.1,-60
"Crawford County, IL",IL,2018,8746,8278,468,5.4,-134
"Crawford County, IL",IL,2017,8880,8415,465,5.2,-185
"Crawford County, IL",IL,2016,9065,8498,567,6.3,-584
"Crawford County, IL",IL,2015,9649,9077,572,5.9,-94
"Crawford County, IL",IL,2014,9743,9107,636,6.5,-211
"Crawford County, IL",IL,2013,9954,9130,824,8.3,-442
"Crawford County, IL",IL,2012,10396,9591,805,7.7,-420
"Crawford County, IL",IL,2011,10816,10027,789,7.3,445
"Crawford County, IL",IL,2010,10371,9475,896,8.6,0
"Crawford County, IN",IN,2021,4788,4613,175,3.7,-81
"Crawford County, IN",IN,2020,4869,4515,354,7.3,-19
"Crawford County, IN",IN,2019,4888,4690,198,4.1,-66
"Crawford County, IN",IN,2018,4954,4735,219,4.4,8
"Crawford County, IN",IN,2017,4946,4728,218,4.4,-57
"Crawford County, IN",IN,2016,5003,4725,278,5.6,89
"Crawford County, IN",IN,2015,4914,4619,295,6.0,19
"Crawford County, IN",IN,2014,4895,4521,374,7.6,49
"Crawford County, IN",IN,2013,4846,4370,476,9.8,53
"Crawford County, IN",IN,2012,4793,4291,502,10.5,-82
"Crawford County, IN",IN,2011,4875,4308,567,11.6,-42
"Crawford County, IN",IN,2010,4917,4297,620,12.6,0
"Crawford County, KS",KS,2021,18935,18334,601,3.2,4
"Crawford County, KS",KS,2020,18931,17920,1011,5.3,19
"Crawford County, KS",KS,2019,18912,18190,722,3.8,49
"Crawford County, KS",KS,2018,18863,18128,735,3.9,-340
"Crawford County, KS",KS,2017,19203,18402,801,4.2,202
"Crawford County, KS",KS,2016,19001,18087,914,4.8,23
"Crawford County, KS",KS,2015,18978,18012,966,5.1,-184
"Crawford County, KS",KS,2014,19162,18144,1018,5.3,-165
"Crawford County, KS",KS,2013,19327,18186,1141,5.9,-30
"Crawford County, KS",KS,2012,19357,18075,1282,6.6,104
"Crawford County, KS",KS,2011,19253,17755,1498,7.8,-90
"Crawford County, KS",KS,2010,19343,17687,1656,8.6,0
"Crawford County, MI",MI,2021,5359,4981,378,7.1,-230
"Crawford County, MI",MI,2020,5589,4975,614,11.0,-8
"Crawford County, MI",MI,2019,5597,5277,320,5.7,53
"Crawford County, MI",MI,2018,5544,5210,334,6.0,127
"Crawford County, MI",MI,2017,5417,5046,371,6.8,34
"Crawford County, MI",MI,2016,5383,4972,411,7.6,82
"Crawford County, MI",MI,2015,5301,4880,421,7.9,-49
"Crawford County, MI",MI,2014,5350,4841,509,9.5,-45
"Crawford County, MI",MI,2013,5395,4783,612,11.3,7
"Crawford County, MI",MI,2012,5388,4761,627,11.6,-92
"Crawford County, MI",MI,2011,5480,4804,676,12.3,-91
"Crawford County, MI",MI,2010,5571,4804,767,13.8,0
"Crawford County, MO",MO,2021,10913,10418,495,4.5,125
"Crawford County, MO",MO,2020,10788,10103,685,6.3,-122
"Crawford County, MO",MO,2019,10910,10522,388,3.6,87
"Crawford County, MO",MO,2018,10823,10408,415,3.8,30
"Crawford County, MO",MO,2017,10793,10297,496,4.6,-24
"Crawford County, MO",MO,2016,10817,10240,577,5.3,-28
"Crawford County, MO",MO,2015,10845,10179,666,6.1,-6
"Crawford County, MO",MO,2014,10851,9979,872,8.0,-18
"Crawford County, MO",MO,2013,10869,9931,938,8.6,197
"Crawford County, MO",MO,2012,10672,9703,969,9.1,-139
"Crawford County, MO",MO,2011,10811,9612,1199,11.1,49
"Crawford County, MO",MO,2010,10762,9406,1356,12.6,0
"Crawford County, OH",OH,2021,18066,17016,1050,5.8,-460
"Crawford County, OH",OH,2020,18526,16795,1731,9.3,122
"Crawford County, OH",OH,2019,18404,17537,867,4.7,292
"Crawford County, OH",OH,2018,18112,17164,948,5.2,-813
"Crawford County, OH",OH,2017,18925,17840,1085,5.7,-321
"Crawford County, OH",OH,2016,19246,18079,1167,6.1,104
"Crawford County, OH",OH,2015,19142,18018,1124,5.9,-493
"Crawford County, OH",OH,2014,19635,18318,1317,6.7,-67
"Crawford County, OH",OH,2013,19702,17901,1801,9.1,-612
"Crawford County, OH",OH,2012,20314,18478,1836,9.0,-424
"Crawford County, OH",OH,2011,20738,18351,2387,11.5,-254
"Crawford County, OH",OH,2010,20992,18289,2703,12.9,0
"Crawford County, PA",PA,2021,37822,35305,2517,6.7,-838
"Crawford County, PA",PA,2020,38660,35224,3436,8.9,-378
"Crawford County, PA",PA,2019,39038,37146,1892,4.8,-284
"Crawford County, PA",PA,2018,39322,37412,1910,4.9,-486
"Crawford County, PA",PA,2017,39808,37586,2222,5.6,-751
"Crawford County, PA",PA,2016,40559,38150,2409,5.9,-500
"Crawford County, PA",PA,2015,41059,38884,2175,5.3,-151
"Crawford County, PA",PA,2014,41210,38792,2418,5.9,-437
"Crawford County, PA",PA,2013,41647,38735,2912,7.0,-249
"Crawford County, PA",PA,2012,41896,38769,3127,7.5,458
"Crawford County, PA",PA,2011,41438,38193,3245,7.8,-108
"Crawford County, PA",PA,2010,41546,37732,3814,9.2,0
"Crawford County, WI",WI,2021,7518,7186,332,4.4,61
"Crawford County, WI",WI,2020,7457,6907,550,7.4,-157
"Crawford County, WI",WI,2019,7614,7308,306,4.0,-248
"Crawford County, WI",WI,2018,7862,7575,287,3.7,-43
"Crawford County, WI",WI,2017,7905,7579,326,4.1,6
"Crawford County, WI",WI,2016,7899,7523,376,4.8,17
"Crawford County, WI",WI,2015,7882,7432,450,5.7,-93
"Crawford County, WI",WI,2014,7975,7420,555,7.0,-145
"Crawford County, WI",WI,2013,8120,7460,660,8.1,-168
"Crawford County, WI",WI,2012,8288,7598,690,8.3,-143
"Crawford County, WI",WI,2011,8431,7672,759,9.0,64
"Crawford County, WI",WI,2010,8367,7506,861,10.3,0
"Creek County, OK",OK,2021,31131,29812,1319,4.2,230
"Creek County, OK",OK,2020,30901,28850,2051,6.6,-536
"Creek County, OK",OK,2019,31437,30329,1108,3.5,79
"Creek County, OK",OK,2018,31358,30210,1148,3.7,-9
"Creek County, OK",OK,2017,31367,29884,1483,4.7,-85
"Creek County, OK",OK,2016,31452,29687,1765,5.6,143
"Creek County, OK",OK,2015,31309,29795,1514,4.8,364
"Creek County, OK",OK,2014,30945,29458,1487,4.8,-248
"Creek County, OK",OK,2013,31193,29373,1820,5.8,-249
"Creek County, OK",OK,2012,31442,29614,1828,5.8,268
"Creek County, OK",OK,2011,31174,29101,2073,6.6,-548
"Creek County, OK",OK,2010,31722,29118,2604,8.2,0
"Crenshaw County, AL",AL,2021,6133,5931,202,3.3,-238
"Crenshaw County, AL",AL,2020,6371,5971,400,6.3,-163
"Crenshaw County, AL",AL,2019,6534,6340,194,3.0,98
"Crenshaw County, AL",AL,2018,6436,6177,259,4.0,-41
"Crenshaw County, AL",AL,2017,6477,6177,300,4.6,76
"Crenshaw County, AL",AL,2016,6401,6024,377,5.9,62
"Crenshaw County, AL",AL,2015,6339,5957,382,6.0,29
"Crenshaw County, AL",AL,2014,6310,5875,435,6.9,4
"Crenshaw County, AL",AL,2013,6306,5817,489,7.8,49
"Crenshaw County, AL",AL,2012,6257,5725,532,8.5,-175
"Crenshaw County, AL",AL,2011,6432,5801,631,9.8,142
"Crenshaw County, AL",AL,2010,6290,5658,632,10.0,0
"Crisp County, GA",GA,2021,10068,9206,862,8.6,354
"Crisp County, GA",GA,2020,9714,8841,873,9.0,108
"Crisp County, GA",GA,2019,9606,9220,386,4.0,182
"Crisp County, GA",GA,2018,9424,8962,462,4.9,-69
"Crisp County, GA",GA,2017,9493,8996,497,5.2,302
"Crisp County, GA",GA,2016,9191,8629,562,6.1,-129
"Crisp County, GA",GA,2015,9320,8671,649,7.0,-122
"Crisp County, GA",GA,2014,9442,8604,838,8.9,-218
"Crisp County, GA",GA,2013,9660,8588,1072,11.1,521
"Crisp County, GA",GA,2012,9139,8013,1126,12.3,-41
"Crisp County, GA",GA,2011,9180,7915,1265,13.8,-57
"Crisp County, GA",GA,2010,9237,7911,1326,14.4,0
"Crittenden County, AR",AR,2021,20502,19394,1108,5.4,-600
"Crittenden County, AR",AR,2020,21102,19339,1763,8.4,-147
"Crittenden County, AR",AR,2019,21249,20362,887,4.2,71
"Crittenden County, AR",AR,2018,21178,20272,906,4.3,-200
"Crittenden County, AR",AR,2017,21378,20437,941,4.4,-264
"Crittenden County, AR",AR,2016,21642,20664,978,4.5,139
"Crittenden County, AR",AR,2015,21503,20198,1305,6.1,-81
"Crittenden County, AR",AR,2014,21584,20031,1553,7.2,-69
"Crittenden County, AR",AR,2013,21653,19886,1767,8.2,-523
"Crittenden County, AR",AR,2012,22176,20135,2041,9.2,-460
"Crittenden County, AR",AR,2011,22636,20277,2359,10.4,-142
"Crittenden County, AR",AR,2010,22778,20478,2300,10.1,0
"Crittenden County, KY",KY,2021,3809,3644,165,4.3,136
"Crittenden County, KY",KY,2020,3673,3476,197,5.4,-103
"Crittenden County, KY",KY,2019,3776,3601,175,4.6,-86
"Crittenden County, KY",KY,2018,3862,3668,194,5.0,-121
"Crittenden County, KY",KY,2017,3983,3768,215,5.4,-39
"Crittenden County, KY",KY,2016,4022,3814,208,5.2,305
"Crittenden County, KY",KY,2015,3717,3513,204,5.5,-156
"Crittenden County, KY",KY,2014,3873,3634,239,6.2,-227
"Crittenden County, KY",KY,2013,4100,3799,301,7.3,-60
"Crittenden County, KY",KY,2012,4160,3839,321,7.7,-23
"Crittenden County, KY",KY,2011,4183,3829,354,8.5,97
"Crittenden County, KY",KY,2010,4086,3675,411,10.1,0
"Crockett County, TN",TN,2021,6833,6589,244,3.6,5
"Crockett County, TN",TN,2020,6828,6438,390,5.7,-169
"Crockett County, TN",TN,2019,6997,6753,244,3.5,34
"Crockett County, TN",TN,2018,6963,6694,269,3.9,-4
"Crockett County, TN",TN,2017,6967,6678,289,4.1,77
"Crockett County, TN",TN,2016,6890,6528,362,5.3,57
"Crockett County, TN",TN,2015,6833,6398,435,6.4,-66
"Crockett County, TN",TN,2014,6899,6371,528,7.7,-136
"Crockett County, TN",TN,2013,7035,6395,640,9.1,-173
"Crockett County, TN",TN,2012,7208,6535,673,9.3,-102
"Crockett County, TN",TN,2011,7310,6529,781,10.7,23
"Crockett County, TN",TN,2010,7287,6428,859,11.8,0
"Crockett County, TX",TX,2021,1467,1368,99,6.7,-71
"Crockett County, TX",TX,2020,1538,1401,137,8.9,-74
"Crockett County, TX",TX,2019,1612,1565,47,2.9,-6
"Crockett County, TX",TX,2018,1618,1570,48,3.0,-49
"Crockett County, TX",TX,2017,1667,1599,68,4.1,-70
"Crockett County, TX",TX,2016,1737,1606,131,7.5,-164
"Crockett County, TX",TX,2015,1901,1786,115,6.0,-29
"Crockett County, TX",TX,2014,1930,1856,74,3.8,50
"Crockett County, TX",TX,2013,1880,1783,97,5.2,111
"Crockett County, TX",TX,2012,1769,1681,88,5.0,54
"Crockett County, TX",TX,2011,1715,1597,118,6.9,-10
"Crockett County, TX",TX,2010,1725,1576,149,8.6,0
"Crook County, OR",OR,2021,10941,10205,736,6.7,572
"Crook County, OR",OR,2020,10369,9454,915,8.8,562
"Crook County, OR",OR,2019,9807,9305,502,5.1,377
"Crook County, OR",OR,2018,9430,8884,546,5.8,75
"Crook County, OR",OR,2017,9355,8771,584,6.2,39
"Crook County, OR",OR,2016,9316,8682,634,6.8,295
"Crook County, OR",OR,2015,9021,8285,736,8.2,-42
"Crook County, OR",OR,2014,9063,8190,873,9.6,95
"Crook County, OR",OR,2013,8968,7896,1072,12.0,-310
"Crook County, OR",OR,2012,9278,8022,1256,13.5,-187
"Crook County, OR",OR,2011,9465,8101,1364,14.4,-158
"Crook County, OR",OR,2010,9623,8078,1545,16.1,0
"Crook County, WY",WY,2021,3833,3704,129,3.4,-8
"Crook County, WY",WY,2020,3841,3693,148,3.9,96
"Crook County, WY",WY,2019,3745,3622,123,3.3,4
"Crook County, WY",WY,2018,3741,3620,121,3.2,47
"Crook County, WY",WY,2017,3694,3560,134,3.6,-46
"Crook County, WY",WY,2016,3740,3567,173,4.6,61
"Crook County, WY",WY,2015,3679,3552,127,3.5,11
"Crook County, WY",WY,2014,3668,3519,149,4.1,30
"Crook County, WY",WY,2013,3638,3475,163,4.5,-131
"Crook County, WY",WY,2012,3769,3580,189,5.0,-65
"Crook County, WY",WY,2011,3834,3636,198,5.2,-53
"Crook County, WY",WY,2010,3887,3678,209,5.4,0
"Crosby County, TX",TX,2021,2376,2243,133,5.6,99
"Crosby County, TX",TX,2020,2277,2156,121,5.3,-152
"Crosby County, TX",TX,2019,2429,2333,96,4.0,-33
"Crosby County, TX",TX,2018,2462,2347,115,4.7,-66
"Crosby County, TX",TX,2017,2528,2421,107,4.2,-95
"Crosby County, TX",TX,2016,2623,2508,115,4.4,-26
"Crosby County, TX",TX,2015,2649,2533,116,4.4,-45
"Crosby County, TX",TX,2014,2694,2566,128,4.8,-67
"Crosby County, TX",TX,2013,2761,2596,165,6.0,-143
"Crosby County, TX",TX,2012,2904,2697,207,7.1,-100
"Crosby County, TX",TX,2011,3004,2744,260,8.7,49
"Crosby County, TX",TX,2010,2955,2718,237,8.0,0
"Cross County, AR",AR,2021,6987,6681,306,4.4,-277
"Cross County, AR",AR,2020,7264,6820,444,6.1,-143
"Cross County, AR",AR,2019,7407,7102,305,4.1,-38
"Cross County, AR",AR,2018,7445,7143,302,4.1,-209
"Cross County, AR",AR,2017,7654,7346,308,4.0,-243
"Cross County, AR",AR,2016,7897,7547,350,4.4,-238
"Cross County, AR",AR,2015,8135,7701,434,5.3,-18
"Cross County, AR",AR,2014,8153,7646,507,6.2,-101
"Cross County, AR",AR,2013,8254,7645,609,7.4,-312
"Cross County, AR",AR,2012,8566,7913,653,7.6,-219
"Cross County, AR",AR,2011,8785,8084,701,8.0,177
"Cross County, AR",AR,2010,8608,7921,687,8.0,0
"Crow Wing County, MN",MN,2021,31834,30555,1279,4.0,-702
"Crow Wing County, MN",MN,2020,32536,30117,2419,7.4,-106
"Crow Wing County, MN",MN,2019,32642,31138,1504,4.6,310
"Crow Wing County, MN",MN,2018,32332,30967,1365,4.2,-34
"Crow Wing County, MN",MN,2017,32366,30905,1461,4.5,546
"Crow Wing County, MN",MN,2016,31820,30198,1622,5.1,238
"Crow Wing County, MN",MN,2015,31582,29920,1662,5.3,23
"Crow Wing County, MN",MN,2014,31559,29665,1894,6.0,83
"Crow Wing County, MN",MN,2013,31476,29262,2214,7.0,521
"Crow Wing County, MN",MN,2012,30955,28558,2397,7.7,-680
"Crow Wing County, MN",MN,2011,31635,28852,2783,8.8,-424
"Crow Wing County, MN",MN,2010,32059,28999,3060,9.5,0
"Crowley County, CO",CO,2021,1465,1389,76,5.2,25
"Crowley County, CO",CO,2020,1440,1364,76,5.3,-101
"Crowley County, CO",CO,2019,1541,1479,62,4.0,64
"Crowley County, CO",CO,2018,1477,1417,60,4.1,20
"Crowley County, CO",CO,2017,1457,1415,42,2.9,35
"Crowley County, CO",CO,2016,1422,1374,48,3.4,69
"Crowley County, CO",CO,2015,1353,1295,58,4.3,38
"Crowley County, CO",CO,2014,1315,1238,77,5.9,-6
"Crowley County, CO",CO,2013,1321,1228,93,7.0,-37
"Crowley County, CO",CO,2012,1358,1247,111,8.2,-128
"Crowley County, CO",CO,2011,1486,1349,137,9.2,-34
"Crowley County, CO",CO,2010,1520,1373,147,9.7,0
"Culberson County, TX",TX,2021,1066,1015,51,4.8,-54
"Culberson County, TX",TX,2020,1120,1046,74,6.6,92
"Culberson County, TX",TX,2019,1028,986,42,4.1,62
"Culberson County, TX",TX,2018,966,936,30,3.1,50
"Culberson County, TX",TX,2017,916,882,34,3.7,-84
"Culberson County, TX",TX,2016,1000,959,41,4.1,-41
"Culberson County, TX",TX,2015,1041,997,44,4.2,29
"Culberson County, TX",TX,2014,1012,969,43,4.2,-5
"Culberson County, TX",TX,2013,1017,965,52,5.1,30
"Culberson County, TX",TX,2012,987,928,59,6.0,-31
"Culberson County, TX",TX,2011,1018,945,73,7.2,-16
"Culberson County, TX",TX,2010,1034,960,74,7.2,0
"Culebra Municipio, PR",PR,2021,953,894,59,6.2,
"Culebra Municipio, PR",PR,2020,N.A.,N.A.,N.A.,N.A.,
"Culebra Municipio, PR",PR,2019,896,868,28,3.1,2
"Culebra Municipio, PR",PR,2018,894,855,39,4.4,-18
"Culebra Municipio, PR",PR,2017,912,872,40,4.4,16
"Culebra Municipio, PR",PR,2016,896,866,30,3.3,52
"Culebra Municipio, PR",PR,2015,844,813,31,3.7,58
"Culebra Municipio, PR",PR,2014,786,737,49,6.2,-64
"Culebra Municipio, PR",PR,2013,850,793,57,6.7,10
"Culebra Municipio, PR",PR,2012,840,792,48,5.7,73
"Culebra Municipio, PR",PR,2011,767,705,62,8.1,-49
"Culebra Municipio, PR",PR,2010,816,733,83,10.2,0
"Cullman County, AL",AL,2021,38858,37943,915,2.4,-4
"Cullman County, AL",AL,2020,38862,36992,1870,4.8,-268
"Cullman County, AL",AL,2019,39130,38061,1069,2.7,611
"Cullman County, AL",AL,2018,38519,37263,1256,3.3,261
"Cullman County, AL",AL,2017,38258,36792,1466,3.8,664
"Cullman County, AL",AL,2016,37594,35720,1874,5.0,1298
"Cullman County, AL",AL,2015,36296,34376,1920,5.3,312
"Cullman County, AL",AL,2014,35984,33812,2172,6.0,234
"Cullman County, AL",AL,2013,35750,33333,2417,6.8,143
"Cullman County, AL",AL,2012,35607,32795,2812,7.9,-66
"Cullman County, AL",AL,2011,35673,32295,3378,9.5,-310
"Cullman County, AL",AL,2010,35983,32272,3711,10.3,0
"Culpeper County, VA",VA,2021,24541,23745,796,3.2,-335
"Culpeper County, VA",VA,2020,24876,23655,1221,4.9,-448
"Culpeper County, VA",VA,2019,25324,24675,649,2.6,802
"Culpeper County, VA",VA,2018,24522,23824,698,2.8,390
"Culpeper County, VA",VA,2017,24132,23268,864,3.6,651
"Culpeper County, VA",VA,2016,23481,22585,896,3.8,285
"Culpeper County, VA",VA,2015,23196,22202,994,4.3,-235
"Culpeper County, VA",VA,2014,23431,22281,1150,4.9,44
"Culpeper County, VA",VA,2013,23387,22161,1226,5.2,58
"Culpeper County, VA",VA,2012,23329,22029,1300,5.6,-30
"Culpeper County, VA",VA,2011,23359,21878,1481,6.3,70
"Culpeper County, VA",VA,2010,23289,21580,1709,7.3,0
"Cumberland County, IL",IL,2021,5920,5674,246,4.2,-6
"Cumberland County, IL",IL,2020,5926,5582,344,5.8,-195
"Cumberland County, IL",IL,2019,6121,5920,201,3.3,6
"Cumberland County, IL",IL,2018,6115,5872,243,4.0,-14
"Cumberland County, IL",IL,2017,6129,5883,246,4.0,120
"Cumberland County, IL",IL,2016,6009,5694,315,5.2,92
"Cumberland County, IL",IL,2015,5917,5605,312,5.3,57
"Cumberland County, IL",IL,2014,5860,5511,349,6.0,47
"Cumberland County, IL",IL,2013,5813,5360,453,7.8,-123
"Cumberland County, IL",IL,2012,5936,5472,464,7.8,-2
"Cumberland County, IL",IL,2011,5938,5425,513,8.6,-116
"Cumberland County, IL",IL,2010,6054,5496,558,9.2,0
"Cumberland County, KY",KY,2021,3307,3191,116,3.5,52
"Cumberland County, KY",KY,2020,3255,3101,154,4.7,32
"Cumberland County, KY",KY,2019,3223,3096,127,3.9,105
"Cumberland County, KY",KY,2018,3118,2983,135,4.3,178
"Cumberland County, KY",KY,2017,2940,2787,153,5.2,50
"Cumberland County, KY",KY,2016,2890,2728,162,5.6,24
"Cumberland County, KY",KY,2015,2866,2696,170,5.9,-84
"Cumberland County, KY",KY,2014,2950,2728,222,7.5,-88
"Cumberland County, KY",KY,2013,3038,2717,321,10.6,-83
"Cumberland County, KY",KY,2012,3121,2783,338,10.8,-5
"Cumberland County, KY",KY,2011,3126,2783,343,11.0,-65
"Cumberland County, KY",KY,2010,3191,2812,379,11.9,0
"Cumberland County, ME",ME,2021,162433,155942,6491,4.0,1682
"Cumberland County, ME",ME,2020,160751,152878,7873,4.9,-6090
"Cumberland County, ME",ME,2019,166841,163213,3628,2.2,409
"Cumberland County, ME",ME,2018,166432,162313,4119,2.5,533
"Cumberland County, ME",ME,2017,165899,161555,4344,2.6,3503
"Cumberland County, ME",ME,2016,162396,157678,4718,2.9,3440
"Cumberland County, ME",ME,2015,158956,153481,5475,3.4,-628
"Cumberland County, ME",ME,2014,159584,152585,6999,4.4,-1066
"Cumberland County, ME",ME,2013,160650,152056,8594,5.3,1178
"Cumberland County, ME",ME,2012,159472,150299,9173,5.8,1360
"Cumberland County, ME",ME,2011,158112,148311,9801,6.2,1607
"Cumberland County, ME",ME,2010,156505,145927,10578,6.8,0
"Cumberland County, NC",NC,2021,125305,116685,8620,6.9,1669
"Cumberland County, NC",NC,2020,123636,112350,11286,9.1,-3234
"Cumberland County, NC",NC,2019,126870,120485,6385,5.0,1053
"Cumberland County, NC",NC,2018,125817,119228,6589,5.2,-79
"Cumberland County, NC",NC,2017,125896,118662,7234,5.7,-1051
"Cumberland County, NC",NC,2016,126947,118818,8129,6.4,844
"Cumberland County, NC",NC,2015,126103,117001,9102,7.2,-1398
"Cumberland County, NC",NC,2014,127501,117510,9991,7.8,-3498
"Cumberland County, NC",NC,2013,130999,118696,12303,9.4,-2636
"Cumberland County, NC",NC,2012,133635,119256,14379,10.8,318
"Cumberland County, NC",NC,2011,133317,119247,14070,10.6,1712
"Cumberland County, NC",NC,2010,131605,118405,13200,10.0,0
"Cumberland County, NJ",NJ,2021,68943,63655,5288,7.7,383
"Cumberland County, NJ",NJ,2020,68560,61463,7097,10.4,678
"Cumberland County, NJ",NJ,2019,67882,64344,3538,5.2,823
"Cumberland County, NJ",NJ,2018,67059,62889,4170,6.2,-473
"Cumberland County, NJ",NJ,2017,67532,62922,4610,6.8,1043
"Cumberland County, NJ",NJ,2016,66489,61546,4943,7.4,-887
"Cumberland County, NJ",NJ,2015,67376,61495,5881,8.7,-191
"Cumberland County, NJ",NJ,2014,67567,60887,6680,9.9,-1806
"Cumberland County, NJ",NJ,2013,69373,61064,8309,12.0,-1750
"Cumberland County, NJ",NJ,2012,71123,61727,9396,13.2,-621
"Cumberland County, NJ",NJ,2011,71744,62430,9314,13.0,-902
"Cumberland County, NJ",NJ,2010,72646,63067,9579,13.2,0
"Cumberland County, PA",PA,2021,132627,126550,6077,4.6,-427
"Cumberland County, PA",PA,2020,133054,124212,8842,6.6,-1149
"Cumberland County, PA",PA,2019,134203,129560,4643,3.5,2148
"Cumberland County, PA",PA,2018,132055,127480,4575,3.5,659
"Cumberland County, PA",PA,2017,131396,126312,5084,3.9,1101
"Cumberland County, PA",PA,2016,130295,125064,5231,4.0,1888
"Cumberland County, PA",PA,2015,128407,123192,5215,4.1,2453
"Cumberland County, PA",PA,2014,125954,120237,5717,4.5,548
"Cumberland County, PA",PA,2013,125406,118482,6924,5.5,-128
"Cumberland County, PA",PA,2012,125534,117950,7584,6.0,1345
"Cumberland County, PA",PA,2011,124189,116484,7705,6.2,87
"Cumberland County, PA",PA,2010,124102,115889,8213,6.6,0
"Cumberland County, TN",TN,2021,22618,21539,1079,4.8,-171
"Cumberland County, TN",TN,2020,22789,21080,1709,7.5,-724
"Cumberland County, TN",TN,2019,23513,22445,1068,4.5,143
"Cumberland County, TN",TN,2018,23370,22348,1022,4.4,-44
"Cumberland County, TN",TN,2017,23414,22323,1091,4.7,-162
"Cumberland County, TN",TN,2016,23576,22174,1402,5.9,600
"Cumberland County, TN",TN,2015,22976,21363,1613,7.0,-166
"Cumberland County, TN",TN,2014,23142,21296,1846,8.0,-375
"Cumberland County, TN",TN,2013,23517,21340,2177,9.3,-290
"Cumberland County, TN",TN,2012,23807,21627,2180,9.2,30
"Cumberland County, TN",TN,2011,23777,21328,2449,10.3,671
"Cumberland County, TN",TN,2010,23106,20583,2523,10.9,0
"Cumberland County, VA",VA,2021,4537,4343,194,4.3,-66
"Cumberland County, VA",VA,2020,4603,4325,278,6.0,-123
"Cumberland County, VA",VA,2019,4726,4585,141,3.0,32
"Cumberland County, VA",VA,2018,4694,4543,151,3.2,-37
"Cumberland County, VA",VA,2017,4731,4536,195,4.1,122
"Cumberland County, VA",VA,2016,4609,4400,209,4.5,36
"Cumberland County, VA",VA,2015,4573,4341,232,5.1,20
"Cumberland County, VA",VA,2014,4553,4279,274,6.0,45
"Cumberland County, VA",VA,2013,4508,4215,293,6.5,-12
"Cumberland County, VA",VA,2012,4520,4204,316,7.0,-32
"Cumberland County, VA",VA,2011,4552,4206,346,7.6,22
"Cumberland County, VA",VA,2010,4530,4139,391,8.6,0
"Cuming County, NE",NE,2021,4939,4857,82,1.7,49
"Cuming County, NE",NE,2020,4890,4769,121,2.5,89
"Cuming County, NE",NE,2019,4801,4677,124,2.6,63
"Cuming County, NE",NE,2018,4738,4617,121,2.6,-36
"Cuming County, NE",NE,2017,4774,4643,131,2.7,32
"Cuming County, NE",NE,2016,4742,4606,136,2.9,-116
"Cuming County, NE",NE,2015,4858,4730,128,2.6,-94
"Cuming County, NE",NE,2014,4952,4823,129,2.6,7
"Cuming County, NE",NE,2013,4945,4798,147,3.0,40
"Cuming County, NE",NE,2012,4905,4758,147,3.0,-20
"Cuming County, NE",NE,2011,4925,4757,168,3.4,69
"Cuming County, NE",NE,2010,4856,4675,181,3.7,0
"Currituck County, NC",NC,2021,14215,13632,583,4.1,160
"Currituck County, NC",NC,2020,14055,13214,841,6.0,-150
"Currituck County, NC",NC,2019,14205,13707,498,3.5,405
"Currituck County, NC",NC,2018,13800,13300,500,3.6,412
"Currituck County, NC",NC,2017,13388,12806,582,4.3,277
"Currituck County, NC",NC,2016,13111,12446,665,5.1,278
"Currituck County, NC",NC,2015,12833,12099,734,5.7,121
"Currituck County, NC",NC,2014,12712,11935,777,6.1,84
"Currituck County, NC",NC,2013,12628,11660,968,7.7,62
"Currituck County, NC",NC,2012,12566,11464,1102,8.8,149
"Currituck County, NC",NC,2011,12417,11293,1124,9.1,181
"Currituck County, NC",NC,2010,12236,11158,1078,8.8,0
"Curry County, NM",NM,2021,22066,20979,1087,4.9,156
"Curry County, NM",NM,2020,21910,20749,1161,5.3,41
"Curry County, NM",NM,2019,21869,20955,914,4.2,58
"Curry County, NM",NM,2018,21811,20941,870,4.0,-713
"Curry County, NM",NM,2017,22524,21457,1067,4.7,388
"Curry County, NM",NM,2016,22136,21004,1132,5.1,93
"Curry County, NM",NM,2015,22043,20954,1089,4.9,229
"Curry County, NM",NM,2014,21814,20723,1091,5.0,258
"Curry County, NM",NM,2013,21556,20457,1099,5.1,-58
"Curry County, NM",NM,2012,21614,20565,1049,4.9,235
"Curry County, NM",NM,2011,21379,20337,1042,4.9,-64
"Curry County, NM",NM,2010,21443,20344,1099,5.1,0
"Curry County, OR",OR,2021,9158,8546,612,6.7,197
"Curry County, OR",OR,2020,8961,8183,778,8.7,105
"Curry County, OR",OR,2019,8856,8403,453,5.1,-22
"Curry County, OR",OR,2018,8878,8355,523,5.9,-28
"Curry County, OR",OR,2017,8906,8374,532,6.0,-113
"Curry County, OR",OR,2016,9019,8421,598,6.6,307
"Curry County, OR",OR,2015,8712,8011,701,8.0,41
"Curry County, OR",OR,2014,8671,7809,862,9.9,-28
"Curry County, OR",OR,2013,8699,7787,912,10.5,-304
"Curry County, OR",OR,2012,9003,7944,1059,11.8,-222
"Curry County, OR",OR,2011,9225,8105,1120,12.1,-207
"Curry County, OR",OR,2010,9432,8232,1200,12.7,0
"Custer County, CO",CO,2021,2325,2232,93,4.0,240
"Custer County, CO",CO,2020,2085,1986,99,4.7,40
"Custer County, CO",CO,2019,2045,1987,58,2.8,-17
"Custer County, CO",CO,2018,2062,1992,70,3.4,47
"Custer County, CO",CO,2017,2015,1958,57,2.8,-4
"Custer County, CO",CO,2016,2019,1958,61,3.0,31
"Custer County, CO",CO,2015,1988,1921,67,3.4,9
"Custer County, CO",CO,2014,1979,1888,91,4.6,59
"Custer County, CO",CO,2013,1920,1799,121,6.3,-61
"Custer County, CO",CO,2012,1981,1853,128,6.5,-31
"Custer County, CO",CO,2011,2012,1879,133,6.6,-58
"Custer County, CO",CO,2010,2070,1925,145,7.0,0
"Custer County, ID",ID,2021,2279,2173,106,4.7,40
"Custer County, ID",ID,2020,2239,2125,114,5.1,-1
"Custer County, ID",ID,2019,2240,2145,95,4.2,44
"Custer County, ID",ID,2018,2196,2107,89,4.1,22
"Custer County, ID",ID,2017,2174,2081,93,4.3,36
"Custer County, ID",ID,2016,2138,2033,105,4.9,11
"Custer County, ID",ID,2015,2127,1996,131,6.2,2
"Custer County, ID",ID,2014,2125,1991,134,6.3,-109
"Custer County, ID",ID,2013,2234,2027,207,9.3,-111
"Custer County, ID",ID,2012,2345,2150,195,8.3,48
"Custer County, ID",ID,2011,2297,2119,178,7.7,0
"Custer County, ID",ID,2010,2297,2114,183,8.0,0
"Custer County, MT",MT,2021,6217,6025,192,3.1,-8
"Custer County, MT",MT,2020,6225,5931,294,4.7,93
"Custer County, MT",MT,2019,6132,5953,179,2.9,9
"Custer County, MT",MT,2018,6123,5934,189,3.1,-75
"Custer County, MT",MT,2017,6198,6000,198,3.2,-37
"Custer County, MT",MT,2016,6235,6007,228,3.7,-155
"Custer County, MT",MT,2015,6390,6174,216,3.4,-203
"Custer County, MT",MT,2014,6593,6381,212,3.2,-46
"Custer County, MT",MT,2013,6639,6419,220,3.3,96
"Custer County, MT",MT,2012,6543,6316,227,3.5,169
"Custer County, MT",MT,2011,6374,6126,248,3.9,-33
"Custer County, MT",MT,2010,6407,6121,286,4.5,0
"Custer County, NE",NE,2021,6421,6319,102,1.6,-7
"Custer County, NE",NE,2020,6428,6257,171,2.7,-58
"Custer County, NE",NE,2019,6486,6332,154,2.4,0
"Custer County, NE",NE,2018,6486,6345,141,2.2,42
"Custer County, NE",NE,2017,6444,6303,141,2.2,57
"Custer County, NE",NE,2016,6387,6238,149,2.3,78
"Custer County, NE",NE,2015,6309,6169,140,2.2,171
"Custer County, NE",NE,2014,6138,5991,147,2.4,-5
"Custer County, NE",NE,2013,6143,5976,167,2.7,45
"Custer County, NE",NE,2012,6098,5928,170,2.8,48
"Custer County, NE",NE,2011,6050,5843,207,3.4,73
"Custer County, NE",NE,2010,5977,5753,224,3.7,0
"Custer County, OK",OK,2021,15179,14686,493,3.2,160
"Custer County, OK",OK,2020,15019,14197,822,5.5,-544
"Custer County, OK",OK,2019,15563,15186,377,2.4,-56
"Custer County, OK",OK,2018,15619,15253,366,2.3,253
"Custer County, OK",OK,2017,15366,14896,470,3.1,185
"Custer County, OK",OK,2016,15181,14514,667,4.4,-465
"Custer County, OK",OK,2015,15646,15028,618,3.9,-256
"Custer County, OK",OK,2014,15902,15425,477,3.0,-104
"Custer County, OK",OK,2013,16006,15434,572,3.6,383
"Custer County, OK",OK,2012,15623,15083,540,3.5,475
"Custer County, OK",OK,2011,15148,14569,579,3.8,1002
"Custer County, OK",OK,2010,14146,13446,700,4.9,0
"Custer County, SD",SD,2021,4119,3954,165,4.0,93
"Custer County, SD",SD,2020,4026,3796,230,5.7,-25
"Custer County, SD",SD,2019,4051,3897,154,3.8,67
"Custer County, SD",SD,2018,3984,3834,150,3.8,-43
"Custer County, SD",SD,2017,4027,3867,160,4.0,13
"Custer County, SD",SD,2016,4014,3852,162,4.0,27
"Custer County, SD",SD,2015,3987,3821,166,4.2,-11
"Custer County, SD",SD,2014,3998,3821,177,4.4,-53
"Custer County, SD",SD,2013,4051,3849,202,5.0,-5
"Custer County, SD",SD,2012,4056,3850,206,5.1,-62
"Custer County, SD",SD,2011,4118,3894,224,5.4,29
"Custer County, SD",SD,2010,4089,3854,235,5.7,0
"Cuyahoga County, OH",OH,2021,595326,556610,38716,6.5,-1765
"Cuyahoga County, OH",OH,2020,597091,533399,63692,10.7,-28885
"Cuyahoga County, OH",OH,2019,625976,599034,26942,4.3,3318
"Cuyahoga County, OH",OH,2018,622658,592290,30368,4.9,-725
"Cuyahoga County, OH",OH,2017,623383,587517,35866,5.8,11223
"Cuyahoga County, OH",OH,2016,612160,578168,33992,5.6,3098
"Cuyahoga County, OH",OH,2015,609062,577370,31692,5.2,-6503
"Cuyahoga County, OH",OH,2014,615565,576999,38566,6.3,-2354
"Cuyahoga County, OH",OH,2013,617919,574381,43538,7.0,-3893
"Cuyahoga County, OH",OH,2012,621812,579379,42433,6.8,-10559
"Cuyahoga County, OH",OH,2011,632371,584368,48003,7.6,-9615
"Cuyahoga County, OH",OH,2010,641986,586904,55082,8.6,0
"Dade County, GA",GA,2021,8049,7839,210,2.6,265
"Dade County, GA",GA,2020,7784,7463,321,4.1,-353
"Dade County, GA",GA,2019,8137,7858,279,3.4,-101
"Dade County, GA",GA,2018,8238,7933,305,3.7,-49
"Dade County, GA",GA,2017,8287,7921,366,4.4,269
"Dade County, GA",GA,2016,8018,7607,411,5.1,257
"Dade County, GA",GA,2015,7761,7329,432,5.6,-112
"Dade County, GA",GA,2014,7873,7375,498,6.3,-244
"Dade County, GA",GA,2013,8117,7543,574,7.1,-241
"Dade County, GA",GA,2012,8358,7731,627,7.5,9
"Dade County, GA",GA,2011,8349,7689,660,7.9,-20
"Dade County, GA",GA,2010,8369,7634,735,8.8,0
"Dade County, MO",MO,2021,3544,3427,117,3.3,-5
"Dade County, MO",MO,2020,3549,3396,153,4.3,25
"Dade County, MO",MO,2019,3524,3419,105,3.0,-37
"Dade County, MO",MO,2018,3561,3466,95,2.7,-9
"Dade County, MO",MO,2017,3570,3449,121,3.4,-13
"Dade County, MO",MO,2016,3583,3423,160,4.5,34
"Dade County, MO",MO,2015,3549,3364,185,5.2,53
"Dade County, MO",MO,2014,3496,3285,211,6.0,56
"Dade County, MO",MO,2013,3440,3203,237,6.9,96
"Dade County, MO",MO,2012,3344,3086,258,7.7,-74
"Dade County, MO",MO,2011,3418,3093,325,9.5,31
"Dade County, MO",MO,2010,3387,3060,327,9.7,0
"Daggett County, UT",UT,2021,415,400,15,3.6,3
"Daggett County, UT",UT,2020,412,393,19,4.6,20
"Daggett County, UT",UT,2019,392,377,15,3.8,-10
"Daggett County, UT",UT,2018,402,385,17,4.2,-29
"Daggett County, UT",UT,2017,431,410,21,4.9,-30
"Daggett County, UT",UT,2016,461,438,23,5.0,-3
"Daggett County, UT",UT,2015,464,443,21,4.5,37
"Daggett County, UT",UT,2014,427,410,17,4.0,4
"Daggett County, UT",UT,2013,423,404,19,4.5,-5
"Daggett County, UT",UT,2012,428,409,19,4.4,-40
"Daggett County, UT",UT,2011,468,438,30,6.4,-24
"Daggett County, UT",UT,2010,492,456,36,7.3,0
"Dakota County, MN",MN,2021,237756,230287,7469,3.1,-7390
"Dakota County, MN",MN,2020,245146,229690,15456,6.3,-619
"Dakota County, MN",MN,2019,245765,238218,7547,3.1,4343
"Dakota County, MN",MN,2018,241422,234826,6596,2.7,2296
"Dakota County, MN",MN,2017,239126,231802,7324,3.1,4185
"Dakota County, MN",MN,2016,234941,226978,7963,3.4,2131
"Dakota County, MN",MN,2015,232810,224956,7854,3.4,797
"Dakota County, MN",MN,2014,232013,223040,8973,3.9,2064
"Dakota County, MN",MN,2013,229949,219363,10586,4.6,1669
"Dakota County, MN",MN,2012,228280,216288,11992,5.3,-138
"Dakota County, MN",MN,2011,228418,214573,13845,6.1,1014
"Dakota County, MN",MN,2010,227404,211524,15880,7.0,0
"Dakota County, NE",NE,2021,10823,10494,329,3.0,107
"Dakota County, NE",NE,2020,10716,10212,504,4.7,-146
"Dakota County, NE",NE,2019,10862,10441,421,3.9,75
"Dakota County, NE",NE,2018,10787,10395,392,3.6,54
"Dakota County, NE",NE,2017,10733,10292,441,4.1,-236
"Dakota County, NE",NE,2016,10969,10515,454,4.1,-69
"Dakota County, NE",NE,2015,11038,10649,389,3.5,-16
"Dakota County, NE",NE,2014,11054,10645,409,3.7,-120
"Dakota County, NE",NE,2013,11174,10661,513,4.6,7
"Dakota County, NE",NE,2012,11167,10539,628,5.6,149
"Dakota County, NE",NE,2011,11018,10369,649,5.9,-272
"Dakota County, NE",NE,2010,11290,10447,843,7.5,0
"Dale County, AL",AL,2021,20915,20257,658,3.1,-13
"Dale County, AL",AL,2020,20928,19793,1135,5.4,8
"Dale County, AL",AL,2019,20920,20232,688,3.3,442
"Dale County, AL",AL,2018,20478,19627,851,4.2,312
"Dale County, AL",AL,2017,20166,19243,923,4.6,370
"Dale County, AL",AL,2016,19796,18648,1148,5.8,7
"Dale County, AL",AL,2015,19789,18524,1265,6.4,-562
"Dale County, AL",AL,2014,20351,18919,1432,7.0,-381
"Dale County, AL",AL,2013,20732,19180,1552,7.5,-656
"Dale County, AL",AL,2012,21388,19757,1631,7.6,-632
"Dale County, AL",AL,2011,22020,20197,1823,8.3,-79
"Dale County, AL",AL,2010,22099,20167,1932,8.7,0
"Dallam County, TX",TX,2021,3803,3703,100,2.6,95
"Dallam County, TX",TX,2020,3708,3606,102,2.8,-184
"Dallam County, TX",TX,2019,3892,3815,77,2.0,-109
"Dallam County, TX",TX,2018,4001,3919,82,2.0,-28
"Dallam County, TX",TX,2017,4029,3942,87,2.2,28
"Dallam County, TX",TX,2016,4001,3912,89,2.2,-7
"Dallam County, TX",TX,2015,4008,3920,88,2.2,112
"Dallam County, TX",TX,2014,3896,3780,116,3.0,6
"Dallam County, TX",TX,2013,3890,3753,137,3.5,-122
"Dallam County, TX",TX,2012,4012,3865,147,3.7,-36
"Dallam County, TX",TX,2011,4048,3865,183,4.5,163
"Dallam County, TX",TX,2010,3885,3677,208,5.4,0
"Dallas County, AL",AL,2021,13959,12924,1035,7.4,-877
"Dallas County, AL",AL,2020,14836,13091,1745,11.8,-61
"Dallas County, AL",AL,2019,14897,14044,853,5.7,-146
"Dallas County, AL",AL,2018,15043,14073,970,6.4,-168
"Dallas County, AL",AL,2017,15211,14046,1165,7.7,-82
"Dallas County, AL",AL,2016,15293,13880,1413,9.2,-262
"Dallas County, AL",AL,2015,15555,14056,1499,9.6,-471
"Dallas County, AL",AL,2014,16026,14234,1792,11.2,-264
"Dallas County, AL",AL,2013,16290,14270,2020,12.4,-490
"Dallas County, AL",AL,2012,16780,14565,2215,13.2,-713
"Dallas County, AL",AL,2011,17493,14874,2619,15.0,-289
"Dallas County, AL",AL,2010,17782,14839,2943,16.6,0
"Dallas County, AR",AR,2021,2770,2657,113,4.1,-51
"Dallas County, AR",AR,2020,2821,2669,152,5.4,-6
"Dallas County, AR",AR,2019,2827,2699,128,4.5,-18
"Dallas County, AR",AR,2018,2845,2727,118,4.1,-74
"Dallas County, AR",AR,2017,2919,2790,129,4.4,-68
"Dallas County, AR",AR,2016,2987,2842,145,4.9,0
"Dallas County, AR",AR,2015,2987,2782,205,6.9,-14
"Dallas County, AR",AR,2014,3001,2737,264,8.8,-53
"Dallas County, AR",AR,2013,3054,2742,312,10.2,-249
"Dallas County, AR",AR,2012,3303,2951,352,10.7,-106
"Dallas County, AR",AR,2011,3409,3017,392,11.5,-193
"Dallas County, AR",AR,2010,3602,3187,415,11.5,0
"Dallas County, IA",IA,2021,51851,50351,1500,2.9,744
"Dallas County, IA",IA,2020,51107,49331,1776,3.5,-1037
"Dallas County, IA",IA,2019,52144,51183,961,1.8,2777
"Dallas County, IA",IA,2018,49367,48520,847,1.7,1993
"Dallas County, IA",IA,2017,47374,46381,993,2.1,1315
"Dallas County, IA",IA,2016,46059,44856,1203,2.6,2377
"Dallas County, IA",IA,2015,43682,42443,1239,2.8,969
"Dallas County, IA",IA,2014,42713,41312,1401,3.3,1758
"Dallas County, IA",IA,2013,40955,39477,1478,3.6,1632
"Dallas County, IA",IA,2012,39323,37779,1544,3.9,949
"Dallas County, IA",IA,2011,38374,36706,1668,4.3,1184
"Dallas County, IA",IA,2010,37190,35464,1726,4.6,0
"Dallas County, MO",MO,2021,7177,6865,312,4.3,100
"Dallas County, MO",MO,2020,7077,6665,412,5.8,34
"Dallas County, MO",MO,2019,7043,6743,300,4.3,102
"Dallas County, MO",MO,2018,6941,6669,272,3.9,10
"Dallas County, MO",MO,2017,6931,6607,324,4.7,-16
"Dallas County, MO",MO,2016,6947,6567,380,5.5,10
"Dallas County, MO",MO,2015,6937,6497,440,6.3,-5
"Dallas County, MO",MO,2014,6942,6411,531,7.6,1
"Dallas County, MO",MO,2013,6941,6336,605,8.7,-125
"Dallas County, MO",MO,2012,7066,6403,663,9.4,-129
"Dallas County, MO",MO,2011,7195,6386,809,11.2,-57
"Dallas County, MO",MO,2010,7252,6347,905,12.5,0
"Dallas County, TX",TX,2021,1372277,1295698,76579,5.6,49671
"Dallas County, TX",TX,2020,1322606,1219627,102979,7.8,-5859
"Dallas County, TX",TX,2019,1328465,1281824,46641,3.5,4515
"Dallas County, TX",TX,2018,1323950,1273283,50667,3.8,6889
"Dallas County, TX",TX,2017,1317061,1264990,52071,4.0,17927
"Dallas County, TX",TX,2016,1299134,1246814,52320,4.0,35820
"Dallas County, TX",TX,2015,1263314,1208806,54508,4.3,14038
"Dallas County, TX",TX,2014,1249276,1180636,68640,5.5,16764
"Dallas County, TX",TX,2013,1232512,1150663,81849,6.6,12202
"Dallas County, TX",TX,2012,1220310,1133951,86359,7.1,8370
"Dallas County, TX",TX,2011,1211940,1110079,101861,8.4,16257
"Dallas County, TX",TX,2010,1195683,1092540,103143,8.6,0
"Dane County, WI",WI,2021,331664,322279,9385,2.8,7132
"Dane County, WI",WI,2020,324532,308816,15716,4.8,-1353
"Dane County, WI",WI,2019,325885,318339,7546,2.3,4775
"Dane County, WI",WI,2018,321110,313959,7151,2.2,-377
"Dane County, WI",WI,2017,321487,313791,7696,2.4,4495
"Dane County, WI",WI,2016,316992,308144,8848,2.8,6904
"Dane County, WI",WI,2015,310088,300430,9658,3.1,4646
"Dane County, WI",WI,2014,305442,294301,11141,3.6,4340
"Dane County, WI",WI,2013,301102,287097,14005,4.7,3907
"Dane County, WI",WI,2012,297195,282929,14266,4.8,2388
"Dane County, WI",WI,2011,294807,279539,15268,5.2,1253
"Dane County, WI",WI,2010,293554,276445,17109,5.8,0
"Daniels County, MT",MT,2021,875,858,17,1.9,-16
"Daniels County, MT",MT,2020,891,866,25,2.8,-3
"Daniels County, MT",MT,2019,894,876,18,2.0,3
"Daniels County, MT",MT,2018,891,872,19,2.1,-21
"Daniels County, MT",MT,2017,912,891,21,2.3,-22
"Daniels County, MT",MT,2016,934,909,25,2.7,-10
"Daniels County, MT",MT,2015,944,919,25,2.6,-8
"Daniels County, MT",MT,2014,952,923,29,3.0,18
"Daniels County, MT",MT,2013,934,904,30,3.2,-7
"Daniels County, MT",MT,2012,941,912,29,3.1,-4
"Daniels County, MT",MT,2011,945,913,32,3.4,-3
"Daniels County, MT",MT,2010,948,915,33,3.5,0
"Danville city, VA",VA,2021,18394,17190,1204,6.5,-850
"Danville city, VA",VA,2020,19244,17386,1858,9.7,-116
"Danville city, VA",VA,2019,19360,18402,958,4.9,-403
"Danville city, VA",VA,2018,19763,18770,993,5.0,-354
"Danville city, VA",VA,2017,20117,18991,1126,5.6,992
"Danville city, VA",VA,2016,19125,17984,1141,6.0,-59
"Danville city, VA",VA,2015,19184,17819,1365,7.1,-465
"Danville city, VA",VA,2014,19649,17976,1673,8.5,-140
"Danville city, VA",VA,2013,19789,17895,1894,9.6,-135
"Danville city, VA",VA,2012,19924,17902,2022,10.1,-322
"Danville city, VA",VA,2011,20246,17894,2352,11.6,83
"Danville city, VA",VA,2010,20163,17382,2781,13.8,0
"Dare County, NC",NC,2021,19631,18462,1169,6.0,529
"Dare County, NC",NC,2020,19102,17258,1844,9.7,-795
"Dare County, NC",NC,2019,19897,18976,921,4.6,216
"Dare County, NC",NC,2018,19681,18663,1018,5.2,-143
"Dare County, NC",NC,2017,19824,18659,1165,5.9,-115
"Dare County, NC",NC,2016,19939,18593,1346,6.8,-336
"Dare County, NC",NC,2015,20275,18781,1494,7.4,176
"Dare County, NC",NC,2014,20099,18457,1642,8.2,-456
"Dare County, NC",NC,2013,20555,18323,2232,10.9,-358
"Dare County, NC",NC,2012,20913,18268,2645,12.6,739
"Dare County, NC",NC,2011,20174,17541,2633,13.1,413
"Dare County, NC",NC,2010,19761,17382,2379,12.0,0
"Darke County, OH",OH,2021,25684,24679,1005,3.9,33
"Darke County, OH",OH,2020,25651,23923,1728,6.7,-346
"Darke County, OH",OH,2019,25997,25035,962,3.7,12
"Darke County, OH",OH,2018,25985,24977,1008,3.9,-455
"Darke County, OH",OH,2017,26440,25333,1107,4.2,-37
"Darke County, OH",OH,2016,26477,25380,1097,4.1,175
"Darke County, OH",OH,2015,26302,25168,1134,4.3,95
"Darke County, OH",OH,2014,26207,24811,1396,5.3,-174
"Darke County, OH",OH,2013,26381,24539,1842,7.0,-193
"Darke County, OH",OH,2012,26574,24654,1920,7.2,-3
"Darke County, OH",OH,2011,26577,24123,2454,9.2,-512
"Darke County, OH",OH,2010,27089,24037,3052,11.3,0
"Darlington County, SC",SC,2021,29869,28521,1348,4.5,48
"Darlington County, SC",SC,2020,29821,27944,1877,6.3,127
"Darlington County, SC",SC,2019,29694,28703,991,3.3,267
"Darlington County, SC",SC,2018,29427,28255,1172,4.0,153
"Darlington County, SC",SC,2017,29274,27757,1517,5.2,-536
"Darlington County, SC",SC,2016,29810,27993,1817,6.1,-232
"Darlington County, SC",SC,2015,30042,27849,2193,7.3,313
"Darlington County, SC",SC,2014,29729,27421,2308,7.8,-438
"Darlington County, SC",SC,2013,30167,27421,2746,9.1,-279
"Darlington County, SC",SC,2012,30446,27148,3298,10.8,-129
"Darlington County, SC",SC,2011,30575,26675,3900,12.8,-297
"Darlington County, SC",SC,2010,30872,26741,4131,13.4,0
"Dauphin County, PA",PA,2021,145162,136049,9113,6.3,-1372
"Dauphin County, PA",PA,2020,146534,133508,13026,8.9,459
"Dauphin County, PA",PA,2019,146075,140029,6046,4.1,1844
"Dauphin County, PA",PA,2018,144231,138273,5958,4.1,541
"Dauphin County, PA",PA,2017,143690,137104,6586,4.6,1389
"Dauphin County, PA",PA,2016,142301,135593,6708,4.7,1269
"Dauphin County, PA",PA,2015,141032,134341,6691,4.7,1853
"Dauphin County, PA",PA,2014,139179,131653,7526,5.4,-828
"Dauphin County, PA",PA,2013,140007,130764,9243,6.6,-863
"Dauphin County, PA",PA,2012,140870,130640,10230,7.3,678
"Dauphin County, PA",PA,2011,140192,129789,10403,7.4,30
"Dauphin County, PA",PA,2010,140162,129234,10928,7.8,0
"Davidson County, NC",NC,2021,79091,75503,3588,4.5,1446
"Davidson County, NC",NC,2020,77645,72340,5305,6.8,-2744
"Davidson County, NC",NC,2019,80389,77477,2912,3.6,1121
"Davidson County, NC",NC,2018,79268,76323,2945,3.7,771
"Davidson County, NC",NC,2017,78497,75125,3372,4.3,-761
"Davidson County, NC",NC,2016,79258,75444,3814,4.8,606
"Davidson County, NC",NC,2015,78652,74333,4319,5.5,270
"Davidson County, NC",NC,2014,78382,73589,4793,6.1,-1053
"Davidson County, NC",NC,2013,79435,73107,6328,8.0,-869
"Davidson County, NC",NC,2012,80304,72328,7976,9.9,475
"Davidson County, NC",NC,2011,79829,71042,8787,11.0,-1073
"Davidson County, NC",NC,2010,80902,71050,9852,12.2,0
"Davidson County, TN",TN,2021,404747,387756,16991,4.2,5485
"Davidson County, TN",TN,2020,399262,366706,32556,8.2,-4694
"Davidson County, TN",TN,2019,403956,393666,10290,2.5,9205
"Davidson County, TN",TN,2018,394751,384282,10469,2.7,9660
"Davidson County, TN",TN,2017,385091,374319,10772,2.8,10936
"Davidson County, TN",TN,2016,374155,360601,13554,3.6,9211
"Davidson County, TN",TN,2015,364944,349100,15844,4.3,7963
"Davidson County, TN",TN,2014,356981,339010,17971,5.0,1491
"Davidson County, TN",TN,2013,355490,334535,20955,5.9,2713
"Davidson County, TN",TN,2012,352777,330509,22268,6.3,3667
"Davidson County, TN",TN,2011,349110,322412,26698,7.6,6542
"Davidson County, TN",TN,2010,342568,314127,28441,8.3,0
"Davie County, NC",NC,2021,20130,19269,861,4.3,367
"Davie County, NC",NC,2020,19763,18470,1293,6.5,-694
"Davie County, NC",NC,2019,20457,19772,685,3.3,205
"Davie County, NC",NC,2018,20252,19545,707,3.5,195
"Davie County, NC",NC,2017,20057,19257,800,4.0,-50
"Davie County, NC",NC,2016,20107,19202,905,4.5,279
"Davie County, NC",NC,2015,19828,18843,985,5.0,144
"Davie County, NC",NC,2014,19684,18564,1120,5.7,-316
"Davie County, NC",NC,2013,20000,18542,1458,7.3,-166
"Davie County, NC",NC,2012,20166,18293,1873,9.3,65
"Davie County, NC",NC,2011,20101,17973,2128,10.6,-237
"Davie County, NC",NC,2010,20338,17966,2372,11.7,0
"Daviess County, IN",IN,2021,16405,16030,375,2.3,-144
"Daviess County, IN",IN,2020,16549,15909,640,3.9,-269
"Daviess County, IN",IN,2019,16818,16385,433,2.6,287
"Daviess County, IN",IN,2018,16531,16088,443,2.7,588
"Daviess County, IN",IN,2017,15943,15501,442,2.8,-47
"Daviess County, IN",IN,2016,15990,15432,558,3.5,295
"Daviess County, IN",IN,2015,15695,15104,591,3.8,511
"Daviess County, IN",IN,2014,15184,14507,677,4.5,286
"Daviess County, IN",IN,2013,14898,14072,826,5.5,91
"Daviess County, IN",IN,2012,14807,13930,877,5.9,-123
"Daviess County, IN",IN,2011,14930,14039,891,6.0,162
"Daviess County, IN",IN,2010,14768,13835,933,6.3,0
"Daviess County, KY",KY,2021,46297,44290,2007,4.3,440
"Daviess County, KY",KY,2020,45857,43163,2694,5.9,-1361
"Daviess County, KY",KY,2019,47218,45476,1742,3.7,-222
"Daviess County, KY",KY,2018,47440,45598,1842,3.9,-507
"Daviess County, KY",KY,2017,47947,45896,2051,4.3,1255
"Daviess County, KY",KY,2016,46692,44636,2056,4.4,1094
"Daviess County, KY",KY,2015,45598,43527,2071,4.5,-354
"Daviess County, KY",KY,2014,45952,43358,2594,5.6,-1700
"Daviess County, KY",KY,2013,47652,44408,3244,6.8,-623
"Daviess County, KY",KY,2012,48275,44880,3395,7.0,407
"Daviess County, KY",KY,2011,47868,43877,3991,8.3,747
"Daviess County, KY",KY,2010,47121,42700,4421,9.4,0
"Daviess County, MO",MO,2021,4103,3948,155,3.8,-2
"Daviess County, MO",MO,2020,4105,3933,172,4.2,35
"Daviess County, MO",MO,2019,4070,3941,129,3.2,42
"Daviess County, MO",MO,2018,4028,3909,119,3.0,-40
"Daviess County, MO",MO,2017,4068,3934,134,3.3,-43
"Daviess County, MO",MO,2016,4111,3953,158,3.8,50
"Daviess County, MO",MO,2015,4061,3872,189,4.7,40
"Daviess County, MO",MO,2014,4021,3786,235,5.8,-40
"Daviess County, MO",MO,2013,4061,3806,255,6.3,22
"Daviess County, MO",MO,2012,4039,3750,289,7.2,2
"Daviess County, MO",MO,2011,4037,3671,366,9.1,45
"Daviess County, MO",MO,2010,3992,3604,388,9.7,0
"Davis County, IA",IA,2021,4168,4029,139,3.3,18
"Davis County, IA",IA,2020,4150,3987,163,3.9,-154
"Davis County, IA",IA,2019,4304,4188,116,2.7,33
"Davis County, IA",IA,2018,4271,4157,114,2.7,-34
"Davis County, IA",IA,2017,4305,4164,141,3.3,-6
"Davis County, IA",IA,2016,4311,4130,181,4.2,135
"Davis County, IA",IA,2015,4176,3992,184,4.4,66
"Davis County, IA",IA,2014,4110,3900,210,5.1,-17
"Davis County, IA",IA,2013,4127,3899,228,5.5,20
"Davis County, IA",IA,2012,4107,3870,237,5.8,-100
"Davis County, IA",IA,2011,4207,3945,262,6.2,-39
"Davis County, IA",IA,2010,4246,3936,310,7.3,0
"Davis County, UT",UT,2021,179229,174865,4364,2.4,3006
"Davis County, UT",UT,2020,176223,168939,7284,4.1,1796
"Davis County, UT",UT,2019,174427,170250,4177,2.4,2957
"Davis County, UT",UT,2018,171470,166757,4713,2.7,2109
"Davis County, UT",UT,2017,169361,164325,5036,3.0,5584
"Davis County, UT",UT,2016,163777,158759,5018,3.1,4621
"Davis County, UT",UT,2015,159156,153881,5275,3.3,4593
"Davis County, UT",UT,2014,154563,149286,5277,3.4,4083
"Davis County, UT",UT,2013,150480,144606,5874,3.9,4403
"Davis County, UT",UT,2012,146077,139776,6301,4.3,485
"Davis County, UT",UT,2011,145592,136414,9178,6.3,-715
"Davis County, UT",UT,2010,146307,135943,10364,7.1,0
"Davison County, SD",SD,2021,10891,10589,302,2.8,17
"Davison County, SD",SD,2020,10874,10449,425,3.9,-134
"Davison County, SD",SD,2019,11008,10733,275,2.5,14
"Davison County, SD",SD,2018,10994,10729,265,2.4,-18
"Davison County, SD",SD,2017,11012,10718,294,2.7,-282
"Davison County, SD",SD,2016,11294,11021,273,2.4,-105
"Davison County, SD",SD,2015,11399,11115,284,2.5,32
"Davison County, SD",SD,2014,11367,11055,312,2.7,58
"Davison County, SD",SD,2013,11309,10963,346,3.1,-18
"Davison County, SD",SD,2012,11327,10969,358,3.2,153
"Davison County, SD",SD,2011,11174,10745,429,3.8,196
"Davison County, SD",SD,2010,10978,10499,479,4.4,0
"Dawes County, NE",NE,2021,5020,4925,95,1.9,35
"Dawes County, NE",NE,2020,4985,4850,135,2.7,-59
"Dawes County, NE",NE,2019,5044,4901,143,2.8,-27
"Dawes County, NE",NE,2018,5071,4934,137,2.7,-139
"Dawes County, NE",NE,2017,5210,5066,144,2.8,-33
"Dawes County, NE",NE,2016,5243,5089,154,2.9,-28
"Dawes County, NE",NE,2015,5271,5135,136,2.6,-17
"Dawes County, NE",NE,2014,5288,5134,154,2.9,-123
"Dawes County, NE",NE,2013,5411,5221,190,3.5,6
"Dawes County, NE",NE,2012,5405,5213,192,3.6,-71
"Dawes County, NE",NE,2011,5476,5263,213,3.9,-14
"Dawes County, NE",NE,2010,5490,5269,221,4.0,0
"Dawson County, GA",GA,2021,13115,12765,350,2.7,450
"Dawson County, GA",GA,2020,12665,12082,583,4.6,-75
"Dawson County, GA",GA,2019,12740,12363,377,3.0,451
"Dawson County, GA",GA,2018,12289,11875,414,3.4,298
"Dawson County, GA",GA,2017,11991,11524,467,3.9,661
"Dawson County, GA",GA,2016,11330,10793,537,4.7,512
"Dawson County, GA",GA,2015,10818,10256,562,5.2,39
"Dawson County, GA",GA,2014,10779,10121,658,6.1,10
"Dawson County, GA",GA,2013,10769,9979,790,7.3,-53
"Dawson County, GA",GA,2012,10822,9908,914,8.4,-41
"Dawson County, GA",GA,2011,10863,9769,1094,10.1,-134
"Dawson County, GA",GA,2010,10997,9783,1214,11.0,0
"Dawson County, MT",MT,2021,4511,4371,140,3.1,-159
"Dawson County, MT",MT,2020,4670,4418,252,5.4,11
"Dawson County, MT",MT,2019,4659,4544,115,2.5,-9
"Dawson County, MT",MT,2018,4668,4543,125,2.7,-39
"Dawson County, MT",MT,2017,4707,4560,147,3.1,106
"Dawson County, MT",MT,2016,4601,4418,183,4.0,-221
"Dawson County, MT",MT,2015,4822,4666,156,3.2,-44
"Dawson County, MT",MT,2014,4866,4738,128,2.6,54
"Dawson County, MT",MT,2013,4812,4662,150,3.1,160
"Dawson County, MT",MT,2012,4652,4503,149,3.2,100
"Dawson County, MT",MT,2011,4552,4394,158,3.5,34
"Dawson County, MT",MT,2010,4518,4331,187,4.1,0
"Dawson County, NE",NE,2021,13607,13317,290,2.1,158
"Dawson County, NE",NE,2020,13449,13000,449,3.3,220
"Dawson County, NE",NE,2019,13229,12834,395,3.0,159
"Dawson County, NE",NE,2018,13070,12697,373,2.9,10
"Dawson County, NE",NE,2017,13060,12681,379,2.9,23
"Dawson County, NE",NE,2016,13037,12653,384,2.9,-78
"Dawson County, NE",NE,2015,13115,12700,415,3.2,-225
"Dawson County, NE",NE,2014,13340,12881,459,3.4,110
"Dawson County, NE",NE,2013,13230,12737,493,3.7,-18
"Dawson County, NE",NE,2012,13248,12685,563,4.2,54
"Dawson County, NE",NE,2011,13194,12534,660,5.0,2
"Dawson County, NE",NE,2010,13192,12530,662,5.0,0
"Dawson County, TX",TX,2021,4598,4276,322,7.0,57
"Dawson County, TX",TX,2020,4541,4145,396,8.7,-26
"Dawson County, TX",TX,2019,4567,4389,178,3.9,47
"Dawson County, TX",TX,2018,4520,4324,196,4.3,-77
"Dawson County, TX",TX,2017,4597,4372,225,4.9,-46
"Dawson County, TX",TX,2016,4643,4409,234,5.0,-131
"Dawson County, TX",TX,2015,4774,4556,218,4.6,-118
"Dawson County, TX",TX,2014,4892,4651,241,4.9,-99
"Dawson County, TX",TX,2013,4991,4670,321,6.4,-77
"Dawson County, TX",TX,2012,5068,4745,323,6.4,-152
"Dawson County, TX",TX,2011,5220,4817,403,7.7,77
"Dawson County, TX",TX,2010,5143,4746,397,7.7,0
"Day County, SD",SD,2021,2682,2567,115,4.3,2
"Day County, SD",SD,2020,2680,2537,143,5.3,-41
"Day County, SD",SD,2019,2721,2614,107,3.9,-49
"Day County, SD",SD,2018,2770,2660,110,4.0,-51
"Day County, SD",SD,2017,2821,2715,106,3.8,-52
"Day County, SD",SD,2016,2873,2751,122,4.2,-3
"Day County, SD",SD,2015,2876,2736,140,4.9,-19
"Day County, SD",SD,2014,2895,2745,150,5.2,-44
"Day County, SD",SD,2013,2939,2788,151,5.1,-38
"Day County, SD",SD,2012,2977,2814,163,5.5,-101
"Day County, SD",SD,2011,3078,2883,195,6.3,-10
"Day County, SD",SD,2010,3088,2885,203,6.6,0
"De Baca County, NM",NM,2021,682,647,35,5.1,-12
"De Baca County, NM",NM,2020,694,662,32,4.6,-103
"De Baca County, NM",NM,2019,797,763,34,4.3,25
"De Baca County, NM",NM,2018,772,738,34,4.4,-85
"De Baca County, NM",NM,2017,857,818,39,4.6,18
"De Baca County, NM",NM,2016,839,799,40,4.8,-17
"De Baca County, NM",NM,2015,856,812,44,5.1,11
"De Baca County, NM",NM,2014,845,806,39,4.6,31
"De Baca County, NM",NM,2013,814,777,37,4.5,-10
"De Baca County, NM",NM,2012,824,789,35,4.2,10
"De Baca County, NM",NM,2011,814,774,40,4.9,-13
"De Baca County, NM",NM,2010,827,780,47,5.7,0
"De Soto Parish, LA",LA,2021,10738,10218,520,4.8,50
"De Soto Parish, LA",LA,2020,10688,9864,824,7.7,-285
"De Soto Parish, LA",LA,2019,10973,10341,632,5.8,42
"De Soto Parish, LA",LA,2018,10931,10313,618,5.7,131
"De Soto Parish, LA",LA,2017,10800,10146,654,6.1,-102
"De Soto Parish, LA",LA,2016,10902,10100,802,7.4,-128
"De Soto Parish, LA",LA,2015,11030,10158,872,7.9,-40
"De Soto Parish, LA",LA,2014,11070,10190,880,7.9,65
"De Soto Parish, LA",LA,2013,11005,10071,934,8.5,-230
"De Soto Parish, LA",LA,2012,11235,10270,965,8.6,-30
"De Soto Parish, LA",LA,2011,11265,10359,906,8.0,-114
"De Soto Parish, LA",LA,2010,11379,10434,945,8.3,0
"De Witt County, IL",IL,2021,7094,6748,346,4.9,101
"De Witt County, IL",IL,2020,6993,6523,470,6.7,-469
"De Witt County, IL",IL,2019,7462,7152,310,4.2,-125
"De Witt County, IL",IL,2018,7587,7206,381,5.0,-119
"De Witt County, IL",IL,2017,7706,7343,363,4.7,-269
"De Witt County, IL",IL,2016,7975,7521,454,5.7,-3
"De Witt County, IL",IL,2015,7978,7535,443,5.6,13
"De Witt County, IL",IL,2014,7965,7436,529,6.6,-211
"De Witt County, IL",IL,2013,8176,7497,679,8.3,-305
"De Witt County, IL",IL,2012,8481,7794,687,8.1,-256
"De Witt County, IL",IL,2011,8737,7996,741,8.5,-61
"De Witt County, IL",IL,2010,8798,8022,776,8.8,0
"Deaf Smith County, TX",TX,2021,8749,8429,320,3.7,319
"Deaf Smith County, TX",TX,2020,8430,8126,304,3.6,96
"Deaf Smith County, TX",TX,2019,8334,8106,228,2.7,-9
"Deaf Smith County, TX",TX,2018,8343,8108,235,2.8,56
"Deaf Smith County, TX",TX,2017,8287,8032,255,3.1,-327
"Deaf Smith County, TX",TX,2016,8614,8344,270,3.1,-183
"Deaf Smith County, TX",TX,2015,8797,8518,279,3.2,-296
"Deaf Smith County, TX",TX,2014,9093,8760,333,3.7,-43
"Deaf Smith County, TX",TX,2013,9136,8726,410,4.5,-168
"Deaf Smith County, TX",TX,2012,9304,8869,435,4.7,-317
"Deaf Smith County, TX",TX,2011,9621,9081,540,5.6,106
"Deaf Smith County, TX",TX,2010,9515,8965,550,5.8,0
"Dearborn County, IN",IN,2021,25257,24500,757,3.0,-89
"Dearborn County, IN",IN,2020,25346,23576,1770,7.0,-616
"Dearborn County, IN",IN,2019,25962,25055,907,3.5,61
"Dearborn County, IN",IN,2018,25901,24967,934,3.6,147
"Dearborn County, IN",IN,2017,25754,24769,985,3.8,132
"Dearborn County, IN",IN,2016,25622,24431,1191,4.6,412
"Dearborn County, IN",IN,2015,25210,23925,1285,5.1,84
"Dearborn County, IN",IN,2014,25126,23479,1647,6.6,-86
"Dearborn County, IN",IN,2013,25212,23117,2095,8.3,214
"Dearborn County, IN",IN,2012,24998,22805,2193,8.8,-401
"Dearborn County, IN",IN,2011,25399,22997,2402,9.5,-131
"Dearborn County, IN",IN,2010,25530,22826,2704,10.6,0
"Decatur County, GA",GA,2021,11338,10923,415,3.7,18
"Decatur County, GA",GA,2020,11320,10778,542,4.8,-364
"Decatur County, GA",GA,2019,11684,11227,457,3.9,156
"Decatur County, GA",GA,2018,11528,10981,547,4.7,-245
"Decatur County, GA",GA,2017,11773,11115,658,5.6,297
"Decatur County, GA",GA,2016,11476,10703,773,6.7,211
"Decatur County, GA",GA,2015,11265,10486,779,6.9,-94
"Decatur County, GA",GA,2014,11359,10430,929,8.2,-201
"Decatur County, GA",GA,2013,11560,10469,1091,9.4,-641
"Decatur County, GA",GA,2012,12201,10984,1217,10.0,162
"Decatur County, GA",GA,2011,12039,10608,1431,11.9,-443
"Decatur County, GA",GA,2010,12482,10910,1572,12.6,0
"Decatur County, IA",IA,2021,4271,4128,143,3.3,40
"Decatur County, IA",IA,2020,4231,4073,158,3.7,-226
"Decatur County, IA",IA,2019,4457,4363,94,2.1,62
"Decatur County, IA",IA,2018,4395,4296,99,2.3,75
"Decatur County, IA",IA,2017,4320,4207,113,2.6,-108
"Decatur County, IA",IA,2016,4428,4287,141,3.2,-1
"Decatur County, IA",IA,2015,4429,4285,144,3.3,-11
"Decatur County, IA",IA,2014,4440,4272,168,3.8,133
"Decatur County, IA",IA,2013,4307,4113,194,4.5,46
"Decatur County, IA",IA,2012,4261,4071,190,4.5,-100
"Decatur County, IA",IA,2011,4361,4140,221,5.1,-94
"Decatur County, IA",IA,2010,4455,4180,275,6.2,0
"Decatur County, IN",IN,2021,14786,14368,418,2.8,-170
"Decatur County, IN",IN,2020,14956,13821,1135,7.6,-561
"Decatur County, IN",IN,2019,15517,15089,428,2.8,553
"Decatur County, IN",IN,2018,14964,14522,442,3.0,265
"Decatur County, IN",IN,2017,14699,14273,426,2.9,128
"Decatur County, IN",IN,2016,14571,14059,512,3.5,280
"Decatur County, IN",IN,2015,14291,13713,578,4.0,102
"Decatur County, IN",IN,2014,14189,13494,695,4.9,304
"Decatur County, IN",IN,2013,13885,12974,911,6.6,292
"Decatur County, IN",IN,2012,13593,12508,1085,8.0,552
"Decatur County, IN",IN,2011,13041,11791,1250,9.6,124
"Decatur County, IN",IN,2010,12917,11452,1465,11.3,0
"Decatur County, KS",KS,2021,1205,1174,31,2.6,-19
"Decatur County, KS",KS,2020,1224,1182,42,3.4,-19
"Decatur County, KS",KS,2019,1243,1206,37,3.0,-16
"Decatur County, KS",KS,2018,1259,1223,36,2.9,-28
"Decatur County, KS",KS,2017,1287,1247,40,3.1,-11
"Decatur County, KS",KS,2016,1298,1247,51,3.9,-56
"Decatur County, KS",KS,2015,1354,1305,49,3.6,-1
"Decatur County, KS",KS,2014,1355,1308,47,3.5,-9
"Decatur County, KS",KS,2013,1364,1310,54,4.0,-42
"Decatur County, KS",KS,2012,1406,1344,62,4.4,-17
"Decatur County, KS",KS,2011,1423,1355,68,4.8,-34
"Decatur County, KS",KS,2010,1457,1385,72,4.9,0
"Decatur County, TN",TN,2021,4308,4061,247,5.7,-134
"Decatur County, TN",TN,2020,4442,4062,380,8.6,-123
"Decatur County, TN",TN,2019,4565,4319,246,5.4,61
"Decatur County, TN",TN,2018,4504,4278,226,5.0,-171
"Decatur County, TN",TN,2017,4675,4431,244,5.2,12
"Decatur County, TN",TN,2016,4663,4341,322,6.9,-58
"Decatur County, TN",TN,2015,4721,4352,369,7.8,-85
"Decatur County, TN",TN,2014,4806,4346,460,9.6,-295
"Decatur County, TN",TN,2013,5101,4561,540,10.6,-108
"Decatur County, TN",TN,2012,5209,4663,546,10.5,-111
"Decatur County, TN",TN,2011,5320,4692,628,11.8,14
"Decatur County, TN",TN,2010,5306,4598,708,13.3,0
"Deer Lodge County, MT",MT,2021,5094,4928,166,3.3,21
"Deer Lodge County, MT",MT,2020,5073,4820,253,5.0,-59
"Deer Lodge County, MT",MT,2019,5132,4964,168,3.3,-40
"Deer Lodge County, MT",MT,2018,5172,4987,185,3.6,4
"Deer Lodge County, MT",MT,2017,5168,4981,187,3.6,-128
"Deer Lodge County, MT",MT,2016,5296,5087,209,3.9,58
"Deer Lodge County, MT",MT,2015,5238,5024,214,4.1,-2
"Deer Lodge County, MT",MT,2014,5240,5012,228,4.4,27
"Deer Lodge County, MT",MT,2013,5213,4959,254,4.9,24
"Deer Lodge County, MT",MT,2012,5189,4910,279,5.4,34
"Deer Lodge County, MT",MT,2011,5155,4851,304,5.9,-30
"Deer Lodge County, MT",MT,2010,5185,4873,312,6.0,0
"Defiance County, OH",OH,2021,17564,16739,825,4.7,-162
"Defiance County, OH",OH,2020,17726,16274,1452,8.2,-467
"Defiance County, OH",OH,2019,18193,17413,780,4.3,-97
"Defiance County, OH",OH,2018,18290,17485,805,4.4,-215
"Defiance County, OH",OH,2017,18505,17608,897,4.8,52
"Defiance County, OH",OH,2016,18453,17536,917,5.0,-283
"Defiance County, OH",OH,2015,18736,17806,930,5.0,-268
"Defiance County, OH",OH,2014,19004,17961,1043,5.5,78
"Defiance County, OH",OH,2013,18926,17510,1416,7.5,-70
"Defiance County, OH",OH,2012,18996,17542,1454,7.7,-194
"Defiance County, OH",OH,2011,19190,17343,1847,9.6,-809
"Defiance County, OH",OH,2010,19999,17560,2439,12.2,0
"DeKalb County, AL",AL,2021,31097,30308,789,2.5,-192
"DeKalb County, AL",AL,2020,31289,29721,1568,5.0,-338
"DeKalb County, AL",AL,2019,31627,30695,932,2.9,1011
"DeKalb County, AL",AL,2018,30616,29457,1159,3.8,701
"DeKalb County, AL",AL,2017,29915,28541,1374,4.6,919
"DeKalb County, AL",AL,2016,28996,27232,1764,6.1,296
"DeKalb County, AL",AL,2015,28700,26949,1751,6.1,-297
"DeKalb County, AL",AL,2014,28997,27014,1983,6.8,-14
"DeKalb County, AL",AL,2013,29011,26768,2243,7.7,143
"DeKalb County, AL",AL,2012,28868,26193,2675,9.3,-910
"DeKalb County, AL",AL,2011,29778,26292,3486,11.7,-1140
"DeKalb County, AL",AL,2010,30918,27084,3834,12.4,0
"DeKalb County, GA",GA,2021,400667,382143,18524,4.6,7206
"DeKalb County, GA",GA,2020,393461,362325,31136,7.9,-5006
"DeKalb County, GA",GA,2019,398467,384029,14438,3.6,-62
"DeKalb County, GA",GA,2018,398529,382178,16351,4.1,-491
"DeKalb County, GA",GA,2017,399020,379705,19315,4.8,16289
"DeKalb County, GA",GA,2016,382731,361823,20908,5.5,13868
"DeKalb County, GA",GA,2015,368863,346210,22653,6.1,665
"DeKalb County, GA",GA,2014,368198,341429,26769,7.3,41
"DeKalb County, GA",GA,2013,368157,337355,30802,8.4,-657
"DeKalb County, GA",GA,2012,368814,334647,34167,9.3,3010
"DeKalb County, GA",GA,2011,365804,327592,38212,10.4,1831
"DeKalb County, GA",GA,2010,363973,324087,39886,11.0,0
"DeKalb County, IL",IL,2021,53006,50012,2994,5.6,152
"DeKalb County, IL",IL,2020,52854,48449,4405,8.3,-2836
"DeKalb County, IL",IL,2019,55690,53508,2182,3.9,325
"DeKalb County, IL",IL,2018,55365,52946,2419,4.4,456
"DeKalb County, IL",IL,2017,54909,52362,2547,4.6,-509
"DeKalb County, IL",IL,2016,55418,52454,2964,5.3,577
"DeKalb County, IL",IL,2015,54841,51776,3065,5.6,-249
"DeKalb County, IL",IL,2014,55090,51463,3627,6.6,213
"DeKalb County, IL",IL,2013,54877,50409,4468,8.1,-584
"DeKalb County, IL",IL,2012,55461,50748,4713,8.5,-317
"DeKalb County, IL",IL,2011,55778,50556,5222,9.4,-527
"DeKalb County, IL",IL,2010,56305,50323,5982,10.6,0
"DeKalb County, IN",IN,2021,22028,21434,594,2.7,-183
"DeKalb County, IN",IN,2020,22211,20670,1541,6.9,-535
"DeKalb County, IN",IN,2019,22746,22111,635,2.8,218
"DeKalb County, IN",IN,2018,22528,21896,632,2.8,262
"DeKalb County, IN",IN,2017,22266,21621,645,2.9,9
"DeKalb County, IN",IN,2016,22257,21397,860,3.9,476
"DeKalb County, IN",IN,2015,21781,20891,890,4.1,513
"DeKalb County, IN",IN,2014,21268,20164,1104,5.2,289
"DeKalb County, IN",IN,2013,20979,19505,1474,7.0,390
"DeKalb County, IN",IN,2012,20589,18894,1695,8.2,58
"DeKalb County, IN",IN,2011,20531,18581,1950,9.5,-60
"DeKalb County, IN",IN,2010,20591,18197,2394,11.6,0
"DeKalb County, MO",MO,2021,4167,4010,157,3.8,-35
"DeKalb County, MO",MO,2020,4202,4014,188,4.5,-606
"DeKalb County, MO",MO,2019,4808,4668,140,2.9,-31
"DeKalb County, MO",MO,2018,4839,4691,148,3.1,-58
"DeKalb County, MO",MO,2017,4897,4708,189,3.9,-180
"DeKalb County, MO",MO,2016,5077,4856,221,4.4,59
"DeKalb County, MO",MO,2015,5018,4780,238,4.7,64
"DeKalb County, MO",MO,2014,4954,4684,270,5.5,-71
"DeKalb County, MO",MO,2013,5025,4720,305,6.1,8
"DeKalb County, MO",MO,2012,5017,4710,307,6.1,10
"DeKalb County, MO",MO,2011,5007,4601,406,8.1,5
"DeKalb County, MO",MO,2010,5002,4565,437,8.7,0
"DeKalb County, TN",TN,2021,7758,7409,349,4.5,83
"DeKalb County, TN",TN,2020,7675,6981,694,9.0,-141
"DeKalb County, TN",TN,2019,7816,7474,342,4.4,48
"DeKalb County, TN",TN,2018,7768,7420,348,4.5,97
"DeKalb County, TN",TN,2017,7671,7302,369,4.8,118
"DeKalb County, TN",TN,2016,7553,7131,422,5.6,173
"DeKalb County, TN",TN,2015,7380,6877,503,6.8,-89
"DeKalb County, TN",TN,2014,7469,6856,613,8.2,-262
"DeKalb County, TN",TN,2013,7731,6951,780,10.1,-306
"DeKalb County, TN",TN,2012,8037,7251,786,9.8,-173
"DeKalb County, TN",TN,2011,8210,7282,928,11.3,41
"DeKalb County, TN",TN,2010,8169,7198,971,11.9,0
"Del Norte County, CA",CA,2021,9314,8606,708,7.6,-100
"Del Norte County, CA",CA,2020,9414,8497,917,9.7,-221
"Del Norte County, CA",CA,2019,9635,9070,565,5.9,-77
"Del Norte County, CA",CA,2018,9712,9152,560,5.8,16
"Del Norte County, CA",CA,2017,9696,9068,628,6.5,-59
"Del Norte County, CA",CA,2016,9755,9019,736,7.5,-101
"Del Norte County, CA",CA,2015,9856,9009,847,8.6,-59
"Del Norte County, CA",CA,2014,9915,8905,1010,10.2,-383
"Del Norte County, CA",CA,2013,10298,9064,1234,12.0,-183
"Del Norte County, CA",CA,2012,10481,9040,1441,13.7,-401
"Del Norte County, CA",CA,2011,10882,9409,1473,13.5,-62
"Del Norte County, CA",CA,2010,10944,9465,1479,13.5,0
"Delaware County, IA",IA,2021,10412,10067,345,3.3,-58
"Delaware County, IA",IA,2020,10470,10065,405,3.9,-336
"Delaware County, IA",IA,2019,10806,10566,240,2.2,221
"Delaware County, IA",IA,2018,10585,10367,218,2.1,-18
"Delaware County, IA",IA,2017,10603,10326,277,2.6,-179
"Delaware County, IA",IA,2016,10782,10412,370,3.4,98
"Delaware County, IA",IA,2015,10684,10327,357,3.3,159
"Delaware County, IA",IA,2014,10525,10129,396,3.8,123
"Delaware County, IA",IA,2013,10402,9955,447,4.3,104
"Delaware County, IA",IA,2012,10298,9835,463,4.5,0
"Delaware County, IA",IA,2011,10298,9725,573,5.6,-38
"Delaware County, IA",IA,2010,10336,9699,637,6.2,0
"Delaware County, IN",IN,2021,51868,49842,2026,3.9,-602
"Delaware County, IN",IN,2020,52470,48593,3877,7.4,-1222
"Delaware County, IN",IN,2019,53692,51643,2049,3.8,-509
"Delaware County, IN",IN,2018,54201,52048,2153,4.0,-156
"Delaware County, IN",IN,2017,54357,52060,2297,4.2,-772
"Delaware County, IN",IN,2016,55129,52342,2787,5.1,702
"Delaware County, IN",IN,2015,54427,51349,3078,5.7,825
"Delaware County, IN",IN,2014,53602,49868,3734,7.0,-636
"Delaware County, IN",IN,2013,54238,49652,4586,8.5,-695
"Delaware County, IN",IN,2012,54933,49864,5069,9.2,188
"Delaware County, IN",IN,2011,54745,49312,5433,9.9,41
"Delaware County, IN",IN,2010,54704,48559,6145,11.2,0
"Delaware County, NY",NY,2021,18914,18042,872,4.6,-43
"Delaware County, NY",NY,2020,18957,17637,1320,7.0,-488
"Delaware County, NY",NY,2019,19445,18565,880,4.5,-40
"Delaware County, NY",NY,2018,19485,18547,938,4.8,172
"Delaware County, NY",NY,2017,19313,18252,1061,5.5,79
"Delaware County, NY",NY,2016,19234,18154,1080,5.6,-233
"Delaware County, NY",NY,2015,19467,18290,1177,6.0,-537
"Delaware County, NY",NY,2014,20004,18681,1323,6.6,-1026
"Delaware County, NY",NY,2013,21030,19333,1697,8.1,-530
"Delaware County, NY",NY,2012,21560,19649,1911,8.9,-188
"Delaware County, NY",NY,2011,21748,19848,1900,8.7,-702
"Delaware County, NY",NY,2010,22450,20447,2003,8.9,0
"Delaware County, OH",OH,2021,114622,110501,4121,3.6,2531
"Delaware County, OH",OH,2020,112091,106072,6019,5.4,-943
"Delaware County, OH",OH,2019,113034,109437,3597,3.2,3481
"Delaware County, OH",OH,2018,109553,105848,3705,3.4,1809
"Delaware County, OH",OH,2017,107744,103922,3822,3.5,2480
"Delaware County, OH",OH,2016,105264,101438,3826,3.6,2594
"Delaware County, OH",OH,2015,102670,99005,3665,3.6,2005
"Delaware County, OH",OH,2014,100665,96531,4134,4.1,2638
"Delaware County, OH",OH,2013,98027,92813,5214,5.3,2029
"Delaware County, OH",OH,2012,95998,91025,4973,5.2,1064
"Delaware County, OH",OH,2011,94934,89026,5908,6.2,574
"Delaware County, OH",OH,2010,94360,87512,6848,7.3,0
"Delaware County, OK",OK,2021,18692,18066,626,3.3,416
"Delaware County, OK",OK,2020,18276,17287,989,5.4,217
"Delaware County, OK",OK,2019,18059,17409,650,3.6,170
"Delaware County, OK",OK,2018,17889,17213,676,3.8,-615
"Delaware County, OK",OK,2017,18504,17735,769,4.2,557
"Delaware County, OK",OK,2016,17947,17100,847,4.7,487
"Delaware County, OK",OK,2015,17460,16618,842,4.8,371
"Delaware County, OK",OK,2014,17089,16128,961,5.6,132
"Delaware County, OK",OK,2013,16957,15820,1137,6.7,-89
"Delaware County, OK",OK,2012,17046,15957,1089,6.4,-209
"Delaware County, OK",OK,2011,17255,16078,1177,6.8,106
"Delaware County, OK",OK,2010,17149,15833,1316,7.7,0
"Delaware County, PA",PA,2021,295824,277226,18598,6.3,-3112
"Delaware County, PA",PA,2020,298936,271519,27417,9.2,-4160
"Delaware County, PA",PA,2019,303096,290501,12595,4.2,3863
"Delaware County, PA",PA,2018,299233,286729,12504,4.2,1483
"Delaware County, PA",PA,2017,297750,284084,13666,4.6,3095
"Delaware County, PA",PA,2016,294655,280449,14206,4.8,3040
"Delaware County, PA",PA,2015,291615,277085,14530,5.0,1744
"Delaware County, PA",PA,2014,289871,273671,16200,5.6,374
"Delaware County, PA",PA,2013,289497,269746,19751,6.8,539
"Delaware County, PA",PA,2012,288958,267200,21758,7.5,2695
"Delaware County, PA",PA,2011,286263,264559,21704,7.6,1004
"Delaware County, PA",PA,2010,285259,263172,22087,7.7,0
"Delta County, CO",CO,2021,14360,13599,761,5.3,201
"Delta County, CO",CO,2020,14159,13273,886,6.3,-54
"Delta County, CO",CO,2019,14213,13765,448,3.2,-49
"Delta County, CO",CO,2018,14262,13732,530,3.7,113
"Delta County, CO",CO,2017,14149,13641,508,3.6,201
"Delta County, CO",CO,2016,13948,13293,655,4.7,516
"Delta County, CO",CO,2015,13432,12693,739,5.5,-160
"Delta County, CO",CO,2014,13592,12638,954,7.0,-250
"Delta County, CO",CO,2013,13842,12627,1215,8.8,-523
"Delta County, CO",CO,2012,14365,12958,1407,9.8,-23
"Delta County, CO",CO,2011,14388,12834,1554,10.8,-89
"Delta County, CO",CO,2010,14477,12860,1617,11.2,0
"Delta County, MI",MI,2021,16243,15244,999,6.2,-576
"Delta County, MI",MI,2020,16819,15280,1539,9.2,-327
"Delta County, MI",MI,2019,17146,16232,914,5.3,96
"Delta County, MI",MI,2018,17050,16137,913,5.4,0
"Delta County, MI",MI,2017,17050,15994,1056,6.2,-119
"Delta County, MI",MI,2016,17169,16033,1136,6.6,-158
"Delta County, MI",MI,2015,17327,16136,1191,6.9,-152
"Delta County, MI",MI,2014,17479,15998,1481,8.5,-72
"Delta County, MI",MI,2013,17551,15767,1784,10.2,-21
"Delta County, MI",MI,2012,17572,15858,1714,9.8,-197
"Delta County, MI",MI,2011,17769,15933,1836,10.3,-229
"Delta County, MI",MI,2010,17998,15809,2189,12.2,0
"Delta County, TX",TX,2021,2443,2324,119,4.9,66
"Delta County, TX",TX,2020,2377,2246,131,5.5,-35
"Delta County, TX",TX,2019,2412,2330,82,3.4,-9
"Delta County, TX",TX,2018,2421,2337,84,3.5,-108
"Delta County, TX",TX,2017,2529,2443,86,3.4,-78
"Delta County, TX",TX,2016,2607,2508,99,3.8,12
"Delta County, TX",TX,2015,2595,2476,119,4.6,-54
"Delta County, TX",TX,2014,2649,2487,162,6.1,18
"Delta County, TX",TX,2013,2631,2463,168,6.4,13
"Delta County, TX",TX,2012,2618,2443,175,6.7,-13
"Delta County, TX",TX,2011,2631,2412,219,8.3,30
"Delta County, TX",TX,2010,2601,2394,207,8.0,0
"Denali Borough, AK",AK,2021,855,769,86,10.1,210
"Denali Borough, AK",AK,2020,645,534,111,17.2,-454
"Denali Borough, AK",AK,2019,1099,1017,82,7.5,35
"Denali Borough, AK",AK,2018,1064,987,77,7.2,-82
"Denali Borough, AK",AK,2017,1146,1049,97,8.5,55
"Denali Borough, AK",AK,2016,1091,996,95,8.7,25
"Denali Borough, AK",AK,2015,1066,976,90,8.4,-2
"Denali Borough, AK",AK,2014,1068,959,109,10.2,-4
"Denali Borough, AK",AK,2013,1072,937,135,12.6,29
"Denali Borough, AK",AK,2012,1043,898,145,13.9,27
"Denali Borough, AK",AK,2011,1016,874,142,14.0,3
"Denali Borough, AK",AK,2010,1013,888,125,12.3,0
"Dent County, MO",MO,2021,6257,5987,270,4.3,-41
"Dent County, MO",MO,2020,6298,5996,302,4.8,45
"Dent County, MO",MO,2019,6253,6042,211,3.4,55
"Dent County, MO",MO,2018,6198,5998,200,3.2,31
"Dent County, MO",MO,2017,6167,5911,256,4.2,-28
"Dent County, MO",MO,2016,6195,5862,333,5.4,-67
"Dent County, MO",MO,2015,6262,5890,372,5.9,15
"Dent County, MO",MO,2014,6247,5823,424,6.8,10
"Dent County, MO",MO,2013,6237,5762,475,7.6,266
"Dent County, MO",MO,2012,5971,5468,503,8.4,-418
"Dent County, MO",MO,2011,6389,5757,632,9.9,-94
"Dent County, MO",MO,2010,6483,5817,666,10.3,0
"Denton County, TX",TX,2021,528401,505287,23114,4.4,19733
"Denton County, TX",TX,2020,508668,475991,32677,6.4,11197
"Denton County, TX",TX,2019,497471,482704,14767,3.0,18401
"Denton County, TX",TX,2018,479070,463617,15453,3.2,11434
"Denton County, TX",TX,2017,467636,451897,15739,3.4,15489
"Denton County, TX",TX,2016,452147,436615,15532,3.4,23479
"Denton County, TX",TX,2015,428668,413303,15365,3.6,15143
"Denton County, TX",TX,2014,413525,394926,18599,4.5,13963
"Denton County, TX",TX,2013,399562,378005,21557,5.4,11928
"Denton County, TX",TX,2012,387634,365619,22015,5.7,8366
"Denton County, TX",TX,2011,379268,353534,25734,6.8,9619
"Denton County, TX",TX,2010,369649,343301,26348,7.1,0
"Denver County/city, CO",CO,2021,427421,402123,25298,5.9,7577
"Denver County/city, CO",CO,2020,419844,387275,32569,7.8,3460
"Denver County/city, CO",CO,2019,416384,405807,10577,2.5,8902
"Denver County/city, CO",CO,2018,407482,395573,11909,2.9,11895
"Denver County/city, CO",CO,2017,395587,385501,10086,2.5,10479
"Denver County/city, CO",CO,2016,385108,373645,11463,3.0,9477
"Denver County/city, CO",CO,2015,375631,362250,13381,3.6,6968
"Denver County/city, CO",CO,2014,368663,351002,17661,4.8,6034
"Denver County/city, CO",CO,2013,362629,338950,23679,6.5,6052
"Denver County/city, CO",CO,2012,356577,328259,28318,7.9,5141
"Denver County/city, CO",CO,2011,351436,320182,31254,8.9,4913
"Denver County/city, CO",CO,2010,346523,313456,33067,9.5,0
"Des Moines County, IA",IA,2021,18427,17262,1165,6.3,-299
"Des Moines County, IA",IA,2020,18726,17364,1362,7.3,-996
"Des Moines County, IA",IA,2019,19722,18985,737,3.7,8
"Des Moines County, IA",IA,2018,19714,19071,643,3.3,-118
"Des Moines County, IA",IA,2017,19832,19008,824,4.2,-309
"Des Moines County, IA",IA,2016,20141,19155,986,4.9,-373
"Des Moines County, IA",IA,2015,20514,19555,959,4.7,-325
"Des Moines County, IA",IA,2014,20839,19796,1043,5.0,315
"Des Moines County, IA",IA,2013,20524,19284,1240,6.0,349
"Des Moines County, IA",IA,2012,20175,18929,1246,6.2,-223
"Des Moines County, IA",IA,2011,20398,18998,1400,6.9,225
"Des Moines County, IA",IA,2010,20173,18641,1532,7.6,0
"Deschutes County, OR",OR,2021,102553,97124,5429,5.3,4349
"Deschutes County, OR",OR,2020,98204,90396,7808,8.0,2278
"Deschutes County, OR",OR,2019,95926,92211,3715,3.9,1602
"Deschutes County, OR",OR,2018,94324,90460,3864,4.1,1679
"Deschutes County, OR",OR,2017,92645,88783,3862,4.2,2995
"Deschutes County, OR",OR,2016,89650,85369,4281,4.8,4854
"Deschutes County, OR",OR,2015,84796,79935,4861,5.7,3287
"Deschutes County, OR",OR,2014,81509,75321,6188,7.6,2728
"Deschutes County, OR",OR,2013,78781,71376,7405,9.4,-395
"Deschutes County, OR",OR,2012,79176,70282,8894,11.2,-1489
"Deschutes County, OR",OR,2011,80665,70653,10012,12.4,-902
"Deschutes County, OR",OR,2010,81567,70190,11377,13.9,0
"Desha County, AR",AR,2021,4963,4670,293,5.9,-326
"Desha County, AR",AR,2020,5289,4916,373,7.1,-121
"Desha County, AR",AR,2019,5410,5175,235,4.3,-10
"Desha County, AR",AR,2018,5420,5180,240,4.4,-26
"Desha County, AR",AR,2017,5446,5183,263,4.8,-9
"Desha County, AR",AR,2016,5455,5157,298,5.5,-124
"Desha County, AR",AR,2015,5579,5178,401,7.2,-21
"Desha County, AR",AR,2014,5600,5159,441,7.9,-82
"Desha County, AR",AR,2013,5682,5147,535,9.4,-276
"Desha County, AR",AR,2012,5958,5392,566,9.5,-174
"Desha County, AR",AR,2011,6132,5481,651,10.6,237
"Desha County, AR",AR,2010,5895,5264,631,10.7,0
"DeSoto County, FL",FL,2021,14631,14070,561,3.8,281
"DeSoto County, FL",FL,2020,14350,13549,801,5.6,251
"DeSoto County, FL",FL,2019,14099,13588,511,3.6,495
"DeSoto County, FL",FL,2018,13604,13050,554,4.1,-334
"DeSoto County, FL",FL,2017,13938,13306,632,4.5,422
"DeSoto County, FL",FL,2016,13516,12797,719,5.3,85
"DeSoto County, FL",FL,2015,13431,12643,788,5.9,279
"DeSoto County, FL",FL,2014,13152,12185,967,7.4,46
"DeSoto County, FL",FL,2013,13106,11984,1122,8.6,283
"DeSoto County, FL",FL,2012,12823,11507,1316,10.3,-988
"DeSoto County, FL",FL,2011,13811,12378,1433,10.4,846
"DeSoto County, FL",FL,2010,12965,11425,1540,11.9,0
"DeSoto County, MS",MS,2021,92926,88834,4092,4.4,1837
"DeSoto County, MS",MS,2020,91089,85724,5365,5.9,-1809
"DeSoto County, MS",MS,2019,92898,88767,4131,4.4,2416
"DeSoto County, MS",MS,2018,90482,86949,3533,3.9,2025
"DeSoto County, MS",MS,2017,88457,84967,3490,3.9,1603
"DeSoto County, MS",MS,2016,86854,83114,3740,4.3,2568
"DeSoto County, MS",MS,2015,84286,80182,4104,4.9,3216
"DeSoto County, MS",MS,2014,81070,76686,4384,5.4,-82
"DeSoto County, MS",MS,2013,81152,76379,4773,5.9,-2887
"DeSoto County, MS",MS,2012,84039,78719,5320,6.3,644
"DeSoto County, MS",MS,2011,83395,77539,5856,7.0,3557
"DeSoto County, MS",MS,2010,79838,74061,5777,7.2,0
"Deuel County, NE",NE,2021,977,956,21,2.1,10
"Deuel County, NE",NE,2020,967,937,30,3.1,1
"Deuel County, NE",NE,2019,966,937,29,3.0,-4
"Deuel County, NE",NE,2018,970,941,29,3.0,-75
"Deuel County, NE",NE,2017,1045,1018,27,2.6,-22
"Deuel County, NE",NE,2016,1067,1039,28,2.6,-12
"Deuel County, NE",NE,2015,1079,1052,27,2.5,-13
"Deuel County, NE",NE,2014,1092,1062,30,2.7,-38
"Deuel County, NE",NE,2013,1130,1093,37,3.3,-60
"Deuel County, NE",NE,2012,1190,1152,38,3.2,121
"Deuel County, NE",NE,2011,1069,1032,37,3.5,39
"Deuel County, NE",NE,2010,1030,989,41,4.0,0
"Deuel County, SD",SD,2021,2293,2197,96,4.2,-20
"Deuel County, SD",SD,2020,2313,2198,115,5.0,150
"Deuel County, SD",SD,2019,2163,2073,90,4.2,9
"Deuel County, SD",SD,2018,2154,2066,88,4.1,-38
"Deuel County, SD",SD,2017,2192,2093,99,4.5,-59
"Deuel County, SD",SD,2016,2251,2141,110,4.9,-73
"Deuel County, SD",SD,2015,2324,2211,113,4.9,-25
"Deuel County, SD",SD,2014,2349,2226,123,5.2,-48
"Deuel County, SD",SD,2013,2397,2265,132,5.5,-106
"Deuel County, SD",SD,2012,2503,2362,141,5.6,-38
"Deuel County, SD",SD,2011,2541,2390,151,5.9,52
"Deuel County, SD",SD,2010,2489,2324,165,6.6,0
"Dewey County, OK",OK,2021,2728,2654,74,2.7,52
"Dewey County, OK",OK,2020,2676,2545,131,4.9,-210
"Dewey County, OK",OK,2019,2886,2828,58,2.0,126
"Dewey County, OK",OK,2018,2760,2709,51,1.8,245
"Dewey County, OK",OK,2017,2515,2447,68,2.7,-158
"Dewey County, OK",OK,2016,2673,2568,105,3.9,178
"Dewey County, OK",OK,2015,2495,2407,88,3.5,92
"Dewey County, OK",OK,2014,2403,2330,73,3.0,-190
"Dewey County, OK",OK,2013,2593,2505,88,3.4,219
"Dewey County, OK",OK,2012,2374,2300,74,3.1,-91
"Dewey County, OK",OK,2011,2465,2374,91,3.7,157
"Dewey County, OK",OK,2010,2308,2192,116,5.0,0
"Dewey County, SD",SD,2021,2288,2153,135,5.9,-6
"Dewey County, SD",SD,2020,2294,2133,161,7.0,97
"Dewey County, SD",SD,2019,2197,2041,156,7.1,-7
"Dewey County, SD",SD,2018,2204,2025,179,8.1,-31
"Dewey County, SD",SD,2017,2235,2026,209,9.4,-31
"Dewey County, SD",SD,2016,2266,2059,207,9.1,-38
"Dewey County, SD",SD,2015,2304,2043,261,11.3,-78
"Dewey County, SD",SD,2014,2382,2043,339,14.2,-50
"Dewey County, SD",SD,2013,2432,2061,371,15.3,9
"Dewey County, SD",SD,2012,2423,2053,370,15.3,-5
"Dewey County, SD",SD,2011,2428,2044,384,15.8,61
"Dewey County, SD",SD,2010,2367,2018,349,14.7,0
"DeWitt County, TX",TX,2021,9414,8958,456,4.8,286
"DeWitt County, TX",TX,2020,9128,8575,553,6.1,-497
"DeWitt County, TX",TX,2019,9625,9371,254,2.6,-5
"DeWitt County, TX",TX,2018,9630,9326,304,3.2,119
"DeWitt County, TX",TX,2017,9511,9091,420,4.4,9
"DeWitt County, TX",TX,2016,9502,8983,519,5.5,-555
"DeWitt County, TX",TX,2015,10057,9653,404,4.0,58
"DeWitt County, TX",TX,2014,9999,9611,388,3.9,317
"DeWitt County, TX",TX,2013,9682,9221,461,4.8,-36
"DeWitt County, TX",TX,2012,9718,9256,462,4.8,251
"DeWitt County, TX",TX,2011,9467,8836,631,6.7,378
"DeWitt County, TX",TX,2010,9089,8379,710,7.8,0
"Dickens County, TX",TX,2021,693,658,35,5.1,37
"Dickens County, TX",TX,2020,656,615,41,6.3,-10
"Dickens County, TX",TX,2019,666,638,28,4.2,-1
"Dickens County, TX",TX,2018,667,638,29,4.3,-8
"Dickens County, TX",TX,2017,675,642,33,4.9,-17
"Dickens County, TX",TX,2016,692,658,34,4.9,-11
"Dickens County, TX",TX,2015,703,670,33,4.7,-40
"Dickens County, TX",TX,2014,743,696,47,6.3,-27
"Dickens County, TX",TX,2013,770,698,72,9.4,-61
"Dickens County, TX",TX,2012,831,743,88,10.6,-81
"Dickens County, TX",TX,2011,912,769,143,15.7,39
"Dickens County, TX",TX,2010,873,774,99,11.3,0
"Dickenson County, VA",VA,2021,4645,4398,247,5.3,-102
"Dickenson County, VA",VA,2020,4747,4372,375,7.9,2
"Dickenson County, VA",VA,2019,4745,4512,233,4.9,180
"Dickenson County, VA",VA,2018,4565,4333,232,5.1,-111
"Dickenson County, VA",VA,2017,4676,4362,314,6.7,101
"Dickenson County, VA",VA,2016,4575,4128,447,9.8,-352
"Dickenson County, VA",VA,2015,4927,4436,491,10.0,-282
"Dickenson County, VA",VA,2014,5209,4688,521,10.0,-132
"Dickenson County, VA",VA,2013,5341,4758,583,10.9,137
"Dickenson County, VA",VA,2012,5204,4660,544,10.5,-247
"Dickenson County, VA",VA,2011,5451,4913,538,9.9,-73
"Dickenson County, VA",VA,2010,5524,4931,593,10.7,0
"Dickey County, ND",ND,2021,2265,2204,61,2.7,-51
"Dickey County, ND",ND,2020,2316,2240,76,3.3,-28
"Dickey County, ND",ND,2019,2344,2304,40,1.7,-96
"Dickey County, ND",ND,2018,2440,2400,40,1.6,-100
"Dickey County, ND",ND,2017,2540,2496,44,1.7,-1
"Dickey County, ND",ND,2016,2541,2492,49,1.9,9
"Dickey County, ND",ND,2015,2532,2485,47,1.9,-26
"Dickey County, ND",ND,2014,2558,2508,50,2.0,-73
"Dickey County, ND",ND,2013,2631,2570,61,2.3,-62
"Dickey County, ND",ND,2012,2693,2623,70,2.6,-122
"Dickey County, ND",ND,2011,2815,2736,79,2.8,-47
"Dickey County, ND",ND,2010,2862,2771,91,3.2,0
"Dickinson County, IA",IA,2021,10128,9728,400,3.9,275
"Dickinson County, IA",IA,2020,9853,9364,489,5.0,-413
"Dickinson County, IA",IA,2019,10266,9984,282,2.7,283
"Dickinson County, IA",IA,2018,9983,9667,316,3.2,-215
"Dickinson County, IA",IA,2017,10198,9831,367,3.6,-156
"Dickinson County, IA",IA,2016,10354,9912,442,4.3,145
"Dickinson County, IA",IA,2015,10209,9816,393,3.8,499
"Dickinson County, IA",IA,2014,9710,9257,453,4.7,361
"Dickinson County, IA",IA,2013,9349,8851,498,5.3,132
"Dickinson County, IA",IA,2012,9217,8694,523,5.7,-81
"Dickinson County, IA",IA,2011,9298,8702,596,6.4,24
"Dickinson County, IA",IA,2010,9274,8634,640,6.9,0
"Dickinson County, KS",KS,2021,9097,8828,269,3.0,230
"Dickinson County, KS",KS,2020,8867,8455,412,4.6,-48
"Dickinson County, KS",KS,2019,8915,8605,310,3.5,-238
"Dickinson County, KS",KS,2018,9153,8841,312,3.4,-158
"Dickinson County, KS",KS,2017,9311,8958,353,3.8,102
"Dickinson County, KS",KS,2016,9209,8803,406,4.4,-336
"Dickinson County, KS",KS,2015,9545,9052,493,5.2,-190
"Dickinson County, KS",KS,2014,9735,9246,489,5.0,-147
"Dickinson County, KS",KS,2013,9882,9299,583,5.9,-217
"Dickinson County, KS",KS,2012,10099,9489,610,6.0,-58
"Dickinson County, KS",KS,2011,10157,9497,660,6.5,-76
"Dickinson County, KS",KS,2010,10233,9565,668,6.5,0
"Dickinson County, MI",MI,2021,12132,11552,580,4.8,16
"Dickinson County, MI",MI,2020,12116,11218,898,7.4,-164
"Dickinson County, MI",MI,2019,12280,11750,530,4.3,-260
"Dickinson County, MI",MI,2018,12540,12058,482,3.8,-9
"Dickinson County, MI",MI,2017,12549,11966,583,4.6,10
"Dickinson County, MI",MI,2016,12539,11882,657,5.2,-126
"Dickinson County, MI",MI,2015,12665,11941,724,5.7,-216
"Dickinson County, MI",MI,2014,12881,12002,879,6.8,219
"Dickinson County, MI",MI,2013,12662,11622,1040,8.2,-20
"Dickinson County, MI",MI,2012,12682,11625,1057,8.3,-101
"Dickinson County, MI",MI,2011,12783,11607,1176,9.2,-307
"Dickinson County, MI",MI,2010,13090,11627,1463,11.2,0
"Dickson County, TN",TN,2021,27087,26174,913,3.4,740
"Dickson County, TN",TN,2020,26347,24786,1561,5.9,-868
"Dickson County, TN",TN,2019,27215,26392,823,3.0,837
"Dickson County, TN",TN,2018,26378,25577,801,3.0,823
"Dickson County, TN",TN,2017,25555,24697,858,3.4,758
"Dickson County, TN",TN,2016,24797,23714,1083,4.4,654
"Dickson County, TN",TN,2015,24143,22841,1302,5.4,515
"Dickson County, TN",TN,2014,23628,22142,1486,6.3,-248
"Dickson County, TN",TN,2013,23876,22048,1828,7.7,-290
"Dickson County, TN",TN,2012,24166,22121,2045,8.5,-104
"Dickson County, TN",TN,2011,24270,21913,2357,9.7,289
"Dickson County, TN",TN,2010,23981,21488,2493,10.4,0
"Dillingham Census Area, AK",AK,2021,1709,1569,140,8.2,-12
"Dillingham Census Area, AK",AK,2020,1721,1570,151,8.8,-261
"Dillingham Census Area, AK",AK,2019,1982,1840,142,7.2,-35
"Dillingham Census Area, AK",AK,2018,2017,1868,149,7.4,-32
"Dillingham Census Area, AK",AK,2017,2049,1877,172,8.4,-24
"Dillingham Census Area, AK",AK,2016,2073,1881,192,9.3,40
"Dillingham Census Area, AK",AK,2015,2033,1843,190,9.3,-78
"Dillingham Census Area, AK",AK,2014,2111,1902,209,9.9,-12
"Dillingham Census Area, AK",AK,2013,2123,1906,217,10.2,-1
"Dillingham Census Area, AK",AK,2012,2124,1911,213,10.0,24
"Dillingham Census Area, AK",AK,2011,2100,1873,227,10.8,10
"Dillingham Census Area, AK",AK,2010,2090,1871,219,10.5,0
"Dillon County, SC",SC,2021,13128,12367,761,5.8,199
"Dillon County, SC",SC,2020,12929,12156,773,6.0,273
"Dillon County, SC",SC,2019,12656,12149,507,4.0,377
"Dillon County, SC",SC,2018,12279,11697,582,4.7,86
"Dillon County, SC",SC,2017,12193,11506,687,5.6,-450
"Dillon County, SC",SC,2016,12643,11805,838,6.6,-19
"Dillon County, SC",SC,2015,12662,11582,1080,8.5,77
"Dillon County, SC",SC,2014,12585,11405,1180,9.4,-199
"Dillon County, SC",SC,2013,12784,11308,1476,11.5,-424
"Dillon County, SC",SC,2012,13208,11379,1829,13.8,-497
"Dillon County, SC",SC,2011,13705,11564,2141,15.6,-443
"Dillon County, SC",SC,2010,14148,11865,2283,16.1,0
"Dimmit County, TX",TX,2021,5830,5497,333,5.7,-598
"Dimmit County, TX",TX,2020,6428,6019,409,6.4,-927
"Dimmit County, TX",TX,2019,7355,7168,187,2.5,69
"Dimmit County, TX",TX,2018,7286,7066,220,3.0,845
"Dimmit County, TX",TX,2017,6441,6113,328,5.1,199
"Dimmit County, TX",TX,2016,6242,5796,446,7.1,-922
"Dimmit County, TX",TX,2015,7164,6830,334,4.7,-484
"Dimmit County, TX",TX,2014,7648,7355,293,3.8,879
"Dimmit County, TX",TX,2013,6769,6427,342,5.1,1018
"Dimmit County, TX",TX,2012,5751,5418,333,5.8,840
"Dimmit County, TX",TX,2011,4911,4519,392,8.0,1050
"Dimmit County, TX",TX,2010,3861,3453,408,10.6,0
"Dinwiddie County, VA",VA,2021,13210,12617,593,4.5,-259
"Dinwiddie County, VA",VA,2020,13469,12615,854,6.3,-345
"Dinwiddie County, VA",VA,2019,13814,13365,449,3.3,130
"Dinwiddie County, VA",VA,2018,13684,13210,474,3.5,132
"Dinwiddie County, VA",VA,2017,13552,12950,602,4.4,91
"Dinwiddie County, VA",VA,2016,13461,12815,646,4.8,99
"Dinwiddie County, VA",VA,2015,13362,12648,714,5.3,-143
"Dinwiddie County, VA",VA,2014,13505,12650,855,6.3,-33
"Dinwiddie County, VA",VA,2013,13538,12565,973,7.2,-74
"Dinwiddie County, VA",VA,2012,13612,12600,1012,7.4,-10
"Dinwiddie County, VA",VA,2011,13622,12538,1084,8.0,31
"Dinwiddie County, VA",VA,2010,13591,12361,1230,9.1,0
District of Columbia,,2021,381673,356578,25095,6.6,-7711
District of Columbia,,2020,389384,358370,31014,8.0,-11193
District of Columbia,,2019,400577,379016,21561,5.4,4538
District of Columbia,,2018,396039,373772,22267,5.6,2713
District of Columbia,,2017,393326,369388,23938,6.1,-1798
District of Columbia,,2016,395124,370553,24571,6.2,6678
District of Columbia,,2015,388446,361556,26890,6.9,8768
District of Columbia,,2014,379678,350415,29263,7.7,5479
District of Columbia,,2013,374199,342609,31590,8.4,9023
District of Columbia,,2012,365176,332412,32764,9.0,12983
District of Columbia,,2011,352193,316372,35821,10.2,5486
District of Columbia,,2010,346707,312132,34575,10.0,0
"Divide County, ND",ND,2021,1434,1399,35,2.4,-11
"Divide County, ND",ND,2020,1445,1399,46,3.2,-35
"Divide County, ND",ND,2019,1480,1461,19,1.3,-75
"Divide County, ND",ND,2018,1555,1537,18,1.2,-49
"Divide County, ND",ND,2017,1604,1578,26,1.6,-76
"Divide County, ND",ND,2016,1680,1636,44,2.6,-121
"Divide County, ND",ND,2015,1801,1768,33,1.8,-51
"Divide County, ND",ND,2014,1852,1825,27,1.5,99
"Divide County, ND",ND,2013,1753,1729,24,1.4,-25
"Divide County, ND",ND,2012,1778,1752,26,1.5,203
"Divide County, ND",ND,2011,1575,1548,27,1.7,189
"Divide County, ND",ND,2010,1386,1358,28,2.0,0
"Dixie County, FL",FL,2021,5910,5653,257,4.3,65
"Dixie County, FL",FL,2020,5845,5495,350,6.0,42
"Dixie County, FL",FL,2019,5803,5579,224,3.9,69
"Dixie County, FL",FL,2018,5734,5486,248,4.3,30
"Dixie County, FL",FL,2017,5704,5428,276,4.8,35
"Dixie County, FL",FL,2016,5669,5358,311,5.5,60
"Dixie County, FL",FL,2015,5609,5256,353,6.3,60
"Dixie County, FL",FL,2014,5549,5126,423,7.6,-285
"Dixie County, FL",FL,2013,5834,5316,518,8.9,60
"Dixie County, FL",FL,2012,5774,5166,608,10.5,54
"Dixie County, FL",FL,2011,5720,5018,702,12.3,26
"Dixie County, FL",FL,2010,5694,4983,711,12.5,0
"Dixon County, NE",NE,2021,2986,2922,64,2.1,29
"Dixon County, NE",NE,2020,2957,2862,95,3.2,-69
"Dixon County, NE",NE,2019,3026,2934,92,3.0,-17
"Dixon County, NE",NE,2018,3043,2948,95,3.1,0
"Dixon County, NE",NE,2017,3043,2947,96,3.2,-43
"Dixon County, NE",NE,2016,3086,2984,102,3.3,-8
"Dixon County, NE",NE,2015,3094,2992,102,3.3,35
"Dixon County, NE",NE,2014,3059,2966,93,3.0,-53
"Dixon County, NE",NE,2013,3112,2998,114,3.7,-22
"Dixon County, NE",NE,2012,3134,3008,126,4.0,-28
"Dixon County, NE",NE,2011,3162,3018,144,4.6,51
"Dixon County, NE",NE,2010,3111,2959,152,4.9,0
"Doddridge County, WV",WV,2021,3867,3708,159,4.1,-34
"Doddridge County, WV",WV,2020,3901,3668,233,6.0,-103
"Doddridge County, WV",WV,2019,4004,3825,179,4.5,8
"Doddridge County, WV",WV,2018,3996,3841,155,3.9,85
"Doddridge County, WV",WV,2017,3911,3744,167,4.3,117
"Doddridge County, WV",WV,2016,3794,3597,197,5.2,107
"Doddridge County, WV",WV,2015,3687,3488,199,5.4,18
"Doddridge County, WV",WV,2014,3669,3489,180,4.9,147
"Doddridge County, WV",WV,2013,3522,3336,186,5.3,116
"Doddridge County, WV",WV,2012,3406,3199,207,6.1,82
"Doddridge County, WV",WV,2011,3324,3094,230,6.9,13
"Doddridge County, WV",WV,2010,3311,3074,237,7.2,0
"Dodge County, GA",GA,2021,7005,6709,296,4.2,83
"Dodge County, GA",GA,2020,6922,6508,414,6.0,-251
"Dodge County, GA",GA,2019,7173,6774,399,5.6,-11
"Dodge County, GA",GA,2018,7184,6807,377,5.2,-18
"Dodge County, GA",GA,2017,7202,6748,454,6.3,184
"Dodge County, GA",GA,2016,7018,6501,517,7.4,137
"Dodge County, GA",GA,2015,6881,6295,586,8.5,-542
"Dodge County, GA",GA,2014,7423,6695,728,9.8,-349
"Dodge County, GA",GA,2013,7772,6892,880,11.3,-349
"Dodge County, GA",GA,2012,8121,7198,923,11.4,-154
"Dodge County, GA",GA,2011,8275,7266,1009,12.2,-114
"Dodge County, GA",GA,2010,8389,7280,1109,13.2,0
"Dodge County, MN",MN,2021,11735,11371,364,3.1,-387
"Dodge County, MN",MN,2020,12122,11451,671,5.5,102
"Dodge County, MN",MN,2019,12020,11588,432,3.6,195
"Dodge County, MN",MN,2018,11825,11444,381,3.2,72
"Dodge County, MN",MN,2017,11753,11353,400,3.4,204
"Dodge County, MN",MN,2016,11549,11120,429,3.7,69
"Dodge County, MN",MN,2015,11480,11043,437,3.8,206
"Dodge County, MN",MN,2014,11274,10794,480,4.3,-68
"Dodge County, MN",MN,2013,11342,10797,545,4.8,-10
"Dodge County, MN",MN,2012,11352,10776,576,5.1,93
"Dodge County, MN",MN,2011,11259,10578,681,6.0,-56
"Dodge County, MN",MN,2010,11315,10530,785,6.9,0
"Dodge County, NE",NE,2021,20420,19940,480,2.4,116
"Dodge County, NE",NE,2020,20304,19609,695,3.4,433
"Dodge County, NE",NE,2019,19871,19293,578,2.9,265
"Dodge County, NE",NE,2018,19606,19048,558,2.8,70
"Dodge County, NE",NE,2017,19536,18981,555,2.8,299
"Dodge County, NE",NE,2016,19237,18649,588,3.1,66
"Dodge County, NE",NE,2015,19171,18548,623,3.2,-61
"Dodge County, NE",NE,2014,19232,18537,695,3.6,40
"Dodge County, NE",NE,2013,19192,18403,789,4.1,-37
"Dodge County, NE",NE,2012,19229,18382,847,4.4,91
"Dodge County, NE",NE,2011,19138,18195,943,4.9,311
"Dodge County, NE",NE,2010,18827,17814,1013,5.4,0
"Dodge County, WI",WI,2021,48501,46971,1530,3.2,617
"Dodge County, WI",WI,2020,47884,45349,2535,5.3,197
"Dodge County, WI",WI,2019,47687,46321,1366,2.9,-445
"Dodge County, WI",WI,2018,48132,46878,1254,2.6,-427
"Dodge County, WI",WI,2017,48559,47160,1399,2.9,818
"Dodge County, WI",WI,2016,47741,46043,1698,3.6,316
"Dodge County, WI",WI,2015,47425,45384,2041,4.3,-47
"Dodge County, WI",WI,2014,47472,44958,2514,5.3,112
"Dodge County, WI",WI,2013,47360,44131,3229,6.8,-321
"Dodge County, WI",WI,2012,47681,44325,3356,7.0,168
"Dodge County, WI",WI,2011,47513,43897,3616,7.6,141
"Dodge County, WI",WI,2010,47372,43170,4202,8.9,0
"Dolores County, CO",CO,2021,1176,1121,55,4.7,41
"Dolores County, CO",CO,2020,1135,1061,74,6.5,-1
"Dolores County, CO",CO,2019,1136,1104,32,2.8,0
"Dolores County, CO",CO,2018,1136,1106,30,2.6,17
"Dolores County, CO",CO,2017,1119,1089,30,2.7,48
"Dolores County, CO",CO,2016,1071,1031,40,3.7,-252
"Dolores County, CO",CO,2015,1323,1283,40,3.0,-6
"Dolores County, CO",CO,2014,1329,1277,52,3.9,315
"Dolores County, CO",CO,2013,1014,931,83,8.2,67
"Dolores County, CO",CO,2012,947,849,98,10.3,0
"Dolores County, CO",CO,2011,947,821,126,13.3,-56
"Dolores County, CO",CO,2010,1003,817,186,18.5,0
"Dona Ana County, NM",NM,2021,98170,91648,6522,6.6,1229
"Dona Ana County, NM",NM,2020,96941,89187,7754,8.0,-2000
"Dona Ana County, NM",NM,2019,98941,93228,5713,5.8,1518
"Dona Ana County, NM",NM,2018,97423,91928,5495,5.6,621
"Dona Ana County, NM",NM,2017,96802,90304,6498,6.7,432
"Dona Ana County, NM",NM,2016,96370,89390,6980,7.2,1396
"Dona Ana County, NM",NM,2015,94974,87947,7027,7.4,519
"Dona Ana County, NM",NM,2014,94455,87658,6797,7.2,171
"Dona Ana County, NM",NM,2013,94284,87259,7025,7.5,414
"Dona Ana County, NM",NM,2012,93870,87140,6730,7.2,997
"Dona Ana County, NM",NM,2011,92873,86124,6749,7.3,-23
"Dona Ana County, NM",NM,2010,92896,85982,6914,7.4,0
"Doniphan County, KS",KS,2021,4124,4011,113,2.7,-12
"Doniphan County, KS",KS,2020,4136,3951,185,4.5,-27
"Doniphan County, KS",KS,2019,4163,4026,137,3.3,-9
"Doniphan County, KS",KS,2018,4172,4027,145,3.5,-45
"Doniphan County, KS",KS,2017,4217,4071,146,3.5,-77
"Doniphan County, KS",KS,2016,4294,4128,166,3.9,-36
"Doniphan County, KS",KS,2015,4330,4143,187,4.3,29
"Doniphan County, KS",KS,2014,4301,4109,192,4.5,-46
"Doniphan County, KS",KS,2013,4347,4111,236,5.4,-63
"Doniphan County, KS",KS,2012,4410,4134,276,6.3,-63
"Doniphan County, KS",KS,2011,4473,4129,344,7.7,-65
"Doniphan County, KS",KS,2010,4538,4142,396,8.7,0
"Donley County, TX",TX,2021,1448,1389,59,4.1,43
"Donley County, TX",TX,2020,1405,1343,62,4.4,-18
"Donley County, TX",TX,2019,1423,1375,48,3.4,-121
"Donley County, TX",TX,2018,1544,1490,54,3.5,51
"Donley County, TX",TX,2017,1493,1438,55,3.7,-64
"Donley County, TX",TX,2016,1557,1494,63,4.0,-37
"Donley County, TX",TX,2015,1594,1527,67,4.2,-23
"Donley County, TX",TX,2014,1617,1538,79,4.9,-367
"Donley County, TX",TX,2013,1984,1882,102,5.1,279
"Donley County, TX",TX,2012,1705,1605,100,5.9,-106
"Donley County, TX",TX,2011,1811,1691,120,6.6,0
"Donley County, TX",TX,2010,1811,1686,125,6.9,0
"Dooly County, GA",GA,2021,4936,4577,359,7.3,-38
"Dooly County, GA",GA,2020,4974,4528,446,9.0,-108
"Dooly County, GA",GA,2019,5082,4884,198,3.9,-55
"Dooly County, GA",GA,2018,5137,4894,243,4.7,1
"Dooly County, GA",GA,2017,5136,4874,262,5.1,185
"Dooly County, GA",GA,2016,4951,4660,291,5.9,246
"Dooly County, GA",GA,2015,4705,4344,361,7.7,76
"Dooly County, GA",GA,2014,4629,4183,446,9.6,121
"Dooly County, GA",GA,2013,4508,3993,515,11.4,-287
"Dooly County, GA",GA,2012,4795,4252,543,11.3,17
"Dooly County, GA",GA,2011,4778,4160,618,12.9,-196
"Dooly County, GA",GA,2010,4974,4392,582,11.7,0
"Door County, WI",WI,2021,15656,14973,683,4.4,531
"Door County, WI",WI,2020,15125,14089,1036,6.8,-264
"Door County, WI",WI,2019,15389,14839,550,3.6,-79
"Door County, WI",WI,2018,15468,14919,549,3.5,-149
"Door County, WI",WI,2017,15617,15023,594,3.8,160
"Door County, WI",WI,2016,15457,14712,745,4.8,21
"Door County, WI",WI,2015,15436,14433,1003,6.5,87
"Door County, WI",WI,2014,15349,14112,1237,8.1,-383
"Door County, WI",WI,2013,15732,14191,1541,9.8,-3
"Door County, WI",WI,2012,15735,14145,1590,10.1,180
"Door County, WI",WI,2011,15555,13736,1819,11.7,-205
"Door County, WI",WI,2010,15760,14017,1743,11.1,0
"Dorado Municipio, PR",PR,2021,14425,13556,869,6.0,
"Dorado Municipio, PR",PR,2020,N.A.,N.A.,N.A.,N.A.,
"Dorado Municipio, PR",PR,2019,13255,12502,753,5.7,371
"Dorado Municipio, PR",PR,2018,12884,12134,750,5.8,65
"Dorado Municipio, PR",PR,2017,12819,11936,883,6.9,-105
"Dorado Municipio, PR",PR,2016,12924,11882,1042,8.1,121
"Dorado Municipio, PR",PR,2015,12803,11802,1001,7.8,137
"Dorado Municipio, PR",PR,2014,12666,11559,1107,8.7,-178
"Dorado Municipio, PR",PR,2013,12844,11707,1137,8.9,-127
"Dorado Municipio, PR",PR,2012,12971,11790,1181,9.1,-115
"Dorado Municipio, PR",PR,2011,13086,11672,1414,10.8,-464
"Dorado Municipio, PR",PR,2010,13550,11926,1624,12.0,0
"Dorchester County, MD",MD,2021,16235,15321,914,5.6,-318
"Dorchester County, MD",MD,2020,16553,15467,1086,6.6,124
"Dorchester County, MD",MD,2019,16429,15700,729,4.4,667
"Dorchester County, MD",MD,2018,15762,15004,758,4.8,-82
"Dorchester County, MD",MD,2017,15844,14974,870,5.5,-19
"Dorchester County, MD",MD,2016,15863,14911,952,6.0,73
"Dorchester County, MD",MD,2015,15790,14680,1110,7.0,15
"Dorchester County, MD",MD,2014,15775,14470,1305,8.3,-174
"Dorchester County, MD",MD,2013,15949,14405,1544,9.7,-222
"Dorchester County, MD",MD,2012,16171,14441,1730,10.7,-363
"Dorchester County, MD",MD,2011,16534,14679,1855,11.2,-52
"Dorchester County, MD",MD,2010,16586,14657,1929,11.6,0
"Dorchester County, SC",SC,2021,77830,75008,2822,3.6,2025
"Dorchester County, SC",SC,2020,75805,71521,4284,5.7,-545
"Dorchester County, SC",SC,2019,76350,74486,1864,2.4,1739
"Dorchester County, SC",SC,2018,74611,72392,2219,3.0,1971
"Dorchester County, SC",SC,2017,72640,69888,2752,3.8,-314
"Dorchester County, SC",SC,2016,72954,69685,3269,4.5,293
"Dorchester County, SC",SC,2015,72661,68727,3934,5.4,2385
"Dorchester County, SC",SC,2014,70276,66286,3990,5.7,1418
"Dorchester County, SC",SC,2013,68858,64419,4439,6.4,531
"Dorchester County, SC",SC,2012,68327,63096,5231,7.7,997
"Dorchester County, SC",SC,2011,67330,61361,5969,8.9,1205
"Dorchester County, SC",SC,2010,66125,59736,6389,9.7,0
"Dougherty County, GA",GA,2021,37494,35110,2384,6.4,12
"Dougherty County, GA",GA,2020,37482,34250,3232,8.6,-273
"Dougherty County, GA",GA,2019,37755,35934,1821,4.8,-954
"Dougherty County, GA",GA,2018,38709,36603,2106,5.4,-582
"Dougherty County, GA",GA,2017,39291,36904,2387,6.1,1119
"Dougherty County, GA",GA,2016,38172,35525,2647,6.9,712
"Dougherty County, GA",GA,2015,37460,34519,2941,7.9,-1141
"Dougherty County, GA",GA,2014,38601,35022,3579,9.3,-1060
"Dougherty County, GA",GA,2013,39661,35585,4076,10.3,-1094
"Dougherty County, GA",GA,2012,40755,36216,4539,11.1,-427
"Dougherty County, GA",GA,2011,41182,36196,4986,12.1,-441
"Dougherty County, GA",GA,2010,41623,36327,5296,12.7,0
"Douglas County, CO",CO,2021,200746,192563,8183,4.1,4647
"Douglas County, CO",CO,2020,196099,185505,10594,5.4,298
"Douglas County, CO",CO,2019,195801,191411,4390,2.2,5968
"Douglas County, CO",CO,2018,189833,184850,4983,2.6,6596
"Douglas County, CO",CO,2017,183237,179180,4057,2.2,5667
"Douglas County, CO",CO,2016,177570,173042,4528,2.5,5366
"Douglas County, CO",CO,2015,172204,167066,5138,3.0,3053
"Douglas County, CO",CO,2014,169151,162392,6759,4.0,4728
"Douglas County, CO",CO,2013,164423,155829,8594,5.2,4015
"Douglas County, CO",CO,2012,160408,150643,9765,6.1,2524
"Douglas County, CO",CO,2011,157884,147339,10545,6.7,939
"Douglas County, CO",CO,2010,156945,145418,11527,7.3,0
"Douglas County, GA",GA,2021,74001,70771,3230,4.4,1592
"Douglas County, GA",GA,2020,72409,67092,5317,7.3,-893
"Douglas County, GA",GA,2019,73302,70570,2732,3.7,217
"Douglas County, GA",GA,2018,73085,70001,3084,4.2,334
"Douglas County, GA",GA,2017,72751,69159,3592,4.9,2519
"Douglas County, GA",GA,2016,70232,66273,3959,5.6,2664
"Douglas County, GA",GA,2015,67568,63209,4359,6.5,-3
"Douglas County, GA",GA,2014,67571,62550,5021,7.4,346
"Douglas County, GA",GA,2013,67225,61482,5743,8.5,482
"Douglas County, GA",GA,2012,66743,60426,6317,9.5,-99
"Douglas County, GA",GA,2011,66842,59644,7198,10.8,78
"Douglas County, GA",GA,2010,66764,59181,7583,11.4,0
"Douglas County, IL",IL,2021,10153,9778,375,3.7,189
"Douglas County, IL",IL,2020,9964,9391,573,5.8,-290
"Douglas County, IL",IL,2019,10254,9905,349,3.4,-71
"Douglas County, IL",IL,2018,10325,9908,417,4.0,62
"Douglas County, IL",IL,2017,10263,9843,420,4.1,-63
"Douglas County, IL",IL,2016,10326,9839,487,4.7,156
"Douglas County, IL",IL,2015,10170,9673,497,4.9,221
"Douglas County, IL",IL,2014,9949,9366,583,5.9,94
"Douglas County, IL",IL,2013,9855,9178,677,6.9,-125
"Douglas County, IL",IL,2012,9980,9260,720,7.2,-211
"Douglas County, IL",IL,2011,10191,9370,821,8.1,-130
"Douglas County, IL",IL,2010,10321,9407,914,8.9,0
"Douglas County, KS",KS,2021,64611,62581,2030,3.1,654
"Douglas County, KS",KS,2020,63957,60252,3705,5.8,-1825
"Douglas County, KS",KS,2019,65782,63872,1910,2.9,212
"Douglas County, KS",KS,2018,65570,63604,1966,3.0,-44
"Douglas County, KS",KS,2017,65614,63527,2087,3.2,47
"Douglas County, KS",KS,2016,65567,63255,2312,3.5,631
"Douglas County, KS",KS,2015,64936,62542,2394,3.7,191
"Douglas County, KS",KS,2014,64745,62121,2624,4.1,1059
"Douglas County, KS",KS,2013,63686,60620,3066,4.8,-54
"Douglas County, KS",KS,2012,63740,60473,3267,5.1,-319
"Douglas County, KS",KS,2011,64059,60492,3567,5.6,-325
"Douglas County, KS",KS,2010,64384,60627,3757,5.8,0
"Douglas County, MN",MN,2021,20894,20304,590,2.8,-508
"Douglas County, MN",MN,2020,21402,20352,1050,4.9,126
"Douglas County, MN",MN,2019,21276,20560,716,3.4,579
"Douglas County, MN",MN,2018,20697,20071,626,3.0,74
"Douglas County, MN",MN,2017,20623,19961,662,3.2,405
"Douglas County, MN",MN,2016,20218,19513,705,3.5,36
"Douglas County, MN",MN,2015,20182,19478,704,3.5,265
"Douglas County, MN",MN,2014,19917,19157,760,3.8,25
"Douglas County, MN",MN,2013,19892,18996,896,4.5,61
"Douglas County, MN",MN,2012,19831,18825,1006,5.1,8
"Douglas County, MN",MN,2011,19823,18618,1205,6.1,-10
"Douglas County, MN",MN,2010,19833,18481,1352,6.8,0
"Douglas County, MO",MO,2021,5162,4941,221,4.3,28
"Douglas County, MO",MO,2020,5134,4745,389,7.6,71
"Douglas County, MO",MO,2019,5063,4821,242,4.8,9
"Douglas County, MO",MO,2018,5054,4831,223,4.4,-8
"Douglas County, MO",MO,2017,5062,4830,232,4.6,-13
"Douglas County, MO",MO,2016,5075,4767,308,6.1,65
"Douglas County, MO",MO,2015,5010,4663,347,6.9,-1
"Douglas County, MO",MO,2014,5011,4625,386,7.7,-47
"Douglas County, MO",MO,2013,5058,4579,479,9.5,-63
"Douglas County, MO",MO,2012,5121,4602,519,10.1,-51
"Douglas County, MO",MO,2011,5172,4635,537,10.4,-53
"Douglas County, MO",MO,2010,5225,4596,629,12.0,0
"Douglas County, NE",NE,2021,303368,294193,9175,3.0,984
"Douglas County, NE",NE,2020,302384,287388,14996,5.0,-1031
"Douglas County, NE",NE,2019,303415,293488,9927,3.3,5650
"Douglas County, NE",NE,2018,297765,288281,9484,3.2,3992
"Douglas County, NE",NE,2017,293773,284301,9472,3.2,4160
"Douglas County, NE",NE,2016,289613,280038,9575,3.3,1722
"Douglas County, NE",NE,2015,287891,278389,9502,3.3,1234
"Douglas County, NE",NE,2014,286657,276341,10316,3.6,1092
"Douglas County, NE",NE,2013,285565,273993,11572,4.1,539
"Douglas County, NE",NE,2012,285026,272639,12387,4.3,2873
"Douglas County, NE",NE,2011,282153,268311,13842,4.9,3237
"Douglas County, NE",NE,2010,278916,264380,14536,5.2,0
"Douglas County, NV",NV,2021,22047,21046,1001,4.5,-57
"Douglas County, NV",NV,2020,22104,20130,1974,8.9,-1114
"Douglas County, NV",NV,2019,23218,22283,935,4.0,471
"Douglas County, NV",NV,2018,22747,21798,949,4.2,546
"Douglas County, NV",NV,2017,22201,21131,1070,4.8,132
"Douglas County, NV",NV,2016,22069,20810,1259,5.7,-175
"Douglas County, NV",NV,2015,22244,20730,1514,6.8,116
"Douglas County, NV",NV,2014,22128,20300,1828,8.3,-338
"Douglas County, NV",NV,2013,22466,20199,2267,10.1,-143
"Douglas County, NV",NV,2012,22609,19919,2690,11.9,-417
"Douglas County, NV",NV,2011,23026,19919,3107,13.5,-101
"Douglas County, NV",NV,2010,23127,19892,3235,14.0,0
"Douglas County, OR",OR,2021,47860,45073,2787,5.8,537
"Douglas County, OR",OR,2020,47323,43658,3665,7.7,886
"Douglas County, OR",OR,2019,46437,44200,2237,4.8,325
"Douglas County, OR",OR,2018,46112,43716,2396,5.2,199
"Douglas County, OR",OR,2017,45913,43500,2413,5.3,330
"Douglas County, OR",OR,2016,45583,42770,2813,6.2,1207
"Douglas County, OR",OR,2015,44376,41128,3248,7.3,79
"Douglas County, OR",OR,2014,44297,40313,3984,9.0,-130
"Douglas County, OR",OR,2013,44427,39796,4631,10.4,-1536
"Douglas County, OR",OR,2012,45963,40478,5485,11.9,-1588
"Douglas County, OR",OR,2011,47551,41451,6100,12.8,-524
"Douglas County, OR",OR,2010,48075,41299,6776,14.1,0
"Douglas County, SD",SD,2021,1529,1491,38,2.5,-13
"Douglas County, SD",SD,2020,1542,1500,42,2.7,-22
"Douglas County, SD",SD,2019,1564,1525,39,2.5,4
"Douglas County, SD",SD,2018,1560,1522,38,2.4,-34
"Douglas County, SD",SD,2017,1594,1550,44,2.8,-86
"Douglas County, SD",SD,2016,1680,1637,43,2.6,-5
"Douglas County, SD",SD,2015,1685,1644,41,2.4,-51
"Douglas County, SD",SD,2014,1736,1687,49,2.8,21
"Douglas County, SD",SD,2013,1715,1662,53,3.1,3
"Douglas County, SD",SD,2012,1712,1657,55,3.2,-59
"Douglas County, SD",SD,2011,1771,1701,70,4.0,1
"Douglas County, SD",SD,2010,1770,1693,77,4.4,0
"Douglas County, WA",WA,2021,21948,20745,1203,5.5,377
"Douglas County, WA",WA,2020,21571,19783,1788,8.3,-765
"Douglas County, WA",WA,2019,22336,21063,1273,5.7,462
"Douglas County, WA",WA,2018,21874,20718,1156,5.3,673
"Douglas County, WA",WA,2017,21201,20021,1180,5.6,656
"Douglas County, WA",WA,2016,20545,19154,1391,6.8,773
"Douglas County, WA",WA,2015,19772,18547,1225,6.2,480
"Douglas County, WA",WA,2014,19292,17961,1331,6.9,397
"Douglas County, WA",WA,2013,18895,17362,1533,8.1,-286
"Douglas County, WA",WA,2012,19181,17583,1598,8.3,77
"Douglas County, WA",WA,2011,19104,17487,1617,8.5,-374
"Douglas County, WA",WA,2010,19478,17769,1709,8.8,0
"Douglas County, WI",WI,2021,23110,22100,1010,4.4,-343
"Douglas County, WI",WI,2020,23453,21315,2138,9.1,316
"Douglas County, WI",WI,2019,23137,22217,920,4.0,-157
"Douglas County, WI",WI,2018,23294,22378,916,3.9,-325
"Douglas County, WI",WI,2017,23619,22575,1044,4.4,120
"Douglas County, WI",WI,2016,23499,22295,1204,5.1,206
"Douglas County, WI",WI,2015,23293,22165,1128,4.8,-219
"Douglas County, WI",WI,2014,23512,22196,1316,5.6,-52
"Douglas County, WI",WI,2013,23564,22015,1549,6.6,159
"Douglas County, WI",WI,2012,23405,21825,1580,6.8,-158
"Douglas County, WI",WI,2011,23563,21833,1730,7.3,-185
"Douglas County, WI",WI,2010,23748,21809,1939,8.2,0
"Drew County, AR",AR,2021,7522,7145,377,5.0,-194
"Drew County, AR",AR,2020,7716,7180,536,6.9,-118
"Drew County, AR",AR,2019,7834,7437,397,5.1,-4
"Drew County, AR",AR,2018,7838,7460,378,4.8,-123
"Drew County, AR",AR,2017,7961,7554,407,5.1,-41
"Drew County, AR",AR,2016,8002,7549,453,5.7,-113
"Drew County, AR",AR,2015,8115,7568,547,6.7,-65
"Drew County, AR",AR,2014,8180,7518,662,8.1,-160
"Drew County, AR",AR,2013,8340,7556,784,9.4,-177
"Drew County, AR",AR,2012,8517,7656,861,10.1,-237
"Drew County, AR",AR,2011,8754,7800,954,10.9,52
"Drew County, AR",AR,2010,8702,7799,903,10.4,0
"Dubois County, IN",IN,2021,22020,21490,530,2.4,-575
"Dubois County, IN",IN,2020,22595,21563,1032,4.6,-658
"Dubois County, IN",IN,2019,23253,22705,548,2.4,-110
"Dubois County, IN",IN,2018,23363,22791,572,2.4,162
"Dubois County, IN",IN,2017,23201,22607,594,2.6,-220
"Dubois County, IN",IN,2016,23421,22702,719,3.1,748
"Dubois County, IN",IN,2015,22673,21910,763,3.4,621
"Dubois County, IN",IN,2014,22052,21157,895,4.1,376
"Dubois County, IN",IN,2013,21676,20545,1131,5.2,65
"Dubois County, IN",IN,2012,21611,20396,1215,5.6,-391
"Dubois County, IN",IN,2011,22002,20695,1307,5.9,51
"Dubois County, IN",IN,2010,21951,20351,1600,7.3,0
"Dubuque County, IA",IA,2021,54963,52531,2432,4.4,-520
"Dubuque County, IA",IA,2020,55483,52324,3159,5.7,-1792
"Dubuque County, IA",IA,2019,57275,55840,1435,2.5,1146
"Dubuque County, IA",IA,2018,56129,54774,1355,2.4,1076
"Dubuque County, IA",IA,2017,55053,53438,1615,2.9,85
"Dubuque County, IA",IA,2016,54968,53029,1939,3.5,-751
"Dubuque County, IA",IA,2015,55719,53699,2020,3.6,152
"Dubuque County, IA",IA,2014,55567,53278,2289,4.1,441
"Dubuque County, IA",IA,2013,55126,52622,2504,4.5,282
"Dubuque County, IA",IA,2012,54844,52350,2494,4.5,233
"Dubuque County, IA",IA,2011,54611,51803,2808,5.1,529
"Dubuque County, IA",IA,2010,54082,50899,3183,5.9,0
"Duchesne County, UT",UT,2021,7748,7372,376,4.9,-81
"Duchesne County, UT",UT,2020,7829,7218,611,7.8,44
"Duchesne County, UT",UT,2019,7785,7485,300,3.9,11
"Duchesne County, UT",UT,2018,7774,7442,332,4.3,-234
"Duchesne County, UT",UT,2017,8008,7564,444,5.5,-62
"Duchesne County, UT",UT,2016,8070,7373,697,8.6,-686
"Duchesne County, UT",UT,2015,8756,8109,647,7.4,-743
"Duchesne County, UT",UT,2014,9499,9170,329,3.5,329
"Duchesne County, UT",UT,2013,9170,8809,361,3.9,176
"Duchesne County, UT",UT,2012,8994,8622,372,4.1,612
"Duchesne County, UT",UT,2011,8382,7803,579,6.9,261
"Duchesne County, UT",UT,2010,8121,7343,778,9.6,0
"Dukes County, MA",MA,2021,9640,9010,630,6.5,98
"Dukes County, MA",MA,2020,9542,8598,944,9.9,-162
"Dukes County, MA",MA,2019,9704,9286,418,4.3,-91
"Dukes County, MA",MA,2018,9795,9331,464,4.7,152
"Dukes County, MA",MA,2017,9643,9162,481,5.0,286
"Dukes County, MA",MA,2016,9357,8857,500,5.3,-106
"Dukes County, MA",MA,2015,9463,8845,618,6.5,-17
"Dukes County, MA",MA,2014,9480,8730,750,7.9,67
"Dukes County, MA",MA,2013,9413,8564,849,9.0,27
"Dukes County, MA",MA,2012,9386,8552,834,8.9,190
"Dukes County, MA",MA,2011,9196,8341,855,9.3,94
"Dukes County, MA",MA,2010,9102,8239,863,9.5,0
"Dundy County, NE",NE,2021,1171,1152,19,1.6,3
"Dundy County, NE",NE,2020,1168,1143,25,2.1,2
"Dundy County, NE",NE,2019,1166,1137,29,2.5,4
"Dundy County, NE",NE,2018,1162,1136,26,2.2,-30
"Dundy County, NE",NE,2017,1192,1163,29,2.4,-10
"Dundy County, NE",NE,2016,1202,1176,26,2.2,1
"Dundy County, NE",NE,2015,1201,1176,25,2.1,-77
"Dundy County, NE",NE,2014,1278,1249,29,2.3,-22
"Dundy County, NE",NE,2013,1300,1265,35,2.7,21
"Dundy County, NE",NE,2012,1279,1243,36,2.8,4
"Dundy County, NE",NE,2011,1275,1238,37,2.9,60
"Dundy County, NE",NE,2010,1215,1176,39,3.2,0
"Dunklin County, MO",MO,2021,11276,10590,686,6.1,-239
"Dunklin County, MO",MO,2020,11515,10679,836,7.3,72
"Dunklin County, MO",MO,2019,11443,10844,599,5.2,-558
"Dunklin County, MO",MO,2018,12001,11353,648,5.4,-413
"Dunklin County, MO",MO,2017,12414,11612,802,6.5,-406
"Dunklin County, MO",MO,2016,12820,11767,1053,8.2,-231
"Dunklin County, MO",MO,2015,13051,11982,1069,8.2,-41
"Dunklin County, MO",MO,2014,13092,11900,1192,9.1,119
"Dunklin County, MO",MO,2013,12973,11675,1298,10.0,842
"Dunklin County, MO",MO,2012,12131,10829,1302,10.7,-173
"Dunklin County, MO",MO,2011,12304,10780,1524,12.4,70
"Dunklin County, MO",MO,2010,12234,10595,1639,13.4,0
"Dunn County, ND",ND,2021,3096,2994,102,3.3,-66
"Dunn County, ND",ND,2020,3162,3016,146,4.6,-115
"Dunn County, ND",ND,2019,3277,3229,48,1.5,175
"Dunn County, ND",ND,2018,3102,3056,46,1.5,-102
"Dunn County, ND",ND,2017,3204,3136,68,2.1,-37
"Dunn County, ND",ND,2016,3241,3139,102,3.1,-746
"Dunn County, ND",ND,2015,3987,3908,79,2.0,-261
"Dunn County, ND",ND,2014,4248,4196,52,1.2,188
"Dunn County, ND",ND,2013,4060,4003,57,1.4,401
"Dunn County, ND",ND,2012,3659,3605,54,1.5,739
"Dunn County, ND",ND,2011,2920,2862,58,2.0,615
"Dunn County, ND",ND,2010,2305,2233,72,3.1,0
"Dunn County, WI",WI,2021,24274,23412,862,3.6,384
"Dunn County, WI",WI,2020,23890,22559,1331,5.6,-356
"Dunn County, WI",WI,2019,24246,23430,816,3.4,-205
"Dunn County, WI",WI,2018,24451,23712,739,3.0,-72
"Dunn County, WI",WI,2017,24523,23728,795,3.2,266
"Dunn County, WI",WI,2016,24257,23290,967,4.0,542
"Dunn County, WI",WI,2015,23715,22673,1042,4.4,104
"Dunn County, WI",WI,2014,23611,22397,1214,5.1,73
"Dunn County, WI",WI,2013,23538,22051,1487,6.3,133
"Dunn County, WI",WI,2012,23405,21890,1515,6.5,82
"Dunn County, WI",WI,2011,23323,21656,1667,7.1,61
"Dunn County, WI",WI,2010,23262,21457,1805,7.8,0
"DuPage County, IL",IL,2021,499576,477095,22481,4.5,-3549
"DuPage County, IL",IL,2020,503125,465172,37953,7.5,-21977
"DuPage County, IL",IL,2019,525102,509120,15982,3.0,2473
"DuPage County, IL",IL,2018,522629,505711,16918,3.2,203
"DuPage County, IL",IL,2017,522426,501579,20847,4.0,5647
"DuPage County, IL",IL,2016,516779,491849,24930,4.8,4982
"DuPage County, IL",IL,2015,511797,487131,24666,4.8,1139
"DuPage County, IL",IL,2014,510658,480977,29681,5.8,-1034
"DuPage County, IL",IL,2013,511692,473708,37984,7.4,3351
"DuPage County, IL",IL,2012,508341,470119,38222,7.5,9019
"DuPage County, IL",IL,2011,499322,457774,41548,8.3,-2871
"DuPage County, IL",IL,2010,502193,457100,45093,9.0,0
"Duplin County, NC",NC,2021,24263,23200,1063,4.4,173
"Duplin County, NC",NC,2020,24090,22781,1309,5.4,-1076
"Duplin County, NC",NC,2019,25166,24172,994,3.9,478
"Duplin County, NC",NC,2018,24688,23611,1077,4.4,-405
"Duplin County, NC",NC,2017,25093,23873,1220,4.9,-1329
"Duplin County, NC",NC,2016,26422,25012,1410,5.3,-37
"Duplin County, NC",NC,2015,26459,24962,1497,5.7,-127
"Duplin County, NC",NC,2014,26586,24937,1649,6.2,92
"Duplin County, NC",NC,2013,26494,24439,2055,7.8,-152
"Duplin County, NC",NC,2012,26646,24156,2490,9.3,278
"Duplin County, NC",NC,2011,26368,23879,2489,9.4,460
"Duplin County, NC",NC,2010,25908,23531,2377,9.2,0
"Durham County, NC",NC,2021,174877,167710,7167,4.1,5521
"Durham County, NC",NC,2020,169356,158846,10510,6.2,-2531
"Durham County, NC",NC,2019,171887,166108,5779,3.4,5509
"Durham County, NC",NC,2018,166378,160424,5954,3.6,3467
"Durham County, NC",NC,2017,162911,156312,6599,4.1,1303
"Durham County, NC",NC,2016,161608,154321,7287,4.5,5144
"Durham County, NC",NC,2015,156464,148713,7751,5.0,3438
"Durham County, NC",NC,2014,153026,145417,7609,5.0,2325
"Durham County, NC",NC,2013,150701,141530,9171,6.1,800
"Durham County, NC",NC,2012,149901,138530,11371,7.6,3838
"Durham County, NC",NC,2011,146063,134256,11807,8.1,2089
"Durham County, NC",NC,2010,143974,132237,11737,8.2,0
"Dutchess County, NY",NY,2021,142246,135918,6328,4.4,-2305
"Dutchess County, NY",NY,2020,144551,133963,10588,7.3,-3633
"Dutchess County, NY",NY,2019,148184,143053,5131,3.5,1463
"Dutchess County, NY",NY,2018,146721,141342,5379,3.7,736
"Dutchess County, NY",NY,2017,145985,139767,6218,4.3,2877
"Dutchess County, NY",NY,2016,143108,137045,6063,4.2,111
"Dutchess County, NY",NY,2015,142997,136526,6471,4.5,933
"Dutchess County, NY",NY,2014,142064,134432,7632,5.4,-3339
"Dutchess County, NY",NY,2013,145403,135453,9950,6.8,-757
"Dutchess County, NY",NY,2012,146160,134622,11538,7.9,-338
"Dutchess County, NY",NY,2011,146498,135428,11070,7.6,-2790
"Dutchess County, NY",NY,2010,149288,137561,11727,7.9,0
"Duval County, FL",FL,2021,492463,470506,21957,4.5,12055
"Duval County, FL",FL,2020,480408,444860,35548,7.4,-2947
"Duval County, FL",FL,2019,483355,466986,16369,3.4,3522
"Duval County, FL",FL,2018,479833,461935,17898,3.7,5368
"Duval County, FL",FL,2017,474465,453958,20507,4.3,5300
"Duval County, FL",FL,2016,469165,445908,23257,5.0,6784
"Duval County, FL",FL,2015,462381,435287,27094,5.9,3059
"Duval County, FL",FL,2014,459322,427557,31765,6.9,2815
"Duval County, FL",FL,2013,456507,420747,35760,7.8,3043
"Duval County, FL",FL,2012,453464,412793,40671,9.0,-233
"Duval County, FL",FL,2011,453697,407240,46457,10.2,2837
"Duval County, FL",FL,2010,450860,401244,49616,11.0,0
"Duval County, TX",TX,2021,5463,5011,452,8.3,664
"Duval County, TX",TX,2020,4799,4215,584,12.2,-95
"Duval County, TX",TX,2019,4894,4676,218,4.5,-124
"Duval County, TX",TX,2018,5018,4753,265,5.3,250
"Duval County, TX",TX,2017,4768,4399,369,7.7,-119
"Duval County, TX",TX,2016,4887,4352,535,10.9,-354
"Duval County, TX",TX,2015,5241,4815,426,8.1,-282
"Duval County, TX",TX,2014,5523,5211,312,5.6,-8
"Duval County, TX",TX,2013,5531,5175,356,6.4,112
"Duval County, TX",TX,2012,5419,5040,379,7.0,206
"Duval County, TX",TX,2011,5213,4706,507,9.7,166
"Duval County, TX",TX,2010,5047,4457,590,11.7,0
"Dyer County, TN",TN,2021,16075,15333,742,4.6,165
"Dyer County, TN",TN,2020,15910,14659,1251,7.9,-555
"Dyer County, TN",TN,2019,16465,15663,802,4.9,247
"Dyer County, TN",TN,2018,16218,15477,741,4.6,112
"Dyer County, TN",TN,2017,16106,15325,781,4.8,-270
"Dyer County, TN",TN,2016,16376,15357,1019,6.2,-320
"Dyer County, TN",TN,2015,16696,15507,1189,7.1,65
"Dyer County, TN",TN,2014,16631,15256,1375,8.3,-488
"Dyer County, TN",TN,2013,17119,15339,1780,10.4,-353
"Dyer County, TN",TN,2012,17472,15519,1953,11.2,-193
"Dyer County, TN",TN,2011,17665,15438,2227,12.6,-187
"Dyer County, TN",TN,2010,17852,15659,2193,12.3,0
"Eagle County, CO",CO,2021,36813,35177,1636,4.4,1430
"Eagle County, CO",CO,2020,35383,32204,3179,9.0,-944
"Eagle County, CO",CO,2019,36327,35553,774,2.1,545
"Eagle County, CO",CO,2018,35782,34891,891,2.5,1262
"Eagle County, CO",CO,2017,34520,33775,745,2.2,787
"Eagle County, CO",CO,2016,33733,32848,885,2.6,978
"Eagle County, CO",CO,2015,32755,31765,990,3.0,374
"Eagle County, CO",CO,2014,32381,31036,1345,4.2,517
"Eagle County, CO",CO,2013,31864,29970,1894,5.9,-387
"Eagle County, CO",CO,2012,32251,29912,2339,7.3,179
"Eagle County, CO",CO,2011,32072,29461,2611,8.1,-270
"Eagle County, CO",CO,2010,32342,29465,2877,8.9,0
"Early County, GA",GA,2021,4338,4121,217,5.0,-80
"Early County, GA",GA,2020,4418,4164,254,5.7,28
"Early County, GA",GA,2019,4390,4211,179,4.1,-157
"Early County, GA",GA,2018,4547,4335,212,4.7,-30
"Early County, GA",GA,2017,4577,4326,251,5.5,176
"Early County, GA",GA,2016,4401,4095,306,7.0,92
"Early County, GA",GA,2015,4309,4005,304,7.1,-28
"Early County, GA",GA,2014,4337,3947,390,9.0,-32
"Early County, GA",GA,2013,4369,3972,397,9.1,-103
"Early County, GA",GA,2012,4472,4025,447,10.0,32
"Early County, GA",GA,2011,4440,3934,506,11.4,-51
"Early County, GA",GA,2010,4491,3957,534,11.9,0
"East Baton Rouge Parish, LA",LA,2021,227407,215464,11943,5.3,1434
"East Baton Rouge Parish, LA",LA,2020,225973,207325,18648,8.3,-4983
"East Baton Rouge Parish, LA",LA,2019,230956,221116,9840,4.3,-1141
"East Baton Rouge Parish, LA",LA,2018,232097,222184,9913,4.3,-58
"East Baton Rouge Parish, LA",LA,2017,232155,221966,10189,4.4,-253
"East Baton Rouge Parish, LA",LA,2016,232408,220408,12000,5.2,-1745
"East Baton Rouge Parish, LA",LA,2015,234153,221537,12616,5.4,3065
"East Baton Rouge Parish, LA",LA,2014,231088,218054,13034,5.6,5017
"East Baton Rouge Parish, LA",LA,2013,226071,212613,13458,6.0,2792
"East Baton Rouge Parish, LA",LA,2012,223279,208946,14333,6.4,1411
"East Baton Rouge Parish, LA",LA,2011,221868,205945,15923,7.2,16
"East Baton Rouge Parish, LA",LA,2010,221852,205954,15898,7.2,0
"East Carroll Parish, LA",LA,2021,1745,1573,172,9.9,-68
"East Carroll Parish, LA",LA,2020,1813,1583,230,12.7,-82
"East Carroll Parish, LA",LA,2019,1895,1702,193,10.2,-64
"East Carroll Parish, LA",LA,2018,1959,1760,199,10.2,-100
"East Carroll Parish, LA",LA,2017,2059,1830,229,11.1,-82
"East Carroll Parish, LA",LA,2016,2141,1893,248,11.6,-65
"East Carroll Parish, LA",LA,2015,2206,1897,309,14.0,-1
"East Carroll Parish, LA",LA,2014,2207,1890,317,14.4,-56
"East Carroll Parish, LA",LA,2013,2263,1894,369,16.3,77
"East Carroll Parish, LA",LA,2012,2186,1765,421,19.3,-151
"East Carroll Parish, LA",LA,2011,2337,1933,404,17.3,-124
"East Carroll Parish, LA",LA,2010,2461,2047,414,16.8,0
"East Feliciana Parish, LA",LA,2021,7654,7306,348,4.5,88
"East Feliciana Parish, LA",LA,2020,7566,7024,542,7.2,-371
"East Feliciana Parish, LA",LA,2019,7937,7582,355,4.5,-100
"East Feliciana Parish, LA",LA,2018,8037,7668,369,4.6,45
"East Feliciana Parish, LA",LA,2017,7992,7609,383,4.8,-122
"East Feliciana Parish, LA",LA,2016,8114,7645,469,5.8,-64
"East Feliciana Parish, LA",LA,2015,8178,7695,483,5.9,26
"East Feliciana Parish, LA",LA,2014,8152,7638,514,6.3,198
"East Feliciana Parish, LA",LA,2013,7954,7430,524,6.6,-40
"East Feliciana Parish, LA",LA,2012,7994,7420,574,7.2,-80
"East Feliciana Parish, LA",LA,2011,8074,7424,650,8.1,-21
"East Feliciana Parish, LA",LA,2010,8095,7457,638,7.9,0
"Eastland County, TX",TX,2021,7341,6918,423,5.8,61
"Eastland County, TX",TX,2020,7280,6790,490,6.7,-966
"Eastland County, TX",TX,2019,8246,7972,274,3.3,-343
"Eastland County, TX",TX,2018,8589,8300,289,3.4,706
"Eastland County, TX",TX,2017,7883,7543,340,4.3,459
"Eastland County, TX",TX,2016,7424,7019,405,5.5,-619
"Eastland County, TX",TX,2015,8043,7658,385,4.8,-308
"Eastland County, TX",TX,2014,8351,7941,410,4.9,-162
"Eastland County, TX",TX,2013,8513,7994,519,6.1,266
"Eastland County, TX",TX,2012,8247,7701,546,6.6,-170
"Eastland County, TX",TX,2011,8417,7751,666,7.9,293
"Eastland County, TX",TX,2010,8124,7419,705,8.7,0
"Eaton County, MI",MI,2021,54084,51211,2873,5.3,-2003
"Eaton County, MI",MI,2020,56087,51632,4455,7.9,-1432
"Eaton County, MI",MI,2019,57519,55526,1993,3.5,250
"Eaton County, MI",MI,2018,57269,55258,2011,3.5,2
"Eaton County, MI",MI,2017,57267,54956,2311,4.0,216
"Eaton County, MI",MI,2016,57051,54670,2381,4.2,928
"Eaton County, MI",MI,2015,56123,53607,2516,4.5,257
"Eaton County, MI",MI,2014,55866,52662,3204,5.7,345
"Eaton County, MI",MI,2013,55521,51854,3667,6.6,412
"Eaton County, MI",MI,2012,55109,51340,3769,6.8,-487
"Eaton County, MI",MI,2011,55596,51306,4290,7.7,-1106
"Eaton County, MI",MI,2010,56702,51387,5315,9.4,0
"Eau Claire County, WI",WI,2021,60074,58133,1941,3.2,1048
"Eau Claire County, WI",WI,2020,59026,55713,3313,5.6,-67
"Eau Claire County, WI",WI,2019,59093,57380,1713,2.9,-170
"Eau Claire County, WI",WI,2018,59263,57728,1535,2.6,-221
"Eau Claire County, WI",WI,2017,59484,57765,1719,2.9,756
"Eau Claire County, WI",WI,2016,58728,56769,1959,3.3,704
"Eau Claire County, WI",WI,2015,58024,55864,2160,3.7,95
"Eau Claire County, WI",WI,2014,57929,55365,2564,4.4,24
"Eau Claire County, WI",WI,2013,57905,54654,3251,5.6,-295
"Eau Claire County, WI",WI,2012,58200,54878,3322,5.7,579
"Eau Claire County, WI",WI,2011,57621,54016,3605,6.3,460
"Eau Claire County, WI",WI,2010,57161,53258,3903,6.8,0
"Echols County, GA",GA,2021,1897,1845,52,2.7,15
"Echols County, GA",GA,2020,1882,1808,74,3.9,-32
"Echols County, GA",GA,2019,1914,1859,55,2.9,-9
"Echols County, GA",GA,2018,1923,1861,62,3.2,0
"Echols County, GA",GA,2017,1923,1847,76,4.0,41
"Echols County, GA",GA,2016,1882,1800,82,4.4,38
"Echols County, GA",GA,2015,1844,1756,88,4.8,63
"Echols County, GA",GA,2014,1781,1676,105,5.9,3
"Echols County, GA",GA,2013,1778,1666,112,6.3,-23
"Echols County, GA",GA,2012,1801,1670,131,7.3,-74
"Echols County, GA",GA,2011,1875,1725,150,8.0,-5
"Echols County, GA",GA,2010,1880,1724,156,8.3,0
"Ector County, TX",TX,2021,80507,73816,6691,8.3,-1612
"Ector County, TX",TX,2020,82119,73046,9073,11.0,-5150
"Ector County, TX",TX,2019,87269,84942,2327,2.7,2462
"Ector County, TX",TX,2018,84807,82497,2310,2.7,6827
"Ector County, TX",TX,2017,77980,74754,3226,4.1,1735
"Ector County, TX",TX,2016,76245,71389,4856,6.4,-3558
"Ector County, TX",TX,2015,79803,76071,3732,4.7,-2446
"Ector County, TX",TX,2014,82249,79378,2871,3.5,3667
"Ector County, TX",TX,2013,78582,75148,3434,4.4,1695
"Ector County, TX",TX,2012,76887,73375,3512,4.6,4130
"Ector County, TX",TX,2011,72757,68142,4615,6.3,4436
"Ector County, TX",TX,2010,68321,62584,5737,8.4,0
"Eddy County, ND",ND,2021,1188,1141,47,4.0,-18
"Eddy County, ND",ND,2020,1206,1150,56,4.6,-30
"Eddy County, ND",ND,2019,1236,1188,48,3.9,-25
"Eddy County, ND",ND,2018,1261,1203,58,4.6,-25
"Eddy County, ND",ND,2017,1286,1226,60,4.7,10
"Eddy County, ND",ND,2016,1276,1221,55,4.3,16
"Eddy County, ND",ND,2015,1260,1200,60,4.8,-15
"Eddy County, ND",ND,2014,1275,1206,69,5.4,19
"Eddy County, ND",ND,2013,1256,1181,75,6.0,14
"Eddy County, ND",ND,2012,1242,1181,61,4.9,-26
"Eddy County, ND",ND,2011,1268,1208,60,4.7,-32
"Eddy County, ND",ND,2010,1300,1239,61,4.7,0
"Eddy County, NM",NM,2021,31522,29501,2021,6.4,-1532
"Eddy County, NM",NM,2020,33054,30859,2195,6.6,-1789
"Eddy County, NM",NM,2019,34843,33748,1095,3.1,2982
"Eddy County, NM",NM,2018,31861,30809,1052,3.3,2386
"Eddy County, NM",NM,2017,29475,27954,1521,5.2,557
"Eddy County, NM",NM,2016,28918,27013,1905,6.6,-1091
"Eddy County, NM",NM,2015,30009,28513,1496,5.0,795
"Eddy County, NM",NM,2014,29214,27936,1278,4.4,1377
"Eddy County, NM",NM,2013,27837,26565,1272,4.6,963
"Eddy County, NM",NM,2012,26874,25644,1230,4.6,506
"Eddy County, NM",NM,2011,26368,25081,1287,4.9,893
"Eddy County, NM",NM,2010,25475,23916,1559,6.1,0
"Edgar County, IL",IL,2021,8931,8572,359,4.0,56
"Edgar County, IL",IL,2020,8875,8277,598,6.7,-82
"Edgar County, IL",IL,2019,8957,8588,369,4.1,-357
"Edgar County, IL",IL,2018,9314,8873,441,4.7,-161
"Edgar County, IL",IL,2017,9475,9008,467,4.9,-272
"Edgar County, IL",IL,2016,9747,9163,584,6.0,299
"Edgar County, IL",IL,2015,9448,8856,592,6.3,315
"Edgar County, IL",IL,2014,9133,8473,660,7.2,109
"Edgar County, IL",IL,2013,9024,8174,850,9.4,-62
"Edgar County, IL",IL,2012,9086,8202,884,9.7,-243
"Edgar County, IL",IL,2011,9329,8348,981,10.5,-118
"Edgar County, IL",IL,2010,9447,8382,1065,11.3,0
"Edgecombe County, NC",NC,2021,20260,18531,1729,8.5,286
"Edgecombe County, NC",NC,2020,19974,17928,2046,10.2,-800
"Edgecombe County, NC",NC,2019,20774,19559,1215,5.8,-424
"Edgecombe County, NC",NC,2018,21198,19728,1470,6.9,-435
"Edgecombe County, NC",NC,2017,21633,19967,1666,7.7,-720
"Edgecombe County, NC",NC,2016,22353,20411,1942,8.7,-433
"Edgecombe County, NC",NC,2015,22786,20629,2157,9.5,-427
"Edgecombe County, NC",NC,2014,23213,20885,2328,10.0,-751
"Edgecombe County, NC",NC,2013,23964,20937,3027,12.6,-637
"Edgecombe County, NC",NC,2012,24601,20997,3604,14.6,-455
"Edgecombe County, NC",NC,2011,25056,21171,3885,15.5,-523
"Edgecombe County, NC",NC,2010,25579,21591,3988,15.6,0
"Edgefield County, SC",SC,2021,10394,10043,351,3.4,42
"Edgefield County, SC",SC,2020,10352,9833,519,5.0,-151
"Edgefield County, SC",SC,2019,10503,10214,289,2.8,122
"Edgefield County, SC",SC,2018,10381,10024,357,3.4,18
"Edgefield County, SC",SC,2017,10363,9897,466,4.5,-151
"Edgefield County, SC",SC,2016,10514,9931,583,5.5,-146
"Edgefield County, SC",SC,2015,10660,9991,669,6.3,108
"Edgefield County, SC",SC,2014,10552,9862,690,6.5,2
"Edgefield County, SC",SC,2013,10550,9723,827,7.8,-108
"Edgefield County, SC",SC,2012,10658,9674,984,9.2,-304
"Edgefield County, SC",SC,2011,10962,9888,1074,9.8,-119
"Edgefield County, SC",SC,2010,11081,9962,1119,10.1,0
"Edmonson County, KY",KY,2021,4655,4418,237,5.1,66
"Edmonson County, KY",KY,2020,4589,4247,342,7.5,-171
"Edmonson County, KY",KY,2019,4760,4534,226,4.7,-49
"Edmonson County, KY",KY,2018,4809,4559,250,5.2,-52
"Edmonson County, KY",KY,2017,4861,4575,286,5.9,57
"Edmonson County, KY",KY,2016,4804,4511,293,6.1,124
"Edmonson County, KY",KY,2015,4680,4355,325,6.9,-102
"Edmonson County, KY",KY,2014,4782,4384,398,8.3,-214
"Edmonson County, KY",KY,2013,4996,4500,496,9.9,-40
"Edmonson County, KY",KY,2012,5036,4532,504,10.0,-98
"Edmonson County, KY",KY,2011,5134,4535,599,11.7,-16
"Edmonson County, KY",KY,2010,5150,4458,692,13.4,0
"Edmunds County, SD",SD,2021,2013,1959,54,2.7,35
"Edmunds County, SD",SD,2020,1978,1924,54,2.7,-46
"Edmunds County, SD",SD,2019,2024,1971,53,2.6,-31
"Edmunds County, SD",SD,2018,2055,2005,50,2.4,-56
"Edmunds County, SD",SD,2017,2111,2056,55,2.6,-63
"Edmunds County, SD",SD,2016,2174,2123,51,2.3,-61
"Edmunds County, SD",SD,2015,2235,2180,55,2.5,-14
"Edmunds County, SD",SD,2014,2249,2193,56,2.5,-50
"Edmunds County, SD",SD,2013,2299,2236,63,2.7,-32
"Edmunds County, SD",SD,2012,2331,2265,66,2.8,-49
"Edmunds County, SD",SD,2011,2380,2303,77,3.2,-16
"Edmunds County, SD",SD,2010,2396,2323,73,3.0,0
"Edwards County, IL",IL,2021,2550,2420,130,5.1,-101
"Edwards County, IL",IL,2020,2651,2426,225,8.5,-67
"Edwards County, IL",IL,2019,2718,2606,112,4.1,-73
"Edwards County, IL",IL,2018,2791,2662,129,4.6,-64
"Edwards County, IL",IL,2017,2855,2721,134,4.7,-129
"Edwards County, IL",IL,2016,2984,2811,173,5.8,34
"Edwards County, IL",IL,2015,2950,2774,176,6.0,99
"Edwards County, IL",IL,2014,2851,2658,193,6.8,-14
"Edwards County, IL",IL,2013,2865,2621,244,8.5,-181
"Edwards County, IL",IL,2012,3046,2806,240,7.9,-89
"Edwards County, IL",IL,2011,3135,2880,255,8.1,-89
"Edwards County, IL",IL,2010,3224,2940,284,8.8,0
"Edwards County, KS",KS,2021,1464,1433,31,2.1,4
"Edwards County, KS",KS,2020,1460,1418,42,2.9,-11
"Edwards County, KS",KS,2019,1471,1434,37,2.5,-30
"Edwards County, KS",KS,2018,1501,1466,35,2.3,-20
"Edwards County, KS",KS,2017,1521,1474,47,3.1,-141
"Edwards County, KS",KS,2016,1662,1612,50,3.0,-92
"Edwards County, KS",KS,2015,1754,1701,53,3.0,146
"Edwards County, KS",KS,2014,1608,1555,53,3.3,-3
"Edwards County, KS",KS,2013,1611,1551,60,3.7,-37
"Edwards County, KS",KS,2012,1648,1582,66,4.0,-25
"Edwards County, KS",KS,2011,1673,1599,74,4.4,-10
"Edwards County, KS",KS,2010,1683,1594,89,5.3,0
"Edwards County, TX",TX,2021,1265,1210,55,4.3,37
"Edwards County, TX",TX,2020,1228,1185,43,3.5,192
"Edwards County, TX",TX,2019,1036,1012,24,2.3,161
"Edwards County, TX",TX,2018,875,850,25,2.9,-24
"Edwards County, TX",TX,2017,899,870,29,3.2,32
"Edwards County, TX",TX,2016,867,827,40,4.6,2
"Edwards County, TX",TX,2015,865,825,40,4.6,-1
"Edwards County, TX",TX,2014,866,828,38,4.4,-36
"Edwards County, TX",TX,2013,902,849,53,5.9,-23
"Edwards County, TX",TX,2012,925,866,59,6.4,-65
"Edwards County, TX",TX,2011,990,923,67,6.8,-48
"Edwards County, TX",TX,2010,1038,964,74,7.1,0
"Effingham County, GA",GA,2021,33266,32292,974,2.9,1389
"Effingham County, GA",GA,2020,31877,30316,1561,4.9,-397
"Effingham County, GA",GA,2019,32274,31320,954,3.0,1245
"Effingham County, GA",GA,2018,31029,30003,1026,3.3,1282
"Effingham County, GA",GA,2017,29747,28534,1213,4.1,1332
"Effingham County, GA",GA,2016,28415,27025,1390,4.9,1561
"Effingham County, GA",GA,2015,26854,25458,1396,5.2,631
"Effingham County, GA",GA,2014,26223,24587,1636,6.2,77
"Effingham County, GA",GA,2013,26146,24286,1860,7.1,275
"Effingham County, GA",GA,2012,25871,23739,2132,8.2,279
"Effingham County, GA",GA,2011,25592,23227,2365,9.2,-257
"Effingham County, GA",GA,2010,25849,23339,2510,9.7,0
"Effingham County, IL",IL,2021,19397,18644,753,3.9,211
"Effingham County, IL",IL,2020,19186,17889,1297,6.8,-149
"Effingham County, IL",IL,2019,19335,18738,597,3.1,103
"Effingham County, IL",IL,2018,19232,18520,712,3.7,312
"Effingham County, IL",IL,2017,18920,18199,721,3.8,145
"Effingham County, IL",IL,2016,18775,17880,895,4.8,327
"Effingham County, IL",IL,2015,18448,17562,886,4.8,91
"Effingham County, IL",IL,2014,18357,17352,1005,5.5,304
"Effingham County, IL",IL,2013,18053,16810,1243,6.9,-382
"Effingham County, IL",IL,2012,18435,17221,1214,6.6,-211
"Effingham County, IL",IL,2011,18646,17361,1285,6.9,20
"Effingham County, IL",IL,2010,18626,17148,1478,7.9,0
"El Dorado County, CA",CA,2021,91142,85910,5232,5.7,412
"El Dorado County, CA",CA,2020,90730,82984,7746,8.5,-1566
"El Dorado County, CA",CA,2019,92296,88993,3303,3.6,1275
"El Dorado County, CA",CA,2018,91021,87691,3330,3.7,1309
"El Dorado County, CA",CA,2017,89712,85766,3946,4.4,888
"El Dorado County, CA",CA,2016,88824,84248,4576,5.2,932
"El Dorado County, CA",CA,2015,87892,82840,5052,5.7,162
"El Dorado County, CA",CA,2014,87730,81532,6198,7.1,-551
"El Dorado County, CA",CA,2013,88281,80677,7604,8.6,-585
"El Dorado County, CA",CA,2012,88866,79638,9228,10.4,-684
"El Dorado County, CA",CA,2011,89550,78876,10674,11.9,-1655
"El Dorado County, CA",CA,2010,91205,79799,11406,12.5,0
"El Paso County, CO",CO,2021,350677,330916,19761,5.6,8680
"El Paso County, CO",CO,2020,341997,318462,23535,6.9,3929
"El Paso County, CO",CO,2019,338068,327573,10495,3.1,6309
"El Paso County, CO",CO,2018,331759,319727,12032,3.6,8941
"El Paso County, CO",CO,2017,322818,313035,9783,3.0,8168
"El Paso County, CO",CO,2016,314650,303352,11298,3.6,7055
"El Paso County, CO",CO,2015,307595,293988,13607,4.4,1057
"El Paso County, CO",CO,2014,306538,288214,18324,6.0,-88
"El Paso County, CO",CO,2013,306626,282804,23822,7.8,450
"El Paso County, CO",CO,2012,306176,278707,27469,9.0,-649
"El Paso County, CO",CO,2011,306825,278004,28821,9.4,1478
"El Paso County, CO",CO,2010,305347,275510,29837,9.8,0
"El Paso County, TX",TX,2021,363843,341151,22692,6.2,4280
"El Paso County, TX",TX,2020,359563,329749,29814,8.3,1408
"El Paso County, TX",TX,2019,358155,344465,13690,3.8,3223
"El Paso County, TX",TX,2018,354932,339827,15105,4.3,3392
"El Paso County, TX",TX,2017,351540,335163,16377,4.7,1605
"El Paso County, TX",TX,2016,349935,332601,17334,5.0,8153
"El Paso County, TX",TX,2015,341782,323955,17827,5.2,-2354
"El Paso County, TX",TX,2014,344136,321731,22405,6.5,-2483
"El Paso County, TX",TX,2013,346619,318975,27644,8.0,-61
"El Paso County, TX",TX,2012,346680,317204,29476,8.5,-236
"El Paso County, TX",TX,2011,346916,312917,33999,9.8,5427
"El Paso County, TX",TX,2010,341489,309927,31562,9.2,0
"Elbert County, CO",CO,2021,15468,14881,587,3.8,468
"Elbert County, CO",CO,2020,15000,14339,661,4.4,-201
"Elbert County, CO",CO,2019,15201,14888,313,2.1,316
"Elbert County, CO",CO,2018,14885,14501,384,2.6,612
"Elbert County, CO",CO,2017,14273,13952,321,2.2,471
"Elbert County, CO",CO,2016,13802,13460,342,2.5,538
"Elbert County, CO",CO,2015,13264,12862,402,3.0,310
"Elbert County, CO",CO,2014,12954,12403,551,4.3,263
"Elbert County, CO",CO,2013,12691,11956,735,5.8,37
"Elbert County, CO",CO,2012,12654,11742,912,7.2,9
"Elbert County, CO",CO,2011,12645,11660,985,7.8,-67
"Elbert County, CO",CO,2010,12712,11635,1077,8.5,0
"Elbert County, GA",GA,2021,7810,7429,381,4.9,-121
"Elbert County, GA",GA,2020,7931,7386,545,6.9,70
"Elbert County, GA",GA,2019,7861,7541,320,4.1,7
"Elbert County, GA",GA,2018,7854,7472,382,4.9,-83
"Elbert County, GA",GA,2017,7937,7517,420,5.3,207
"Elbert County, GA",GA,2016,7730,7223,507,6.6,201
"Elbert County, GA",GA,2015,7529,6960,569,7.6,-527
"Elbert County, GA",GA,2014,8056,7359,697,8.7,-301
"Elbert County, GA",GA,2013,8357,7458,899,10.8,-165
"Elbert County, GA",GA,2012,8522,7466,1056,12.4,-250
"Elbert County, GA",GA,2011,8772,7370,1402,16.0,-191
"Elbert County, GA",GA,2010,8963,7615,1348,15.0,0
"Elk County, KS",KS,2021,1158,1125,33,2.8,-9
"Elk County, KS",KS,2020,1167,1112,55,4.7,7
"Elk County, KS",KS,2019,1160,1117,43,3.7,-14
"Elk County, KS",KS,2018,1174,1136,38,3.2,-19
"Elk County, KS",KS,2017,1193,1143,50,4.2,-1
"Elk County, KS",KS,2016,1194,1135,59,4.9,-89
"Elk County, KS",KS,2015,1283,1222,61,4.8,-28
"Elk County, KS",KS,2014,1311,1244,67,5.1,-15
"Elk County, KS",KS,2013,1326,1251,75,5.7,-26
"Elk County, KS",KS,2012,1352,1260,92,6.8,-36
"Elk County, KS",KS,2011,1388,1284,104,7.5,-26
"Elk County, KS",KS,2010,1414,1297,117,8.3,0
"Elk County, PA",PA,2021,14836,13814,1022,6.9,-584
"Elk County, PA",PA,2020,15420,13546,1874,12.2,-404
"Elk County, PA",PA,2019,15824,15040,784,5.0,-214
"Elk County, PA",PA,2018,16038,15399,639,4.0,-121
"Elk County, PA",PA,2017,16159,15368,791,4.9,-197
"Elk County, PA",PA,2016,16356,15464,892,5.5,22
"Elk County, PA",PA,2015,16334,15514,820,5.0,-4
"Elk County, PA",PA,2014,16338,15490,848,5.2,-74
"Elk County, PA",PA,2013,16412,15327,1085,6.6,-442
"Elk County, PA",PA,2012,16854,15706,1148,6.8,21
"Elk County, PA",PA,2011,16833,15615,1218,7.2,209
"Elk County, PA",PA,2010,16624,15068,1556,9.4,0
"Elkhart County, IN",IN,2021,115907,113007,2900,2.5,5382
"Elkhart County, IN",IN,2020,110525,102105,8420,7.6,-2456
"Elkhart County, IN",IN,2019,112981,109538,3443,3.0,-3184
"Elkhart County, IN",IN,2018,116165,113186,2979,2.6,3810
"Elkhart County, IN",IN,2017,112355,109531,2824,2.5,3771
"Elkhart County, IN",IN,2016,108584,104854,3730,3.4,3878
"Elkhart County, IN",IN,2015,104706,100665,4041,3.9,2498
"Elkhart County, IN",IN,2014,102208,97040,5168,5.1,3073
"Elkhart County, IN",IN,2013,99135,92097,7038,7.1,2214
"Elkhart County, IN",IN,2012,96921,88387,8534,8.8,1375
"Elkhart County, IN",IN,2011,95546,85490,10056,10.5,1104
"Elkhart County, IN",IN,2010,94442,82165,12277,13.0,0
"Elko County, NV",NV,2021,25803,24939,864,3.3,-283
"Elko County, NV",NV,2020,26086,24551,1535,5.9,-1236
"Elko County, NV",NV,2019,27322,26491,831,3.0,62
"Elko County, NV",NV,2018,27260,26419,841,3.1,693
"Elko County, NV",NV,2017,26567,25588,979,3.7,-142
"Elko County, NV",NV,2016,26709,25497,1212,4.5,231
"Elko County, NV",NV,2015,26478,25097,1381,5.2,-1148
"Elko County, NV",NV,2014,27626,26024,1602,5.8,-880
"Elko County, NV",NV,2013,28506,26670,1836,6.4,-334
"Elko County, NV",NV,2012,28840,26932,1908,6.6,945
"Elko County, NV",NV,2011,27895,25833,2062,7.4,1356
"Elko County, NV",NV,2010,26539,24433,2106,7.9,0
"Elliott County, KY",KY,2021,1892,1734,158,8.4,-58
"Elliott County, KY",KY,2020,1950,1761,189,9.7,-76
"Elliott County, KY",KY,2019,2026,1868,158,7.8,-21
"Elliott County, KY",KY,2018,2047,1861,186,9.1,-68
"Elliott County, KY",KY,2017,2115,1894,221,10.4,19
"Elliott County, KY",KY,2016,2096,1858,238,11.4,60
"Elliott County, KY",KY,2015,2036,1829,207,10.2,-118
"Elliott County, KY",KY,2014,2154,1911,243,11.3,-100
"Elliott County, KY",KY,2013,2254,1930,324,14.4,-52
"Elliott County, KY",KY,2012,2306,1973,333,14.4,-31
"Elliott County, KY",KY,2011,2337,1969,368,15.7,-76
"Elliott County, KY",KY,2010,2413,2028,385,16.0,0
"Ellis County, KS",KS,2021,17158,16826,332,1.9,122
"Ellis County, KS",KS,2020,17036,16477,559,3.3,-85
"Ellis County, KS",KS,2019,17121,16737,384,2.2,119
"Ellis County, KS",KS,2018,17002,16609,393,2.3,-61
"Ellis County, KS",KS,2017,17063,16637,426,2.5,-27
"Ellis County, KS",KS,2016,17090,16564,526,3.1,-479
"Ellis County, KS",KS,2015,17569,17044,525,3.0,-368
"Ellis County, KS",KS,2014,17937,17447,490,2.7,-149
"Ellis County, KS",KS,2013,18086,17517,569,3.1,-3
"Ellis County, KS",KS,2012,18089,17471,618,3.4,154
"Ellis County, KS",KS,2011,17935,17310,625,3.5,287
"Ellis County, KS",KS,2010,17648,16961,687,3.9,0
"Ellis County, OK",OK,2021,2102,2043,59,2.8,-27
"Ellis County, OK",OK,2020,2129,2032,97,4.6,1
"Ellis County, OK",OK,2019,2128,2078,50,2.3,-65
"Ellis County, OK",OK,2018,2193,2147,46,2.1,-23
"Ellis County, OK",OK,2017,2216,2150,66,3.0,-38
"Ellis County, OK",OK,2016,2254,2171,83,3.7,-136
"Ellis County, OK",OK,2015,2390,2295,95,4.0,52
"Ellis County, OK",OK,2014,2338,2270,68,2.9,8
"Ellis County, OK",OK,2013,2330,2260,70,3.0,58
"Ellis County, OK",OK,2012,2272,2209,63,2.8,163
"Ellis County, OK",OK,2011,2109,2033,76,3.6,49
"Ellis County, OK",OK,2010,2060,1954,106,5.1,0
"Ellis County, TX",TX,2021,98901,94460,4441,4.5,4335
"Ellis County, TX",TX,2020,94566,88922,5644,6.0,1587
"Ellis County, TX",TX,2019,92979,90096,2883,3.1,3164
"Ellis County, TX",TX,2018,89815,86816,2999,3.3,2672
"Ellis County, TX",TX,2017,87143,84093,3050,3.5,2118
"Ellis County, TX",TX,2016,85025,81835,3190,3.8,4046
"Ellis County, TX",TX,2015,80979,77765,3214,4.0,2008
"Ellis County, TX",TX,2014,78971,75034,3937,5.0,1450
"Ellis County, TX",TX,2013,77521,72696,4825,6.2,918
"Ellis County, TX",TX,2012,76603,71457,5146,6.7,-237
"Ellis County, TX",TX,2011,76840,70690,6150,8.0,1062
"Ellis County, TX",TX,2010,75778,69678,6100,8.0,0
"Ellsworth County, KS",KS,2021,2701,2641,60,2.2,-3
"Ellsworth County, KS",KS,2020,2704,2623,81,3.0,-52
"Ellsworth County, KS",KS,2019,2756,2680,76,2.8,56
"Ellsworth County, KS",KS,2018,2700,2627,73,2.7,-27
"Ellsworth County, KS",KS,2017,2727,2644,83,3.0,-119
"Ellsworth County, KS",KS,2016,2846,2737,109,3.8,-100
"Ellsworth County, KS",KS,2015,2946,2838,108,3.7,-504
"Ellsworth County, KS",KS,2014,3450,3349,101,2.9,-4
"Ellsworth County, KS",KS,2013,3454,3339,115,3.3,-46
"Ellsworth County, KS",KS,2012,3500,3378,122,3.5,-8
"Ellsworth County, KS",KS,2011,3508,3368,140,4.0,112
"Ellsworth County, KS",KS,2010,3396,3238,158,4.7,0
"Elmore County, AL",AL,2021,37582,36560,1022,2.7,-80
"Elmore County, AL",AL,2020,37662,35657,2005,5.3,-144
"Elmore County, AL",AL,2019,37806,36767,1039,2.7,-187
"Elmore County, AL",AL,2018,37993,36692,1301,3.4,351
"Elmore County, AL",AL,2017,37642,36222,1420,3.8,721
"Elmore County, AL",AL,2016,36921,35161,1760,4.8,266
"Elmore County, AL",AL,2015,36655,34803,1852,5.1,45
"Elmore County, AL",AL,2014,36610,34530,2080,5.7,-278
"Elmore County, AL",AL,2013,36888,34585,2303,6.2,231
"Elmore County, AL",AL,2012,36657,34045,2612,7.1,46
"Elmore County, AL",AL,2011,36611,33538,3073,8.4,-121
"Elmore County, AL",AL,2010,36732,33435,3297,9.0,0
"Elmore County, ID",ID,2021,12015,11566,449,3.7,105
"Elmore County, ID",ID,2020,11910,11323,587,4.9,248
"Elmore County, ID",ID,2019,11662,11275,387,3.3,190
"Elmore County, ID",ID,2018,11472,11091,381,3.3,209
"Elmore County, ID",ID,2017,11263,10850,413,3.7,315
"Elmore County, ID",ID,2016,10948,10511,437,4.0,203
"Elmore County, ID",ID,2015,10745,10274,471,4.4,-213
"Elmore County, ID",ID,2014,10958,10438,520,4.7,73
"Elmore County, ID",ID,2013,10885,10072,813,7.5,165
"Elmore County, ID",ID,2012,10720,9891,829,7.7,-274
"Elmore County, ID",ID,2011,10994,10095,899,8.2,-419
"Elmore County, ID",ID,2010,11413,10447,966,8.5,0
"Emanuel County, GA",GA,2021,8698,8240,458,5.3,130
"Emanuel County, GA",GA,2020,8568,7971,597,7.0,139
"Emanuel County, GA",GA,2019,8429,7966,463,5.5,77
"Emanuel County, GA",GA,2018,8352,7852,500,6.0,-327
"Emanuel County, GA",GA,2017,8679,8094,585,6.7,231
"Emanuel County, GA",GA,2016,8448,7786,662,7.8,221
"Emanuel County, GA",GA,2015,8227,7495,732,8.9,-346
"Emanuel County, GA",GA,2014,8573,7673,900,10.5,-259
"Emanuel County, GA",GA,2013,8832,7732,1100,12.5,-225
"Emanuel County, GA",GA,2012,9057,7951,1106,12.2,-90
"Emanuel County, GA",GA,2011,9147,7936,1211,13.2,0
"Emanuel County, GA",GA,2010,9147,7956,1191,13.0,0
"Emery County, UT",UT,2021,4450,4278,172,3.9,46
"Emery County, UT",UT,2020,4404,4193,211,4.8,72
"Emery County, UT",UT,2019,4332,4161,171,3.9,-25
"Emery County, UT",UT,2018,4357,4160,197,4.5,152
"Emery County, UT",UT,2017,4205,3997,208,4.9,-41
"Emery County, UT",UT,2016,4246,3988,258,6.1,-131
"Emery County, UT",UT,2015,4377,4117,260,5.9,-194
"Emery County, UT",UT,2014,4571,4339,232,5.1,-68
"Emery County, UT",UT,2013,4639,4381,258,5.6,-12
"Emery County, UT",UT,2012,4651,4356,295,6.3,-386
"Emery County, UT",UT,2011,5037,4651,386,7.7,-228
"Emery County, UT",UT,2010,5265,4878,387,7.4,0
"Emmet County, IA",IA,2021,4928,4727,201,4.1,-147
"Emmet County, IA",IA,2020,5075,4830,245,4.8,-288
"Emmet County, IA",IA,2019,5363,5232,131,2.4,-11
"Emmet County, IA",IA,2018,5374,5227,147,2.7,-82
"Emmet County, IA",IA,2017,5456,5285,171,3.1,-168
"Emmet County, IA",IA,2016,5624,5387,237,4.2,-40
"Emmet County, IA",IA,2015,5664,5455,209,3.7,-69
"Emmet County, IA",IA,2014,5733,5507,226,3.9,42
"Emmet County, IA",IA,2013,5691,5458,233,4.1,-45
"Emmet County, IA",IA,2012,5736,5479,257,4.5,-77
"Emmet County, IA",IA,2011,5813,5481,332,5.7,-44
"Emmet County, IA",IA,2010,5857,5437,420,7.2,0
"Emmet County, MI",MI,2021,16348,15305,1043,6.4,-811
"Emmet County, MI",MI,2020,17159,15304,1855,10.8,-571
"Emmet County, MI",MI,2019,17730,16754,976,5.5,16
"Emmet County, MI",MI,2018,17714,16665,1049,5.9,66
"Emmet County, MI",MI,2017,17648,16515,1133,6.4,-1
"Emmet County, MI",MI,2016,17649,16489,1160,6.6,-76
"Emmet County, MI",MI,2015,17725,16431,1294,7.3,-255
"Emmet County, MI",MI,2014,17980,16262,1718,9.6,-199
"Emmet County, MI",MI,2013,18179,16047,2132,11.7,319
"Emmet County, MI",MI,2012,17860,15748,2112,11.8,-122
"Emmet County, MI",MI,2011,17982,15721,2261,12.6,-337
"Emmet County, MI",MI,2010,18319,15752,2567,14.0,0
"Emmons County, ND",ND,2021,1490,1421,69,4.6,-4
"Emmons County, ND",ND,2020,1494,1422,72,4.8,38
"Emmons County, ND",ND,2019,1456,1402,54,3.7,-48
"Emmons County, ND",ND,2018,1504,1438,66,4.4,-65
"Emmons County, ND",ND,2017,1569,1507,62,4.0,-12
"Emmons County, ND",ND,2016,1581,1512,69,4.4,42
"Emmons County, ND",ND,2015,1539,1463,76,4.9,-2
"Emmons County, ND",ND,2014,1541,1457,84,5.5,-31
"Emmons County, ND",ND,2013,1572,1489,83,5.3,-64
"Emmons County, ND",ND,2012,1636,1552,84,5.1,-128
"Emmons County, ND",ND,2011,1764,1661,103,5.8,-64
"Emmons County, ND",ND,2010,1828,1705,123,6.7,0
"Emporia city, VA",VA,2021,2336,2153,183,7.8,-11
"Emporia city, VA",VA,2020,2347,2090,257,11.0,14
"Emporia city, VA",VA,2019,2333,2218,115,4.9,-23
"Emporia city, VA",VA,2018,2356,2245,111,4.7,-28
"Emporia city, VA",VA,2017,2384,2260,124,5.2,138
"Emporia city, VA",VA,2016,2246,2104,142,6.3,-6
"Emporia city, VA",VA,2015,2252,2098,154,6.8,-67
"Emporia city, VA",VA,2014,2319,2133,186,8.0,-61
"Emporia city, VA",VA,2013,2380,2151,229,9.6,-84
"Emporia city, VA",VA,2012,2464,2209,255,10.3,-89
"Emporia city, VA",VA,2011,2553,2277,276,10.8,-23
"Emporia city, VA",VA,2010,2576,2250,326,12.7,0
"Erath County, TX",TX,2021,20529,19610,919,4.5,708
"Erath County, TX",TX,2020,19821,18684,1137,5.7,-783
"Erath County, TX",TX,2019,20604,19954,650,3.2,52
"Erath County, TX",TX,2018,20552,19912,640,3.1,20
"Erath County, TX",TX,2017,20532,19825,707,3.4,292
"Erath County, TX",TX,2016,20240,19418,822,4.1,72
"Erath County, TX",TX,2015,20168,19371,797,4.0,98
"Erath County, TX",TX,2014,20070,19205,865,4.3,259
"Erath County, TX",TX,2013,19811,18733,1078,5.4,-199
"Erath County, TX",TX,2012,20010,18904,1106,5.5,-658
"Erath County, TX",TX,2011,20668,19377,1291,6.2,141
"Erath County, TX",TX,2010,20527,19197,1330,6.5,0
"Erie County, NY",NY,2021,435588,411823,23765,5.5,-9482
"Erie County, NY",NY,2020,445070,404444,40626,9.1,-7467
"Erie County, NY",NY,2019,452537,434058,18479,4.1,913
"Erie County, NY",NY,2018,451624,431796,19828,4.4,-817
"Erie County, NY",NY,2017,452441,429193,23248,5.1,7068
"Erie County, NY",NY,2016,445373,423060,22313,5.0,-2540
"Erie County, NY",NY,2015,447913,423855,24058,5.4,31
"Erie County, NY",NY,2014,447882,420334,27548,6.2,-11899
"Erie County, NY",NY,2013,459781,424800,34981,7.6,-1322
"Erie County, NY",NY,2012,461103,422256,38847,8.4,1695
"Erie County, NY",NY,2011,459408,422449,36959,8.0,-6607
"Erie County, NY",NY,2010,466015,426603,39412,8.5,0
"Erie County, OH",OH,2021,37279,34918,2361,6.3,825
"Erie County, OH",OH,2020,36454,32666,3788,10.4,-1200
"Erie County, OH",OH,2019,37654,35782,1872,5.0,-436
"Erie County, OH",OH,2018,38090,35970,2120,5.6,-262
"Erie County, OH",OH,2017,38352,36009,2343,6.1,778
"Erie County, OH",OH,2016,37574,35494,2080,5.5,87
"Erie County, OH",OH,2015,37487,35388,2099,5.6,-25
"Erie County, OH",OH,2014,37512,35106,2406,6.4,-1014
"Erie County, OH",OH,2013,38526,35408,3118,8.1,-119
"Erie County, OH",OH,2012,38645,35554,3091,8.0,-1058
"Erie County, OH",OH,2011,39703,35929,3774,9.5,-531
"Erie County, OH",OH,2010,40234,35677,4557,11.3,0
"Erie County, PA",PA,2021,126536,117276,9260,7.3,-2187
"Erie County, PA",PA,2020,128723,116100,12623,9.8,-1636
"Erie County, PA",PA,2019,130359,124269,6090,4.7,-248
"Erie County, PA",PA,2018,130607,124230,6377,4.9,-1346
"Erie County, PA",PA,2017,131953,124230,7723,5.9,-1836
"Erie County, PA",PA,2016,133789,125178,8611,6.4,-1012
"Erie County, PA",PA,2015,134801,127260,7541,5.6,311
"Erie County, PA",PA,2014,134490,126078,8412,6.3,-1037
"Erie County, PA",PA,2013,135527,125776,9751,7.2,-1601
"Erie County, PA",PA,2012,137128,126665,10463,7.6,153
"Erie County, PA",PA,2011,136975,126053,10922,8.0,1098
"Erie County, PA",PA,2010,135877,123620,12257,9.0,0
"Escambia County, AL",AL,2021,14000,13425,575,4.1,-604
"Escambia County, AL",AL,2020,14604,13611,993,6.8,-239
"Escambia County, AL",AL,2019,14843,14293,550,3.7,262
"Escambia County, AL",AL,2018,14581,13924,657,4.5,-32
"Escambia County, AL",AL,2017,14613,13868,745,5.1,180
"Escambia County, AL",AL,2016,14433,13472,961,6.7,-131
"Escambia County, AL",AL,2015,14564,13535,1029,7.1,175
"Escambia County, AL",AL,2014,14389,13244,1145,8.0,108
"Escambia County, AL",AL,2013,14281,13037,1244,8.7,-468
"Escambia County, AL",AL,2012,14749,13358,1391,9.4,-218
"Escambia County, AL",AL,2011,14967,13361,1606,10.7,-33
"Escambia County, AL",AL,2010,15000,13266,1734,11.6,0
"Escambia County, FL",FL,2021,146033,139420,6613,4.5,2396
"Escambia County, FL",FL,2020,143637,133112,10525,7.3,24
"Escambia County, FL",FL,2019,143613,138852,4761,3.3,1639
"Escambia County, FL",FL,2018,141974,136726,5248,3.7,990
"Escambia County, FL",FL,2017,140984,134980,6004,4.3,-435
"Escambia County, FL",FL,2016,141419,134347,7072,5.0,2748
"Escambia County, FL",FL,2015,138671,130843,7828,5.6,-457
"Escambia County, FL",FL,2014,139128,129917,9211,6.6,487
"Escambia County, FL",FL,2013,138641,128161,10480,7.6,-139
"Escambia County, FL",FL,2012,138780,126754,12026,8.7,-1111
"Escambia County, FL",FL,2011,139891,126413,13478,9.6,1219
"Escambia County, FL",FL,2010,138672,125154,13518,9.7,0
"Esmeralda County, NV",NV,2021,426,410,16,3.8,9
"Esmeralda County, NV",NV,2020,417,395,22,5.3,-43
"Esmeralda County, NV",NV,2019,460,443,17,3.7,39
"Esmeralda County, NV",NV,2018,421,400,21,5.0,-60
"Esmeralda County, NV",NV,2017,481,461,20,4.2,-30
"Esmeralda County, NV",NV,2016,511,487,24,4.7,-9
"Esmeralda County, NV",NV,2015,520,497,23,4.4,-15
"Esmeralda County, NV",NV,2014,535,511,24,4.5,-2
"Esmeralda County, NV",NV,2013,537,510,27,5.0,65
"Esmeralda County, NV",NV,2012,472,438,34,7.2,55
"Esmeralda County, NV",NV,2011,417,383,34,8.2,35
"Esmeralda County, NV",NV,2010,382,344,38,9.9,0
"Essex County, MA",MA,2021,423777,396759,27018,6.4,-408
"Essex County, MA",MA,2020,424185,380186,43999,10.4,-7395
"Essex County, MA",MA,2019,431580,418029,13551,3.1,1343
"Essex County, MA",MA,2018,430237,415008,15229,3.5,8402
"Essex County, MA",MA,2017,421835,405437,16398,3.9,11281
"Essex County, MA",MA,2016,410554,393617,16937,4.1,2788
"Essex County, MA",MA,2015,407766,387425,20341,5.0,2549
"Essex County, MA",MA,2014,405217,380981,24236,6.0,5500
"Essex County, MA",MA,2013,399717,371871,27846,7.0,1810
"Essex County, MA",MA,2012,397907,369621,28286,7.1,3691
"Essex County, MA",MA,2011,394216,364243,29973,7.6,2156
"Essex County, MA",MA,2010,392060,358956,33104,8.4,0
"Essex County, NJ",NJ,2021,385997,355103,30894,8.0,-1322
"Essex County, NJ",NJ,2020,387319,343539,43780,11.3,1761
"Essex County, NJ",NJ,2019,385558,369214,16344,4.2,5811
"Essex County, NJ",NJ,2018,379747,360905,18842,5.0,-1298
"Essex County, NJ",NJ,2017,381045,359991,21054,5.5,11147
"Essex County, NJ",NJ,2016,369898,347867,22031,6.0,-2030
"Essex County, NJ",NJ,2015,371928,346533,25395,6.8,-2465
"Essex County, NJ",NJ,2014,374393,344497,29896,8.0,-4372
"Essex County, NJ",NJ,2013,378765,341374,37391,9.9,-4743
"Essex County, NJ",NJ,2012,383508,342112,41396,10.8,539
"Essex County, NJ",NJ,2011,382969,341486,41483,10.8,185
"Essex County, NJ",NJ,2010,382784,340655,42129,11.0,0
"Essex County, NY",NY,2021,16744,15955,789,4.7,-108
"Essex County, NY",NY,2020,16852,15526,1326,7.9,-537
"Essex County, NY",NY,2019,17389,16603,786,4.5,-23
"Essex County, NY",NY,2018,17412,16575,837,4.8,-69
"Essex County, NY",NY,2017,17481,16531,950,5.4,233
"Essex County, NY",NY,2016,17248,16311,937,5.4,-35
"Essex County, NY",NY,2015,17283,16235,1048,6.1,-245
"Essex County, NY",NY,2014,17528,16312,1216,6.9,-567
"Essex County, NY",NY,2013,18095,16561,1534,8.5,-57
"Essex County, NY",NY,2012,18152,16392,1760,9.7,-75
"Essex County, NY",NY,2011,18227,16559,1668,9.2,-526
"Essex County, NY",NY,2010,18753,17006,1747,9.3,0
"Essex County, VA",VA,2021,5284,5028,256,4.8,-204
"Essex County, VA",VA,2020,5488,5109,379,6.9,-87
"Essex County, VA",VA,2019,5575,5379,196,3.5,15
"Essex County, VA",VA,2018,5560,5350,210,3.8,-83
"Essex County, VA",VA,2017,5643,5374,269,4.8,114
"Essex County, VA",VA,2016,5529,5267,262,4.7,-2
"Essex County, VA",VA,2015,5531,5238,293,5.3,-169
"Essex County, VA",VA,2014,5700,5344,356,6.2,14
"Essex County, VA",VA,2013,5686,5316,370,6.5,-47
"Essex County, VA",VA,2012,5733,5320,413,7.2,43
"Essex County, VA",VA,2011,5690,5219,471,8.3,-37
"Essex County, VA",VA,2010,5727,5194,533,9.3,0
"Essex County, VT",VT,2021,2613,2487,126,4.8,-101
"Essex County, VT",VT,2020,2714,2507,207,7.6,-61
"Essex County, VT",VT,2019,2775,2686,89,3.2,-6
"Essex County, VT",VT,2018,2781,2681,100,3.6,11
"Essex County, VT",VT,2017,2770,2642,128,4.6,62
"Essex County, VT",VT,2016,2708,2577,131,4.8,-62
"Essex County, VT",VT,2015,2770,2612,158,5.7,-12
"Essex County, VT",VT,2014,2782,2616,166,6.0,-56
"Essex County, VT",VT,2013,2838,2647,191,6.7,-85
"Essex County, VT",VT,2012,2923,2694,229,7.8,-135
"Essex County, VT",VT,2011,3058,2798,260,8.5,-122
"Essex County, VT",VT,2010,3180,2851,329,10.3,0
"Estill County, KY",KY,2021,5137,4871,266,5.2,0
"Estill County, KY",KY,2020,5137,4761,376,7.3,-235
"Estill County, KY",KY,2019,5372,5119,253,4.7,57
"Estill County, KY",KY,2018,5315,5033,282,5.3,-33
"Estill County, KY",KY,2017,5348,5035,313,5.9,107
"Estill County, KY",KY,2016,5241,4936,305,5.8,49
"Estill County, KY",KY,2015,5192,4874,318,6.1,-216
"Estill County, KY",KY,2014,5408,5003,405,7.5,-128
"Estill County, KY",KY,2013,5536,5002,534,9.6,-86
"Estill County, KY",KY,2012,5622,5057,565,10.0,2
"Estill County, KY",KY,2011,5620,4924,696,12.4,-106
"Estill County, KY",KY,2010,5726,4944,782,13.7,0
"Etowah County, AL",AL,2021,39262,37658,1604,4.1,-2155
"Etowah County, AL",AL,2020,41417,37912,3505,8.5,-1710
"Etowah County, AL",AL,2019,43127,41603,1524,3.5,-587
"Etowah County, AL",AL,2018,43714,41935,1779,4.1,152
"Etowah County, AL",AL,2017,43562,41517,2045,4.7,648
"Etowah County, AL",AL,2016,42914,40372,2542,5.9,328
"Etowah County, AL",AL,2015,42586,39936,2650,6.2,-1212
"Etowah County, AL",AL,2014,43798,40729,3069,7.0,-32
"Etowah County, AL",AL,2013,43830,40453,3377,7.7,-453
"Etowah County, AL",AL,2012,44283,40540,3743,8.5,-440
"Etowah County, AL",AL,2011,44723,40258,4465,10.0,705
"Etowah County, AL",AL,2010,44018,39278,4740,10.8,0
"Eureka County, NV",NV,2021,1053,1026,27,2.6,34
"Eureka County, NV",NV,2020,1019,983,36,3.5,-80
"Eureka County, NV",NV,2019,1099,1072,27,2.5,13
"Eureka County, NV",NV,2018,1086,1059,27,2.5,50
"Eureka County, NV",NV,2017,1036,1005,31,3.0,56
"Eureka County, NV",NV,2016,980,935,45,4.6,-6
"Eureka County, NV",NV,2015,986,928,58,5.9,-30
"Eureka County, NV",NV,2014,1016,954,62,6.1,-64
"Eureka County, NV",NV,2013,1080,1012,68,6.3,-11
"Eureka County, NV",NV,2012,1091,1022,69,6.3,30
"Eureka County, NV",NV,2011,1061,986,75,7.1,43
"Eureka County, NV",NV,2010,1018,937,81,8.0,0
"Evangeline Parish, LA",LA,2021,11985,11333,652,5.4,45
"Evangeline Parish, LA",LA,2020,11940,10953,987,8.3,-13
"Evangeline Parish, LA",LA,2019,11953,11274,679,5.7,-181
"Evangeline Parish, LA",LA,2018,12134,11447,687,5.7,-427
"Evangeline Parish, LA",LA,2017,12561,11819,742,5.9,-125
"Evangeline Parish, LA",LA,2016,12686,11745,941,7.4,-248
"Evangeline Parish, LA",LA,2015,12934,11967,967,7.5,-143
"Evangeline Parish, LA",LA,2014,13077,12210,867,6.6,211
"Evangeline Parish, LA",LA,2013,12866,12029,837,6.5,-23
"Evangeline Parish, LA",LA,2012,12889,11977,912,7.1,-181
"Evangeline Parish, LA",LA,2011,13070,12024,1046,8.0,-57
"Evangeline Parish, LA",LA,2010,13127,12064,1063,8.1,0
"Evans County, GA",GA,2021,5179,4998,181,3.5,171
"Evans County, GA",GA,2020,5008,4751,257,5.1,58
"Evans County, GA",GA,2019,4950,4777,173,3.5,30
"Evans County, GA",GA,2018,4920,4736,184,3.7,-17
"Evans County, GA",GA,2017,4937,4720,217,4.4,149
"Evans County, GA",GA,2016,4788,4550,238,5.0,178
"Evans County, GA",GA,2015,4610,4348,262,5.7,-119
"Evans County, GA",GA,2014,4729,4423,306,6.5,8
"Evans County, GA",GA,2013,4721,4364,357,7.6,-66
"Evans County, GA",GA,2012,4787,4384,403,8.4,-13
"Evans County, GA",GA,2011,4800,4365,435,9.1,19
"Evans County, GA",GA,2010,4781,4341,440,9.2,0
"Fairbanks North Star Borough, AK",AK,2021,45375,43099,2276,5.0,778
"Fairbanks North Star Borough, AK",AK,2020,44597,41628,2969,6.7,-777
"Fairbanks North Star Borough, AK",AK,2019,45374,43216,2158,4.8,-491
"Fairbanks North Star Borough, AK",AK,2018,45865,43466,2399,5.2,-557
"Fairbanks North Star Borough, AK",AK,2017,46422,43775,2647,5.7,-21
"Fairbanks North Star Borough, AK",AK,2016,46443,43824,2619,5.6,135
"Fairbanks North Star Borough, AK",AK,2015,46308,43862,2446,5.3,-354
"Fairbanks North Star Borough, AK",AK,2014,46662,44016,2646,5.7,-395
"Fairbanks North Star Borough, AK",AK,2013,47057,44292,2765,5.9,-952
"Fairbanks North Star Borough, AK",AK,2012,48009,45047,2962,6.2,-158
"Fairbanks North Star Borough, AK",AK,2011,48167,44992,3175,6.6,-67
"Fairbanks North Star Borough, AK",AK,2010,48234,44917,3317,6.9,0
"Fairfax city, VA",VA,2021,12429,12004,425,3.4,-267
"Fairfax city, VA",VA,2020,12696,11962,734,5.8,-652
"Fairfax city, VA",VA,2019,13348,13063,285,2.1,-59
"Fairfax city, VA",VA,2018,13407,13104,303,2.3,325
"Fairfax city, VA",VA,2017,13082,12710,372,2.8,89
"Fairfax city, VA",VA,2016,12993,12602,391,3.0,140
"Fairfax city, VA",VA,2015,12853,12409,444,3.5,-439
"Fairfax city, VA",VA,2014,13292,12755,537,4.0,174
"Fairfax city, VA",VA,2013,13118,12585,533,4.1,200
"Fairfax city, VA",VA,2012,12918,12373,545,4.2,226
"Fairfax city, VA",VA,2011,12692,12070,622,4.9,18
"Fairfax city, VA",VA,2010,12674,11967,707,5.6,0
"Fairfax County, VA",VA,2021,614999,593574,21425,3.5,-12998
"Fairfax County, VA",VA,2020,627997,591622,36375,5.8,-15068
"Fairfax County, VA",VA,2019,643065,628443,14622,2.3,9770
"Fairfax County, VA",VA,2018,633295,617899,15396,2.4,4221
"Fairfax County, VA",VA,2017,629074,610106,18968,3.0,11381
"Fairfax County, VA",VA,2016,617693,598093,19600,3.2,1508
"Fairfax County, VA",VA,2015,616185,594499,21686,3.5,-5931
"Fairfax County, VA",VA,2014,622116,596624,25492,4.1,-2527
"Fairfax County, VA",VA,2013,624643,597713,26930,4.3,1529
"Fairfax County, VA",VA,2012,623114,595562,27552,4.4,3855
"Fairfax County, VA",VA,2011,619259,589888,29371,4.7,8204
"Fairfax County, VA",VA,2010,611055,579209,31846,5.2,0
"Fairfield County, CT",CT,2021,465448,437051,28397,6.1,-7760
"Fairfield County, CT",CT,2020,473208,436155,37053,7.8,-15875
"Fairfield County, CT",CT,2019,489083,472261,16822,3.4,3164
"Fairfield County, CT",CT,2018,485919,467592,18327,3.8,835
"Fairfield County, CT",CT,2017,485084,464383,20701,4.3,4855
"Fairfield County, CT",CT,2016,480229,458116,22113,4.6,1239
"Fairfield County, CT",CT,2015,478990,453727,25263,5.3,2652
"Fairfield County, CT",CT,2014,476338,446866,29472,6.2,7660
"Fairfield County, CT",CT,2013,468678,433968,34710,7.4,-3861
"Fairfield County, CT",CT,2012,472539,435691,36848,7.8,-4286
"Fairfield County, CT",CT,2011,476825,436824,40001,8.4,3717
"Fairfield County, CT",CT,2010,473108,431251,41857,8.8,0
"Fairfield County, OH",OH,2021,79813,76349,3464,4.3,1255
"Fairfield County, OH",OH,2020,78558,73344,5214,6.6,-600
"Fairfield County, OH",OH,2019,79158,76176,2982,3.8,1619
"Fairfield County, OH",OH,2018,77539,74393,3146,4.1,1
"Fairfield County, OH",OH,2017,77538,74228,3310,4.3,1285
"Fairfield County, OH",OH,2016,76253,72940,3313,4.3,1128
"Fairfield County, OH",OH,2015,75125,71819,3306,4.4,267
"Fairfield County, OH",OH,2014,74858,70977,3881,5.2,860
"Fairfield County, OH",OH,2013,73998,69090,4908,6.6,645
"Fairfield County, OH",OH,2012,73353,68486,4867,6.6,-430
"Fairfield County, OH",OH,2011,73783,67835,5948,8.1,-614
"Fairfield County, OH",OH,2010,74397,67510,6887,9.3,0
"Fairfield County, SC",SC,2021,9231,8691,540,5.8,49
"Fairfield County, SC",SC,2020,9182,8462,720,7.8,-107
"Fairfield County, SC",SC,2019,9289,8882,407,4.4,-101
"Fairfield County, SC",SC,2018,9390,8811,579,6.2,-323
"Fairfield County, SC",SC,2017,9713,9009,704,7.2,-249
"Fairfield County, SC",SC,2016,9962,9258,704,7.1,-52
"Fairfield County, SC",SC,2015,10014,9215,799,8.0,-9
"Fairfield County, SC",SC,2014,10023,9176,847,8.5,-97
"Fairfield County, SC",SC,2013,10120,9059,1061,10.5,-279
"Fairfield County, SC",SC,2012,10399,9072,1327,12.8,-189
"Fairfield County, SC",SC,2011,10588,9070,1518,14.3,-185
"Fairfield County, SC",SC,2010,10773,9177,1596,14.8,0
"Fajardo Municipio, PR",PR,2021,11387,10321,1066,9.4,
"Fajardo Municipio, PR",PR,2020,N.A.,N.A.,N.A.,N.A.,
"Fajardo Municipio, PR",PR,2019,10866,9697,1169,10.8,-310
"Fajardo Municipio, PR",PR,2018,11176,9601,1575,14.1,64
"Fajardo Municipio, PR",PR,2017,11112,9630,1482,13.3,-173
"Fajardo Municipio, PR",PR,2016,11285,9728,1557,13.8,-267
"Fajardo Municipio, PR",PR,2015,11552,9848,1704,14.8,-359
"Fajardo Municipio, PR",PR,2014,11911,9816,2095,17.6,-344
"Fajardo Municipio, PR",PR,2013,12255,10154,2101,17.1,-465
"Fajardo Municipio, PR",PR,2012,12720,10430,2290,18.0,-466
"Fajardo Municipio, PR",PR,2011,13186,10512,2674,20.3,-496
"Fajardo Municipio, PR",PR,2010,13682,10938,2744,20.1,0
"Fall River County, SD",SD,2021,3071,2947,124,4.0,75
"Fall River County, SD",SD,2020,2996,2828,168,5.6,29
"Fall River County, SD",SD,2019,2967,2859,108,3.6,-24
"Fall River County, SD",SD,2018,2991,2887,104,3.5,17
"Fall River County, SD",SD,2017,2974,2863,111,3.7,-65
"Fall River County, SD",SD,2016,3039,2905,134,4.4,47
"Fall River County, SD",SD,2015,2992,2861,131,4.4,-37
"Fall River County, SD",SD,2014,3029,2890,139,4.6,-29
"Fall River County, SD",SD,2013,3058,2908,150,4.9,-93
"Fall River County, SD",SD,2012,3151,2981,170,5.4,-69
"Fall River County, SD",SD,2011,3220,3033,187,5.8,-57
"Fall River County, SD",SD,2010,3277,3077,200,6.1,0
"Fallon County, MT",MT,2021,1620,1578,42,2.6,-31
"Fallon County, MT",MT,2020,1651,1587,64,3.9,-69
"Fallon County, MT",MT,2019,1720,1689,31,1.8,11
"Fallon County, MT",MT,2018,1709,1678,31,1.8,-38
"Fallon County, MT",MT,2017,1747,1700,47,2.7,-63
"Fallon County, MT",MT,2016,1810,1742,68,3.8,-160
"Fallon County, MT",MT,2015,1970,1923,47,2.4,-104
"Fallon County, MT",MT,2014,2074,2034,40,1.9,33
"Fallon County, MT",MT,2013,2041,2001,40,2.0,6
"Fallon County, MT",MT,2012,2035,1995,40,2.0,79
"Fallon County, MT",MT,2011,1956,1907,49,2.5,56
"Fallon County, MT",MT,2010,1900,1843,57,3.0,0
"Falls Church city, VA",VA,2021,8196,7979,217,2.6,-68
"Falls Church city, VA",VA,2020,8264,7951,313,3.8,-377
"Falls Church city, VA",VA,2019,8641,8462,179,2.1,73
"Falls Church city, VA",VA,2018,8568,8385,183,2.1,160
"Falls Church city, VA",VA,2017,8408,8188,220,2.6,415
"Falls Church city, VA",VA,2016,7993,7778,215,2.7,115
"Falls Church city, VA",VA,2015,7878,7641,237,3.0,60
"Falls Church city, VA",VA,2014,7818,7542,276,3.5,-28
"Falls Church city, VA",VA,2013,7846,7547,299,3.8,127
"Falls Church city, VA",VA,2012,7719,7417,302,3.9,213
"Falls Church city, VA",VA,2011,7506,7188,318,4.2,118
"Falls Church city, VA",VA,2010,7388,7018,370,5.0,0
"Falls County, TX",TX,2021,6576,6226,350,5.3,230
"Falls County, TX",TX,2020,6346,5959,387,6.1,-60
"Falls County, TX",TX,2019,6406,6196,210,3.3,-44
"Falls County, TX",TX,2018,6450,6197,253,3.9,-149
"Falls County, TX",TX,2017,6599,6317,282,4.3,-14
"Falls County, TX",TX,2016,6613,6321,292,4.4,156
"Falls County, TX",TX,2015,6457,6181,276,4.3,-83
"Falls County, TX",TX,2014,6540,6176,364,5.6,-226
"Falls County, TX",TX,2013,6766,6283,483,7.1,-134
"Falls County, TX",TX,2012,6900,6397,503,7.3,-284
"Falls County, TX",TX,2011,7184,6571,613,8.5,-70
"Falls County, TX",TX,2010,7254,6633,621,8.6,0
"Fannin County, GA",GA,2021,11797,11463,334,2.8,665
"Fannin County, GA",GA,2020,11132,10608,524,4.7,-373
"Fannin County, GA",GA,2019,11505,11103,402,3.5,184
"Fannin County, GA",GA,2018,11321,10865,456,4.0,233
"Fannin County, GA",GA,2017,11088,10553,535,4.8,259
"Fannin County, GA",GA,2016,10829,10242,587,5.4,830
"Fannin County, GA",GA,2015,9999,9369,630,6.3,159
"Fannin County, GA",GA,2014,9840,9090,750,7.6,90
"Fannin County, GA",GA,2013,9750,8878,872,8.9,-232
"Fannin County, GA",GA,2012,9982,8977,1005,10.1,-270
"Fannin County, GA",GA,2011,10252,9103,1149,11.2,-49
"Fannin County, GA",GA,2010,10301,9082,1219,11.8,0
"Fannin County, TX",TX,2021,17165,16478,687,4.0,576
"Fannin County, TX",TX,2020,16589,15806,783,4.7,-556
"Fannin County, TX",TX,2019,17145,16673,472,2.8,846
"Fannin County, TX",TX,2018,16299,15792,507,3.1,467
"Fannin County, TX",TX,2017,15832,15299,533,3.4,58
"Fannin County, TX",TX,2016,15774,15179,595,3.8,392
"Fannin County, TX",TX,2015,15382,14746,636,4.1,125
"Fannin County, TX",TX,2014,15257,14435,822,5.4,3
"Fannin County, TX",TX,2013,15254,14181,1073,7.0,222
"Fannin County, TX",TX,2012,15032,13976,1056,7.0,-243
"Fannin County, TX",TX,2011,15275,13972,1303,8.5,-93
"Fannin County, TX",TX,2010,15368,14106,1262,8.2,0
"Faribault County, MN",MN,2021,6806,6548,258,3.8,-351
"Faribault County, MN",MN,2020,7157,6704,453,6.3,50
"Faribault County, MN",MN,2019,7107,6794,313,4.4,83
"Faribault County, MN",MN,2018,7024,6764,260,3.7,-149
"Faribault County, MN",MN,2017,7173,6870,303,4.2,-143
"Faribault County, MN",MN,2016,7316,6995,321,4.4,-205
"Faribault County, MN",MN,2015,7521,7185,336,4.5,128
"Faribault County, MN",MN,2014,7393,6998,395,5.3,-110
"Faribault County, MN",MN,2013,7503,7092,411,5.5,-277
"Faribault County, MN",MN,2012,7780,7323,457,5.9,-31
"Faribault County, MN",MN,2011,7811,7255,556,7.1,-26
"Faribault County, MN",MN,2010,7837,7211,626,8.0,0
"Faulk County, SD",SD,2021,1055,1026,29,2.7,25
"Faulk County, SD",SD,2020,1030,996,34,3.3,-17
"Faulk County, SD",SD,2019,1047,1018,29,2.8,-44
"Faulk County, SD",SD,2018,1091,1061,30,2.7,-7
"Faulk County, SD",SD,2017,1098,1067,31,2.8,-21
"Faulk County, SD",SD,2016,1119,1089,30,2.7,-7
"Faulk County, SD",SD,2015,1126,1097,29,2.6,-24
"Faulk County, SD",SD,2014,1150,1115,35,3.0,-20
"Faulk County, SD",SD,2013,1170,1132,38,3.2,14
"Faulk County, SD",SD,2012,1156,1112,44,3.8,-27
"Faulk County, SD",SD,2011,1183,1135,48,4.1,3
"Faulk County, SD",SD,2010,1180,1134,46,3.9,0
"Faulkner County, AR",AR,2021,61033,58910,2123,3.5,-973
"Faulkner County, AR",AR,2020,62006,58616,3390,5.5,-964
"Faulkner County, AR",AR,2019,62970,61129,1841,2.9,995
"Faulkner County, AR",AR,2018,61975,59995,1980,3.2,634
"Faulkner County, AR",AR,2017,61341,59285,2056,3.4,687
"Faulkner County, AR",AR,2016,60654,58345,2309,3.8,493
"Faulkner County, AR",AR,2015,60161,57396,2765,4.6,663
"Faulkner County, AR",AR,2014,59498,56270,3228,5.4,-154
"Faulkner County, AR",AR,2013,59652,55878,3774,6.3,-334
"Faulkner County, AR",AR,2012,59986,56177,3809,6.3,785
"Faulkner County, AR",AR,2011,59201,55162,4039,6.8,539
"Faulkner County, AR",AR,2010,58662,54585,4077,6.9,0
"Fauquier County, VA",VA,2021,36217,35138,1079,3.0,-560
"Fauquier County, VA",VA,2020,36777,35058,1719,4.7,-1308
"Fauquier County, VA",VA,2019,38085,37168,917,2.4,1031
"Fauquier County, VA",VA,2018,37054,36096,958,2.6,785
"Fauquier County, VA",VA,2017,36269,35091,1178,3.2,292
"Fauquier County, VA",VA,2016,35977,34745,1232,3.4,104
"Fauquier County, VA",VA,2015,35873,34477,1396,3.9,-176
"Fauquier County, VA",VA,2014,36049,34427,1622,4.5,121
"Fauquier County, VA",VA,2013,35928,34198,1730,4.8,-47
"Fauquier County, VA",VA,2012,35975,34162,1813,5.0,-98
"Fauquier County, VA",VA,2011,36073,34092,1981,5.5,268
"Fauquier County, VA",VA,2010,35805,33536,2269,6.3,0
"Fayette County, AL",AL,2021,6653,6449,204,3.1,-11
"Fayette County, AL",AL,2020,6664,6294,370,5.6,-21
"Fayette County, AL",AL,2019,6685,6466,219,3.3,85
"Fayette County, AL",AL,2018,6600,6333,267,4.0,-29
"Fayette County, AL",AL,2017,6629,6309,320,4.8,87
"Fayette County, AL",AL,2016,6542,6100,442,6.8,136
"Fayette County, AL",AL,2015,6406,5954,452,7.1,47
"Fayette County, AL",AL,2014,6359,5863,496,7.8,-42
"Fayette County, AL",AL,2013,6401,5862,539,8.4,-110
"Fayette County, AL",AL,2012,6511,5936,575,8.8,-116
"Fayette County, AL",AL,2011,6627,5899,728,11.0,-200
"Fayette County, AL",AL,2010,6827,5955,872,12.8,0
"Fayette County, GA",GA,2021,58170,56475,1695,2.9,1573
"Fayette County, GA",GA,2020,56597,53572,3025,5.3,-1512
"Fayette County, GA",GA,2019,58109,56284,1825,3.1,332
"Fayette County, GA",GA,2018,57777,55732,2045,3.5,245
"Fayette County, GA",GA,2017,57532,55167,2365,4.1,1820
"Fayette County, GA",GA,2016,55712,53051,2661,4.8,2174
"Fayette County, GA",GA,2015,53538,50712,2826,5.3,-131
"Fayette County, GA",GA,2014,53669,50386,3283,6.1,326
"Fayette County, GA",GA,2013,53343,49791,3552,6.7,19
"Fayette County, GA",GA,2012,53324,49359,3965,7.4,197
"Fayette County, GA",GA,2011,53127,48908,4219,7.9,69
"Fayette County, GA",GA,2010,53058,48624,4434,8.4,0
"Fayette County, IA",IA,2021,10172,9694,478,4.7,-151
"Fayette County, IA",IA,2020,10323,9771,552,5.3,-482
"Fayette County, IA",IA,2019,10805,10439,366,3.4,140
"Fayette County, IA",IA,2018,10665,10349,316,3.0,79
"Fayette County, IA",IA,2017,10586,10207,379,3.6,-181
"Fayette County, IA",IA,2016,10767,10293,474,4.4,-45
"Fayette County, IA",IA,2015,10812,10327,485,4.5,20
"Fayette County, IA",IA,2014,10792,10253,539,5.0,111
"Fayette County, IA",IA,2013,10681,10118,563,5.3,-156
"Fayette County, IA",IA,2012,10837,10247,590,5.4,-251
"Fayette County, IA",IA,2011,11088,10388,700,6.3,98
"Fayette County, IA",IA,2010,10990,10190,800,7.3,0
"Fayette County, IL",IL,2021,9804,9303,501,5.1,104
"Fayette County, IL",IL,2020,9700,8963,737,7.6,-230
"Fayette County, IL",IL,2019,9930,9514,416,4.2,108
"Fayette County, IL",IL,2018,9822,9315,507,5.2,134
"Fayette County, IL",IL,2017,9688,9159,529,5.5,-98
"Fayette County, IL",IL,2016,9786,9149,637,6.5,68
"Fayette County, IL",IL,2015,9718,9078,640,6.6,-35
"Fayette County, IL",IL,2014,9753,9007,746,7.6,-365
"Fayette County, IL",IL,2013,10118,9192,926,9.2,-527
"Fayette County, IL",IL,2012,10645,9687,958,9.0,-510
"Fayette County, IL",IL,2011,11155,10124,1031,9.2,-65
"Fayette County, IL",IL,2010,11220,10083,1137,10.1,0
"Fayette County, IN",IN,2021,8393,8023,370,4.4,-207
"Fayette County, IN",IN,2020,8600,7753,847,9.8,-198
"Fayette County, IN",IN,2019,8798,8388,410,4.7,-367
"Fayette County, IN",IN,2018,9165,8745,420,4.6,89
"Fayette County, IN",IN,2017,9076,8624,452,5.0,-282
"Fayette County, IN",IN,2016,9358,8827,531,5.7,371
"Fayette County, IN",IN,2015,8987,8400,587,6.5,-106
"Fayette County, IN",IN,2014,9093,8386,707,7.8,60
"Fayette County, IN",IN,2013,9033,8117,916,10.1,-137
"Fayette County, IN",IN,2012,9170,8162,1008,11.0,-356
"Fayette County, IN",IN,2011,9526,8353,1173,12.3,-235
"Fayette County, IN",IN,2010,9761,8369,1392,14.3,0
"Fayette County, KY",KY,2021,173189,166393,6796,3.9,1376
"Fayette County, KY",KY,2020,171813,162258,9555,5.6,-3939
"Fayette County, KY",KY,2019,175752,170248,5504,3.1,1563
"Fayette County, KY",KY,2018,174189,168551,5638,3.2,-1209
"Fayette County, KY",KY,2017,175398,169153,6245,3.6,3900
"Fayette County, KY",KY,2016,171498,165460,6038,3.5,3574
"Fayette County, KY",KY,2015,167924,161561,6363,3.8,850
"Fayette County, KY",KY,2014,167074,159106,7968,4.8,-1417
"Fayette County, KY",KY,2013,168491,158808,9683,5.7,2170
"Fayette County, KY",KY,2012,166321,156575,9746,5.9,966
"Fayette County, KY",KY,2011,165355,154034,11321,6.8,1252
"Fayette County, KY",KY,2010,164103,151818,12285,7.5,0
"Fayette County, OH",OH,2021,13748,13091,657,4.8,-190
"Fayette County, OH",OH,2020,13938,12909,1029,7.4,-51
"Fayette County, OH",OH,2019,13989,13441,548,3.9,-175
"Fayette County, OH",OH,2018,14164,13581,583,4.1,-301
"Fayette County, OH",OH,2017,14465,13854,611,4.2,-80
"Fayette County, OH",OH,2016,14545,13896,649,4.5,476
"Fayette County, OH",OH,2015,14069,13367,702,5.0,-104
"Fayette County, OH",OH,2014,14173,13324,849,6.0,-196
"Fayette County, OH",OH,2013,14369,13270,1099,7.6,251
"Fayette County, OH",OH,2012,14118,12950,1168,8.3,-208
"Fayette County, OH",OH,2011,14326,12823,1503,10.5,-600
"Fayette County, OH",OH,2010,14926,12966,1960,13.1,0
"Fayette County, PA",PA,2021,55515,50665,4850,8.7,-1315
"Fayette County, PA",PA,2020,56830,50131,6699,11.8,-669
"Fayette County, PA",PA,2019,57499,53979,3520,6.1,47
"Fayette County, PA",PA,2018,57452,53964,3488,6.1,-504
"Fayette County, PA",PA,2017,57956,53873,4083,7.0,-550
"Fayette County, PA",PA,2016,58506,53815,4691,8.0,92
"Fayette County, PA",PA,2015,58414,53952,4462,7.6,-13
"Fayette County, PA",PA,2014,58427,53772,4655,8.0,-1050
"Fayette County, PA",PA,2013,59477,53934,5543,9.3,-618
"Fayette County, PA",PA,2012,60095,54255,5840,9.7,565
"Fayette County, PA",PA,2011,59530,53657,5873,9.9,215
"Fayette County, PA",PA,2010,59315,53111,6204,10.5,0
"Fayette County, TN",TN,2021,19283,18489,794,4.1,86
"Fayette County, TN",TN,2020,19197,18015,1182,6.2,-396
"Fayette County, TN",TN,2019,19593,18882,711,3.6,576
"Fayette County, TN",TN,2018,19017,18310,707,3.7,411
"Fayette County, TN",TN,2017,18606,17861,745,4.0,312
"Fayette County, TN",TN,2016,18294,17369,925,5.1,387
"Fayette County, TN",TN,2015,17907,16808,1099,6.1,45
"Fayette County, TN",TN,2014,17862,16568,1294,7.2,-334
"Fayette County, TN",TN,2013,18196,16630,1566,8.6,-198
"Fayette County, TN",TN,2012,18394,16809,1585,8.6,-332
"Fayette County, TN",TN,2011,18726,16919,1807,9.6,-119
"Fayette County, TN",TN,2010,18845,16941,1904,10.1,0
"Fayette County, TX",TX,2021,11857,11350,507,4.3,183
"Fayette County, TX",TX,2020,11674,11124,550,4.7,-574
"Fayette County, TX",TX,2019,12248,11926,322,2.6,-227
"Fayette County, TX",TX,2018,12475,12123,352,2.8,-8
"Fayette County, TX",TX,2017,12483,12081,402,3.2,-13
"Fayette County, TX",TX,2016,12496,12039,457,3.7,-282
"Fayette County, TX",TX,2015,12778,12351,427,3.3,-274
"Fayette County, TX",TX,2014,13052,12599,453,3.5,418
"Fayette County, TX",TX,2013,12634,12067,567,4.5,139
"Fayette County, TX",TX,2012,12495,11895,600,4.8,0
"Fayette County, TX",TX,2011,12495,11750,745,6.0,451
"Fayette County, TX",TX,2010,12044,11305,739,6.1,0
"Fayette County, WV",WV,2021,15981,14987,994,6.2,-33
"Fayette County, WV",WV,2020,16014,14449,1565,9.8,-232
"Fayette County, WV",WV,2019,16246,15322,924,5.7,203
"Fayette County, WV",WV,2018,16043,15037,1006,6.3,210
"Fayette County, WV",WV,2017,15833,14819,1014,6.4,-191
"Fayette County, WV",WV,2016,16024,14752,1272,7.9,-440
"Fayette County, WV",WV,2015,16464,15083,1381,8.4,-292
"Fayette County, WV",WV,2014,16756,15380,1376,8.2,-244
"Fayette County, WV",WV,2013,17000,15551,1449,8.5,-570
"Fayette County, WV",WV,2012,17570,16101,1469,8.4,-149
"Fayette County, WV",WV,2011,17719,16176,1543,8.7,174
"Fayette County, WV",WV,2010,17545,15795,1750,10.0,0
"Fentress County, TN",TN,2021,7526,7223,303,4.0,6
"Fentress County, TN",TN,2020,7520,7052,468,6.2,-12
"Fentress County, TN",TN,2019,7532,7215,317,4.2,324
"Fentress County, TN",TN,2018,7208,6909,299,4.1,112
"Fentress County, TN",TN,2017,7096,6774,322,4.5,-15
"Fentress County, TN",TN,2016,7111,6671,440,6.2,95
"Fentress County, TN",TN,2015,7016,6508,508,7.2,-41
"Fentress County, TN",TN,2014,7057,6455,602,8.5,-381
"Fentress County, TN",TN,2013,7438,6714,724,9.7,-29
"Fentress County, TN",TN,2012,7467,6727,740,9.9,-21
"Fentress County, TN",TN,2011,7488,6621,867,11.6,71
"Fentress County, TN",TN,2010,7417,6482,935,12.6,0
"Fergus County, MT",MT,2021,5822,5631,191,3.3,-27
"Fergus County, MT",MT,2020,5849,5586,263,4.5,-249
"Fergus County, MT",MT,2019,6098,5902,196,3.2,239
"Fergus County, MT",MT,2018,5859,5643,216,3.7,60
"Fergus County, MT",MT,2017,5799,5562,237,4.1,36
"Fergus County, MT",MT,2016,5763,5528,235,4.1,59
"Fergus County, MT",MT,2015,5704,5462,242,4.2,-42
"Fergus County, MT",MT,2014,5746,5499,247,4.3,-130
"Fergus County, MT",MT,2013,5876,5591,285,4.9,20
"Fergus County, MT",MT,2012,5856,5552,304,5.2,-51
"Fergus County, MT",MT,2011,5907,5563,344,5.8,-113
"Fergus County, MT",MT,2010,6020,5640,380,6.3,0
"Ferry County, WA",WA,2021,2327,2121,206,8.9,-105
"Ferry County, WA",WA,2020,2432,2151,281,11.6,-101
"Ferry County, WA",WA,2019,2533,2243,290,11.4,12
"Ferry County, WA",WA,2018,2521,2230,291,11.5,-1
"Ferry County, WA",WA,2017,2522,2248,274,10.9,29
"Ferry County, WA",WA,2016,2493,2240,253,10.1,21
"Ferry County, WA",WA,2015,2472,2228,244,9.9,27
"Ferry County, WA",WA,2014,2445,2174,271,11.1,-35
"Ferry County, WA",WA,2013,2480,2152,328,13.2,62
"Ferry County, WA",WA,2012,2418,2069,349,14.4,-63
"Ferry County, WA",WA,2011,2481,2090,391,15.8,-90
"Ferry County, WA",WA,2010,2571,2160,411,16.0,0
"Fillmore County, MN",MN,2021,11282,10949,333,3.0,-472
"Fillmore County, MN",MN,2020,11754,11137,617,5.2,107
"Fillmore County, MN",MN,2019,11647,11237,410,3.5,113
"Fillmore County, MN",MN,2018,11534,11150,384,3.3,69
"Fillmore County, MN",MN,2017,11465,11059,406,3.5,-27
"Fillmore County, MN",MN,2016,11492,11028,464,4.0,60
"Fillmore County, MN",MN,2015,11432,10956,476,4.2,382
"Fillmore County, MN",MN,2014,11050,10553,497,4.5,-67
"Fillmore County, MN",MN,2013,11117,10551,566,5.1,-170
"Fillmore County, MN",MN,2012,11287,10658,629,5.6,38
"Fillmore County, MN",MN,2011,11249,10499,750,6.7,-7
"Fillmore County, MN",MN,2010,11256,10408,848,7.5,0
"Fillmore County, NE",NE,2021,3291,3227,64,1.9,88
"Fillmore County, NE",NE,2020,3203,3116,87,2.7,0
"Fillmore County, NE",NE,2019,3203,3121,82,2.6,26
"Fillmore County, NE",NE,2018,3177,3096,81,2.5,43
"Fillmore County, NE",NE,2017,3134,3055,79,2.5,-67
"Fillmore County, NE",NE,2016,3201,3113,88,2.7,-20
"Fillmore County, NE",NE,2015,3221,3126,95,2.9,-27
"Fillmore County, NE",NE,2014,3248,3170,78,2.4,-48
"Fillmore County, NE",NE,2013,3296,3199,97,2.9,-18
"Fillmore County, NE",NE,2012,3314,3209,105,3.2,-11
"Fillmore County, NE",NE,2011,3325,3210,115,3.5,90
"Fillmore County, NE",NE,2010,3235,3112,123,3.8,0
"Finney County, KS",KS,2021,20305,19877,428,2.1,-250
"Finney County, KS",KS,2020,20555,19894,661,3.2,-138
"Finney County, KS",KS,2019,20693,20218,475,2.3,100
"Finney County, KS",KS,2018,20593,20095,498,2.4,394
"Finney County, KS",KS,2017,20199,19648,551,2.7,-46
"Finney County, KS",KS,2016,20245,19620,625,3.1,61
"Finney County, KS",KS,2015,20184,19473,711,3.5,-48
"Finney County, KS",KS,2014,20232,19543,689,3.4,206
"Finney County, KS",KS,2013,20026,19168,858,4.3,-206
"Finney County, KS",KS,2012,20232,19330,902,4.5,-616
"Finney County, KS",KS,2011,20848,19972,876,4.2,668
"Finney County, KS",KS,2010,20180,19272,908,4.5,0
"Fisher County, TX",TX,2021,1606,1538,68,4.2,22
"Fisher County, TX",TX,2020,1584,1513,71,4.5,-27
"Fisher County, TX",TX,2019,1611,1564,47,2.9,-23
"Fisher County, TX",TX,2018,1634,1581,53,3.2,-57
"Fisher County, TX",TX,2017,1691,1630,61,3.6,-69
"Fisher County, TX",TX,2016,1760,1684,76,4.3,-41
"Fisher County, TX",TX,2015,1801,1731,70,3.9,-60
"Fisher County, TX",TX,2014,1861,1776,85,4.6,-21
"Fisher County, TX",TX,2013,1882,1779,103,5.5,-21
"Fisher County, TX",TX,2012,1903,1801,102,5.4,-37
"Fisher County, TX",TX,2011,1940,1807,133,6.9,12
"Fisher County, TX",TX,2010,1928,1792,136,7.1,0
"Flagler County, FL",FL,2021,48309,46067,2242,4.6,1220
"Flagler County, FL",FL,2020,47089,43263,3826,8.1,-241
"Flagler County, FL",FL,2019,47330,45471,1859,3.9,1029
"Flagler County, FL",FL,2018,46301,44337,1964,4.2,502
"Flagler County, FL",FL,2017,45799,43561,2238,4.9,307
"Flagler County, FL",FL,2016,45492,42967,2525,5.6,1647
"Flagler County, FL",FL,2015,43845,41064,2781,6.3,681
"Flagler County, FL",FL,2014,43164,39906,3258,7.5,-767
"Flagler County, FL",FL,2013,43931,40101,3830,8.7,2029
"Flagler County, FL",FL,2012,41902,37643,4259,10.2,211
"Flagler County, FL",FL,2011,41691,36957,4734,11.4,735
"Flagler County, FL",FL,2010,40956,36034,4922,12.0,0
"Flathead County, MT",MT,2021,51167,49112,2055,4.0,1417
"Flathead County, MT",MT,2020,49750,45934,3816,7.7,888
"Flathead County, MT",MT,2019,48862,46513,2349,4.8,633
"Flathead County, MT",MT,2018,48229,45895,2334,4.8,1137
"Flathead County, MT",MT,2017,47092,44581,2511,5.3,1132
"Flathead County, MT",MT,2016,45960,43298,2662,5.8,1099
"Flathead County, MT",MT,2015,44861,42228,2633,5.9,1088
"Flathead County, MT",MT,2014,43773,40954,2819,6.4,-87
"Flathead County, MT",MT,2013,43860,40529,3331,7.6,577
"Flathead County, MT",MT,2012,43283,39490,3793,8.8,-223
"Flathead County, MT",MT,2011,43506,38933,4573,10.5,-338
"Flathead County, MT",MT,2010,43844,38579,5265,12.0,0
"Fleming County, KY",KY,2021,6049,5750,299,4.9,-59
"Fleming County, KY",KY,2020,6108,5675,433,7.1,-114
"Fleming County, KY",KY,2019,6222,5902,320,5.1,146
"Fleming County, KY",KY,2018,6076,5753,323,5.3,13
"Fleming County, KY",KY,2017,6063,5701,362,6.0,118
"Fleming County, KY",KY,2016,5945,5579,366,6.2,-126
"Fleming County, KY",KY,2015,6071,5691,380,6.3,-300
"Fleming County, KY",KY,2014,6371,5881,490,7.7,-151
"Fleming County, KY",KY,2013,6522,5909,613,9.4,40
"Fleming County, KY",KY,2012,6482,5892,590,9.1,0
"Fleming County, KY",KY,2011,6482,5796,686,10.6,-267
"Fleming County, KY",KY,2010,6749,5965,784,11.6,0
"Florence County, SC",SC,2021,65981,63305,2676,4.1,572
"Florence County, SC",SC,2020,65409,61858,3551,5.4,-138
"Florence County, SC",SC,2019,65547,63668,1879,2.9,734
"Florence County, SC",SC,2018,64813,62498,2315,3.6,770
"Florence County, SC",SC,2017,64043,61190,2853,4.5,-1137
"Florence County, SC",SC,2016,65180,61817,3363,5.2,-290
"Florence County, SC",SC,2015,65470,61234,4236,6.5,641
"Florence County, SC",SC,2014,64829,60279,4550,7.0,-267
"Florence County, SC",SC,2013,65096,59864,5232,8.0,38
"Florence County, SC",SC,2012,65058,58914,6144,9.4,358
"Florence County, SC",SC,2011,64700,57539,7161,11.1,-40
"Florence County, SC",SC,2010,64740,57303,7437,11.5,0
"Florence County, WI",WI,2021,2244,2137,107,4.8,35
"Florence County, WI",WI,2020,2209,2032,177,8.0,-11
"Florence County, WI",WI,2019,2220,2120,100,4.5,-56
"Florence County, WI",WI,2018,2276,2189,87,3.8,-19
"Florence County, WI",WI,2017,2295,2188,107,4.7,74
"Florence County, WI",WI,2016,2221,2093,128,5.8,15
"Florence County, WI",WI,2015,2206,2061,145,6.6,4
"Florence County, WI",WI,2014,2202,2040,162,7.4,6
"Florence County, WI",WI,2013,2196,2015,181,8.2,-12
"Florence County, WI",WI,2012,2208,2027,181,8.2,4
"Florence County, WI",WI,2011,2204,1990,214,9.7,-44
"Florence County, WI",WI,2010,2248,2019,229,10.2,0
"Florida Municipio, PR",PR,2021,3512,3150,362,10.3,
"Florida Municipio, PR",PR,2020,N.A.,N.A.,N.A.,N.A.,
"Florida Municipio, PR",PR,2019,3311,2951,360,10.9,13
"Florida Municipio, PR",PR,2018,3298,2906,392,11.9,-61
"Florida Municipio, PR",PR,2017,3359,2879,480,14.3,-11
"Florida Municipio, PR",PR,2016,3370,2882,488,14.5,-30
"Florida Municipio, PR",PR,2015,3400,2892,508,14.9,-126
"Florida Municipio, PR",PR,2014,3526,2861,665,18.9,-170
"Florida Municipio, PR",PR,2013,3696,2924,772,20.9,31
"Florida Municipio, PR",PR,2012,3665,2962,703,19.2,-15
"Florida Municipio, PR",PR,2011,3680,2918,762,20.7,-171
"Florida Municipio, PR",PR,2010,3851,3000,851,22.1,0
"Floyd County, GA",GA,2021,43891,42277,1614,3.7,765
"Floyd County, GA",GA,2020,43126,40440,2686,6.2,-1074
"Floyd County, GA",GA,2019,44200,42415,1785,4.0,-304
"Floyd County, GA",GA,2018,44504,42570,1934,4.3,-141
"Floyd County, GA",GA,2017,44645,42301,2344,5.3,1142
"Floyd County, GA",GA,2016,43503,40856,2647,6.1,1006
"Floyd County, GA",GA,2015,42497,39611,2886,6.8,-720
"Floyd County, GA",GA,2014,43217,39787,3430,7.9,-495
"Floyd County, GA",GA,2013,43712,39586,4126,9.4,-930
"Floyd County, GA",GA,2012,44642,39833,4809,10.8,-118
"Floyd County, GA",GA,2011,44760,39398,5362,12.0,-475
"Floyd County, GA",GA,2010,45235,39799,5436,12.0,0
"Floyd County, IA",IA,2021,8197,7843,354,4.3,-102
"Floyd County, IA",IA,2020,8299,7810,489,5.9,-702
"Floyd County, IA",IA,2019,9001,8699,302,3.4,50
"Floyd County, IA",IA,2018,8951,8711,240,2.7,91
"Floyd County, IA",IA,2017,8860,8580,280,3.2,125
"Floyd County, IA",IA,2016,8735,8420,315,3.6,35
"Floyd County, IA",IA,2015,8700,8375,325,3.7,291
"Floyd County, IA",IA,2014,8409,8030,379,4.5,124
"Floyd County, IA",IA,2013,8285,7827,458,5.5,127
"Floyd County, IA",IA,2012,8158,7647,511,6.3,-172
"Floyd County, IA",IA,2011,8330,7780,550,6.6,-202
"Floyd County, IA",IA,2010,8532,7900,632,7.4,0
"Floyd County, IN",IN,2021,41370,40221,1149,2.8,46
"Floyd County, IN",IN,2020,41324,38615,2709,6.6,-958
"Floyd County, IN",IN,2019,42282,40974,1308,3.1,427
"Floyd County, IN",IN,2018,41855,40494,1361,3.3,970
"Floyd County, IN",IN,2017,40885,39537,1348,3.3,-140
"Floyd County, IN",IN,2016,41025,39369,1656,4.0,1170
"Floyd County, IN",IN,2015,39855,38157,1698,4.3,763
"Floyd County, IN",IN,2014,39092,37113,1979,5.1,517
"Floyd County, IN",IN,2013,38575,36176,2399,6.2,755
"Floyd County, IN",IN,2012,37820,35171,2649,7.0,-34
"Floyd County, IN",IN,2011,37854,34902,2952,7.8,-21
"Floyd County, IN",IN,2010,37875,34617,3258,8.6,0
"Floyd County, KY",KY,2021,10797,10033,764,7.1,154
"Floyd County, KY",KY,2020,10643,9707,936,8.8,-444
"Floyd County, KY",KY,2019,11087,10417,670,6.0,180
"Floyd County, KY",KY,2018,10907,10213,694,6.4,-365
"Floyd County, KY",KY,2017,11272,10349,923,8.2,-175
"Floyd County, KY",KY,2016,11447,10169,1278,11.2,-104
"Floyd County, KY",KY,2015,11551,10468,1083,9.4,-853
"Floyd County, KY",KY,2014,12404,11135,1269,10.2,-726
"Floyd County, KY",KY,2013,13130,11404,1726,13.1,-614
"Floyd County, KY",KY,2012,13744,12142,1602,11.7,-6
"Floyd County, KY",KY,2011,13750,12217,1533,11.1,-268
"Floyd County, KY",KY,2010,14018,12113,1905,13.6,0
"Floyd County, TX",TX,2021,2503,2359,144,5.8,26
"Floyd County, TX",TX,2020,2477,2323,154,6.2,-60
"Floyd County, TX",TX,2019,2537,2426,111,4.4,-108
"Floyd County, TX",TX,2018,2645,2507,138,5.2,-36
"Floyd County, TX",TX,2017,2681,2534,147,5.5,-57
"Floyd County, TX",TX,2016,2738,2600,138,5.0,-8
"Floyd County, TX",TX,2015,2746,2593,153,5.6,-215
"Floyd County, TX",TX,2014,2961,2747,214,7.2,-156
"Floyd County, TX",TX,2013,3117,2840,277,8.9,-73
"Floyd County, TX",TX,2012,3190,2986,204,6.4,-137
"Floyd County, TX",TX,2011,3327,3063,264,7.9,-50
"Floyd County, TX",TX,2010,3377,3108,269,8.0,0
"Floyd County, VA",VA,2021,8157,7903,254,3.1,13
"Floyd County, VA",VA,2020,8144,7735,409,5.0,-201
"Floyd County, VA",VA,2019,8345,8134,211,2.5,155
"Floyd County, VA",VA,2018,8190,7969,221,2.7,36
"Floyd County, VA",VA,2017,8154,7858,296,3.6,-47
"Floyd County, VA",VA,2016,8201,7873,328,4.0,-125
"Floyd County, VA",VA,2015,8326,7999,327,3.9,-6
"Floyd County, VA",VA,2014,8332,7952,380,4.6,-57
"Floyd County, VA",VA,2013,8389,7946,443,5.3,23
"Floyd County, VA",VA,2012,8366,7901,465,5.6,45
"Floyd County, VA",VA,2011,8321,7796,525,6.3,178
"Floyd County, VA",VA,2010,8143,7563,580,7.1,0
"Fluvanna County, VA",VA,2021,13572,13130,442,3.3,-233
"Fluvanna County, VA",VA,2020,13805,13083,722,5.2,-639
"Fluvanna County, VA",VA,2019,14444,14116,328,2.3,638
"Fluvanna County, VA",VA,2018,13806,13464,342,2.5,266
"Fluvanna County, VA",VA,2017,13540,13131,409,3.0,339
"Fluvanna County, VA",VA,2016,13201,12764,437,3.3,-13
"Fluvanna County, VA",VA,2015,13214,12724,490,3.7,-1
"Fluvanna County, VA",VA,2014,13215,12648,567,4.3,177
"Fluvanna County, VA",VA,2013,13038,12431,607,4.7,-122
"Fluvanna County, VA",VA,2012,13160,12483,677,5.1,-85
"Fluvanna County, VA",VA,2011,13245,12477,768,5.8,152
"Fluvanna County, VA",VA,2010,13093,12246,847,6.5,0
"Foard County, TX",TX,2021,589,569,20,3.4,18
"Foard County, TX",TX,2020,571,548,23,4.0,-2
"Foard County, TX",TX,2019,573,556,17,3.0,-6
"Foard County, TX",TX,2018,579,562,17,2.9,-11
"Foard County, TX",TX,2017,590,569,21,3.6,50
"Foard County, TX",TX,2016,540,520,20,3.7,-12
"Foard County, TX",TX,2015,552,529,23,4.2,-26
"Foard County, TX",TX,2014,578,553,25,4.3,1
"Foard County, TX",TX,2013,577,547,30,5.2,-44
"Foard County, TX",TX,2012,621,585,36,5.8,-46
"Foard County, TX",TX,2011,667,616,51,7.6,3
"Foard County, TX",TX,2010,664,619,45,6.8,0
"Fond du Lac County, WI",WI,2021,57149,55311,1838,3.2,764
"Fond du Lac County, WI",WI,2020,56385,53054,3331,5.9,-1112
"Fond du Lac County, WI",WI,2019,57497,55886,1611,2.8,68
"Fond du Lac County, WI",WI,2018,57429,55920,1509,2.6,206
"Fond du Lac County, WI",WI,2017,57223,55611,1612,2.8,437
"Fond du Lac County, WI",WI,2016,56786,54835,1951,3.4,-110
"Fond du Lac County, WI",WI,2015,56896,54630,2266,4.0,-154
"Fond du Lac County, WI",WI,2014,57050,54285,2765,4.8,-4
"Fond du Lac County, WI",WI,2013,57054,53569,3485,6.1,993
"Fond du Lac County, WI",WI,2012,56061,52476,3585,6.4,-23
"Fond du Lac County, WI",WI,2011,56084,52087,3997,7.1,-466
"Fond du Lac County, WI",WI,2010,56550,51832,4718,8.3,0
"Ford County, IL",IL,2021,6207,5932,275,4.4,51
"Ford County, IL",IL,2020,6156,5746,410,6.7,-196
"Ford County, IL",IL,2019,6352,6090,262,4.1,-104
"Ford County, IL",IL,2018,6456,6156,300,4.6,-6
"Ford County, IL",IL,2017,6462,6151,311,4.8,-221
"Ford County, IL",IL,2016,6683,6319,364,5.4,21
"Ford County, IL",IL,2015,6662,6309,353,5.3,22
"Ford County, IL",IL,2014,6640,6246,394,5.9,-86
"Ford County, IL",IL,2013,6726,6232,494,7.3,-231
"Ford County, IL",IL,2012,6957,6437,520,7.5,-172
"Ford County, IL",IL,2011,7129,6519,610,8.6,-150
"Ford County, IL",IL,2010,7279,6585,694,9.5,0
"Ford County, KS",KS,2021,17686,17309,377,2.1,430
"Ford County, KS",KS,2020,17256,16706,550,3.2,56
"Ford County, KS",KS,2019,17200,16778,422,2.5,-148
"Ford County, KS",KS,2018,17348,16920,428,2.5,-553
"Ford County, KS",KS,2017,17901,17397,504,2.8,-65
"Ford County, KS",KS,2016,17966,17399,567,3.2,-144
"Ford County, KS",KS,2015,18110,17495,615,3.4,-96
"Ford County, KS",KS,2014,18206,17519,687,3.8,-466
"Ford County, KS",KS,2013,18672,17924,748,4.0,-224
"Ford County, KS",KS,2012,18896,18167,729,3.9,531
"Ford County, KS",KS,2011,18365,17585,780,4.2,245
"Ford County, KS",KS,2010,18120,17376,744,4.1,0
"Forest County, PA",PA,2021,1747,1602,145,8.3,-68
"Forest County, PA",PA,2020,1815,1623,192,10.6,-18
"Forest County, PA",PA,2019,1833,1705,128,7.0,-6
"Forest County, PA",PA,2018,1839,1720,119,6.5,-12
"Forest County, PA",PA,2017,1851,1726,125,6.8,-42
"Forest County, PA",PA,2016,1893,1746,147,7.8,-7
"Forest County, PA",PA,2015,1900,1748,152,8.0,-28
"Forest County, PA",PA,2014,1928,1771,157,8.1,-38
"Forest County, PA",PA,2013,1966,1778,188,9.6,-42
"Forest County, PA",PA,2012,2008,1816,192,9.6,-22
"Forest County, PA",PA,2011,2030,1842,188,9.3,-115
"Forest County, PA",PA,2010,2145,1910,235,11.0,0
"Forest County, WI",WI,2021,3957,3692,265,6.7,23
"Forest County, WI",WI,2020,3934,3437,497,12.6,-92
"Forest County, WI",WI,2019,4026,3828,198,4.9,38
"Forest County, WI",WI,2018,3988,3798,190,4.8,-50
"Forest County, WI",WI,2017,4038,3836,202,5.0,51
"Forest County, WI",WI,2016,3987,3745,242,6.1,3
"Forest County, WI",WI,2015,3984,3693,291,7.3,-32
"Forest County, WI",WI,2014,4016,3672,344,8.6,-62
"Forest County, WI",WI,2013,4078,3634,444,10.9,-57
"Forest County, WI",WI,2012,4135,3687,448,10.8,-38
"Forest County, WI",WI,2011,4173,3700,473,11.3,-80
"Forest County, WI",WI,2010,4253,3764,489,11.5,0
"Forrest County, MS",MS,2021,33213,31333,1880,5.7,784
"Forrest County, MS",MS,2020,32429,29866,2563,7.9,-701
"Forrest County, MS",MS,2019,33130,31407,1723,5.2,46
"Forrest County, MS",MS,2018,33084,31562,1522,4.6,-310
"Forrest County, MS",MS,2017,33394,31730,1664,5.0,163
"Forrest County, MS",MS,2016,33231,31288,1943,5.8,491
"Forrest County, MS",MS,2015,32740,30654,2086,6.4,563
"Forrest County, MS",MS,2014,32177,29768,2409,7.5,-930
"Forrest County, MS",MS,2013,33107,30338,2769,8.4,-1668
"Forrest County, MS",MS,2012,34775,31709,3066,8.8,-371
"Forrest County, MS",MS,2011,35146,31676,3470,9.9,989
"Forrest County, MS",MS,2010,34157,30915,3242,9.5,0
"Forsyth County, GA",GA,2021,127031,123874,3157,2.5,4056
"Forsyth County, GA",GA,2020,122975,117458,5517,4.5,-2233
"Forsyth County, GA",GA,2019,125208,121604,3604,2.9,3654
"Forsyth County, GA",GA,2018,121554,117661,3893,3.2,3965
"Forsyth County, GA",GA,2017,117589,113136,4453,3.8,6601
"Forsyth County, GA",GA,2016,110988,106296,4692,4.2,7791
"Forsyth County, GA",GA,2015,103197,98435,4762,4.6,2988
"Forsyth County, GA",GA,2014,100209,94927,5282,5.3,3828
"Forsyth County, GA",GA,2013,96381,90753,5628,5.8,2922
"Forsyth County, GA",GA,2012,93459,87366,6093,6.5,2566
"Forsyth County, GA",GA,2011,90893,84225,6668,7.3,2343
"Forsyth County, GA",GA,2010,88550,81352,7198,8.1,0
"Forsyth County, NC",NC,2021,183512,174514,8998,4.9,3329
"Forsyth County, NC",NC,2020,180183,167293,12890,7.2,-6922
"Forsyth County, NC",NC,2019,187105,180207,6898,3.7,2833
"Forsyth County, NC",NC,2018,184272,177103,7169,3.9,2099
"Forsyth County, NC",NC,2017,182173,174208,7965,4.4,92
"Forsyth County, NC",NC,2016,182081,173210,8871,4.9,2529
"Forsyth County, NC",NC,2015,179552,169780,9772,5.4,2223
"Forsyth County, NC",NC,2014,177329,166984,10345,5.8,-495
"Forsyth County, NC",NC,2013,177824,164762,13062,7.3,-86
"Forsyth County, NC",NC,2012,177910,161767,16143,9.1,3370
"Forsyth County, NC",NC,2011,174540,157407,17133,9.8,896
"Forsyth County, NC",NC,2010,173644,156216,17428,10.0,0
"Fort Bend County, TX",TX,2021,407603,383362,24241,5.9,7094
"Fort Bend County, TX",TX,2020,400509,369972,30537,7.6,5281
"Fort Bend County, TX",TX,2019,395228,381510,13718,3.5,12378
"Fort Bend County, TX",TX,2018,382850,367535,15315,4.0,9996
"Fort Bend County, TX",TX,2017,372854,355381,17473,4.7,5804
"Fort Bend County, TX",TX,2016,367050,348684,18366,5.0,11047
"Fort Bend County, TX",TX,2015,356003,340720,15283,4.3,9465
"Fort Bend County, TX",TX,2014,346538,330674,15864,4.6,13949
"Fort Bend County, TX",TX,2013,332589,314182,18407,5.5,14238
"Fort Bend County, TX",TX,2012,318351,299516,18835,5.9,10151
"Fort Bend County, TX",TX,2011,308200,285580,22620,7.3,9545
"Fort Bend County, TX",TX,2010,298655,275718,22937,7.7,0
"Foster County, ND",ND,2021,1510,1468,42,2.8,-52
"Foster County, ND",ND,2020,1562,1508,54,3.5,23
"Foster County, ND",ND,2019,1539,1501,38,2.5,-81
"Foster County, ND",ND,2018,1620,1581,39,2.4,-58
"Foster County, ND",ND,2017,1678,1637,41,2.4,-4
"Foster County, ND",ND,2016,1682,1632,50,3.0,65
"Foster County, ND",ND,2015,1617,1570,47,2.9,4
"Foster County, ND",ND,2014,1613,1565,48,3.0,-2
"Foster County, ND",ND,2013,1615,1560,55,3.4,-59
"Foster County, ND",ND,2012,1674,1624,50,3.0,-87
"Foster County, ND",ND,2011,1761,1707,54,3.1,-45
"Foster County, ND",ND,2010,1806,1745,61,3.4,0
"Fountain County, IN",IN,2021,7628,7409,219,2.9,-104
"Fountain County, IN",IN,2020,7732,7219,513,6.6,-322
"Fountain County, IN",IN,2019,8054,7776,278,3.5,-51
"Fountain County, IN",IN,2018,8105,7815,290,3.6,195
"Fountain County, IN",IN,2017,7910,7597,313,4.0,-67
"Fountain County, IN",IN,2016,7977,7520,457,5.7,-62
"Fountain County, IN",IN,2015,8039,7565,474,5.9,-155
"Fountain County, IN",IN,2014,8194,7623,571,7.0,-128
"Fountain County, IN",IN,2013,8322,7521,801,9.6,-216
"Fountain County, IN",IN,2012,8538,7832,706,8.3,-104
"Fountain County, IN",IN,2011,8642,7830,812,9.4,41
"Fountain County, IN",IN,2010,8601,7612,989,11.5,0
"Franklin city, VA",VA,2021,3481,3242,239,6.9,-166
"Franklin city, VA",VA,2020,3647,3343,304,8.3,15
"Franklin city, VA",VA,2019,3632,3489,143,3.9,8
"Franklin city, VA",VA,2018,3624,3468,156,4.3,20
"Franklin city, VA",VA,2017,3604,3415,189,5.2,64
"Franklin city, VA",VA,2016,3540,3329,211,6.0,-82
"Franklin city, VA",VA,2015,3622,3382,240,6.6,-3
"Franklin city, VA",VA,2014,3625,3346,279,7.7,-68
"Franklin city, VA",VA,2013,3693,3357,336,9.1,-28
"Franklin city, VA",VA,2012,3721,3356,365,9.8,53
"Franklin city, VA",VA,2011,3668,3251,417,11.4,-51
"Franklin city, VA",VA,2010,3719,3239,480,12.9,0
"Franklin County, AL",AL,2021,14304,13941,363,2.5,-263
"Franklin County, AL",AL,2020,14567,13844,723,5.0,-248
"Franklin County, AL",AL,2019,14815,14384,431,2.9,370
"Franklin County, AL",AL,2018,14445,13911,534,3.7,311
"Franklin County, AL",AL,2017,14134,13516,618,4.4,382
"Franklin County, AL",AL,2016,13752,12941,811,5.9,124
"Franklin County, AL",AL,2015,13628,12746,882,6.5,-109
"Franklin County, AL",AL,2014,13737,12681,1056,7.7,69
"Franklin County, AL",AL,2013,13668,12552,1116,8.2,-321
"Franklin County, AL",AL,2012,13989,12790,1199,8.6,-362
"Franklin County, AL",AL,2011,14351,12992,1359,9.5,99
"Franklin County, AL",AL,2010,14252,12752,1500,10.5,0
"Franklin County, AR",AR,2021,7267,6999,268,3.7,-214
"Franklin County, AR",AR,2020,7481,7058,423,5.7,-47
"Franklin County, AR",AR,2019,7528,7282,246,3.3,151
"Franklin County, AR",AR,2018,7377,7118,259,3.5,-24
"Franklin County, AR",AR,2017,7401,7139,262,3.5,23
"Franklin County, AR",AR,2016,7378,7079,299,4.1,-64
"Franklin County, AR",AR,2015,7442,7080,362,4.9,99
"Franklin County, AR",AR,2014,7343,6936,407,5.5,-123
"Franklin County, AR",AR,2013,7466,6965,501,6.7,-237
"Franklin County, AR",AR,2012,7703,7178,525,6.8,-66
"Franklin County, AR",AR,2011,7769,7201,568,7.3,-27
"Franklin County, AR",AR,2010,7796,7216,580,7.4,0
"Franklin County, FL",FL,2021,4719,4540,179,3.8,68
"Franklin County, FL",FL,2020,4651,4380,271,5.8,25
"Franklin County, FL",FL,2019,4626,4455,171,3.7,-63
"Franklin County, FL",FL,2018,4689,4520,169,3.6,26
"Franklin County, FL",FL,2017,4663,4492,171,3.7,-89
"Franklin County, FL",FL,2016,4752,4544,208,4.4,-39
"Franklin County, FL",FL,2015,4791,4563,228,4.8,-145
"Franklin County, FL",FL,2014,4936,4650,286,5.8,-39
"Franklin County, FL",FL,2013,4975,4688,287,5.8,-40
"Franklin County, FL",FL,2012,5015,4680,335,6.7,-7
"Franklin County, FL",FL,2011,5022,4639,383,7.6,123
"Franklin County, FL",FL,2010,4899,4522,377,7.7,0
"Franklin County, GA",GA,2021,10111,9740,371,3.7,219
"Franklin County, GA",GA,2020,9892,9315,577,5.8,-322
"Franklin County, GA",GA,2019,10214,9842,372,3.6,161
"Franklin County, GA",GA,2018,10053,9662,391,3.9,-125
"Franklin County, GA",GA,2017,10178,9688,490,4.8,390
"Franklin County, GA",GA,2016,9788,9269,519,5.3,608
"Franklin County, GA",GA,2015,9180,8594,586,6.4,-56
"Franklin County, GA",GA,2014,9236,8483,753,8.2,-82
"Franklin County, GA",GA,2013,9318,8414,904,9.7,-188
"Franklin County, GA",GA,2012,9506,8449,1057,11.1,-222
"Franklin County, GA",GA,2011,9728,8557,1171,12.0,-2
"Franklin County, GA",GA,2010,9730,8478,1252,12.9,0
"Franklin County, IA",IA,2021,5617,5407,210,3.7,-13
"Franklin County, IA",IA,2020,5630,5421,209,3.7,-189
"Franklin County, IA",IA,2019,5819,5689,130,2.2,-45
"Franklin County, IA",IA,2018,5864,5740,124,2.1,25
"Franklin County, IA",IA,2017,5839,5682,157,2.7,-136
"Franklin County, IA",IA,2016,5975,5770,205,3.4,17
"Franklin County, IA",IA,2015,5958,5760,198,3.3,-19
"Franklin County, IA",IA,2014,5977,5741,236,3.9,54
"Franklin County, IA",IA,2013,5923,5659,264,4.5,87
"Franklin County, IA",IA,2012,5836,5574,262,4.5,-159
"Franklin County, IA",IA,2011,5995,5683,312,5.2,-16
"Franklin County, IA",IA,2010,6011,5630,381,6.3,0
"Franklin County, ID",ID,2021,7369,7187,182,2.5,187
"Franklin County, ID",ID,2020,7182,6922,260,3.6,47
"Franklin County, ID",ID,2019,7135,6966,169,2.4,220
"Franklin County, ID",ID,2018,6915,6763,152,2.2,117
"Franklin County, ID",ID,2017,6798,6641,157,2.3,159
"Franklin County, ID",ID,2016,6639,6442,197,3.0,178
"Franklin County, ID",ID,2015,6461,6274,187,2.9,75
"Franklin County, ID",ID,2014,6386,6192,194,3.0,81
"Franklin County, ID",ID,2013,6305,6013,292,4.6,-25
"Franklin County, ID",ID,2012,6330,6031,299,4.7,86
"Franklin County, ID",ID,2011,6244,5914,330,5.3,39
"Franklin County, ID",ID,2010,6205,5888,317,5.1,0
"Franklin County, IL",IL,2021,15656,14618,1038,6.6,-279
"Franklin County, IL",IL,2020,15935,14230,1705,10.7,-482
"Franklin County, IL",IL,2019,16417,15570,847,5.2,-515
"Franklin County, IL",IL,2018,16932,15897,1035,6.1,323
"Franklin County, IL",IL,2017,16609,15533,1076,6.5,-156
"Franklin County, IL",IL,2016,16765,15406,1359,8.1,247
"Franklin County, IL",IL,2015,16518,15180,1338,8.1,-124
"Franklin County, IL",IL,2014,16642,15092,1550,9.3,-267
"Franklin County, IL",IL,2013,16909,14906,2003,11.8,-421
"Franklin County, IL",IL,2012,17330,15475,1855,10.7,-279
"Franklin County, IL",IL,2011,17609,15637,1972,11.2,-367
"Franklin County, IL",IL,2010,17976,15740,2236,12.4,0
"Franklin County, IN",IN,2021,11196,10893,303,2.7,-123
"Franklin County, IN",IN,2020,11319,10644,675,6.0,-198
"Franklin County, IN",IN,2019,11517,11128,389,3.4,104
"Franklin County, IN",IN,2018,11413,10995,418,3.7,196
"Franklin County, IN",IN,2017,11217,10816,401,3.6,-273
"Franklin County, IN",IN,2016,11490,10998,492,4.3,104
"Franklin County, IN",IN,2015,11386,10812,574,5.0,499
"Franklin County, IN",IN,2014,10887,10179,708,6.5,104
"Franklin County, IN",IN,2013,10783,9867,916,8.5,219
"Franklin County, IN",IN,2012,10564,9574,990,9.4,-677
"Franklin County, IN",IN,2011,11241,10137,1104,9.8,-150
"Franklin County, IN",IN,2010,11391,10121,1270,11.1,0
"Franklin County, KS",KS,2021,14521,14069,452,3.1,304
"Franklin County, KS",KS,2020,14217,13477,740,5.2,99
"Franklin County, KS",KS,2019,14118,13659,459,3.3,22
"Franklin County, KS",KS,2018,14096,13603,493,3.5,-147
"Franklin County, KS",KS,2017,14243,13713,530,3.7,-48
"Franklin County, KS",KS,2016,14291,13693,598,4.2,152
"Franklin County, KS",KS,2015,14139,13493,646,4.6,67
"Franklin County, KS",KS,2014,14072,13358,714,5.1,75
"Franklin County, KS",KS,2013,13997,13139,858,6.1,-29
"Franklin County, KS",KS,2012,14026,13011,1015,7.2,-15
"Franklin County, KS",KS,2011,14041,12891,1150,8.2,-306
"Franklin County, KS",KS,2010,14347,13081,1266,8.8,0
"Franklin County, KY",KY,2021,25190,24081,1109,4.4,459
"Franklin County, KY",KY,2020,24731,23168,1563,6.3,-467
"Franklin County, KY",KY,2019,25198,24306,892,3.5,224
"Franklin County, KY",KY,2018,24974,24072,902,3.6,191
"Franklin County, KY",KY,2017,24783,23786,997,4.0,335
"Franklin County, KY",KY,2016,24448,23466,982,4.0,132
"Franklin County, KY",KY,2015,24316,23294,1022,4.2,-54
"Franklin County, KY",KY,2014,24370,23085,1285,5.3,-211
"Franklin County, KY",KY,2013,24581,22981,1600,6.5,16
"Franklin County, KY",KY,2012,24565,22913,1652,6.7,-110
"Franklin County, KY",KY,2011,24675,22728,1947,7.9,-73
"Franklin County, KY",KY,2010,24748,22574,2174,8.8,0
"Franklin County, MA",MA,2021,40785,38757,2028,5.0,563
"Franklin County, MA",MA,2020,40222,37042,3180,7.9,-1135
"Franklin County, MA",MA,2019,41357,40184,1173,2.8,-88
"Franklin County, MA",MA,2018,41445,40155,1290,3.1,765
"Franklin County, MA",MA,2017,40680,39288,1392,3.4,1138
"Franklin County, MA",MA,2016,39542,38108,1434,3.6,97
"Franklin County, MA",MA,2015,39445,37717,1728,4.4,-88
"Franklin County, MA",MA,2014,39533,37440,2093,5.3,184
"Franklin County, MA",MA,2013,39349,36955,2394,6.1,-488
"Franklin County, MA",MA,2012,39837,37406,2431,6.1,130
"Franklin County, MA",MA,2011,39707,37118,2589,6.5,-285
"Franklin County, MA",MA,2010,39992,37037,2955,7.4,0
"Franklin County, ME",ME,2021,13839,13109,730,5.3,113
"Franklin County, ME",ME,2020,13726,12953,773,5.6,-809
"Franklin County, ME",ME,2019,14535,14029,506,3.5,0
"Franklin County, ME",ME,2018,14535,13997,538,3.7,-28
"Franklin County, ME",ME,2017,14563,13960,603,4.1,80
"Franklin County, ME",ME,2016,14483,13838,645,4.5,-146
"Franklin County, ME",ME,2015,14629,13932,697,4.8,-342
"Franklin County, ME",ME,2014,14971,14003,968,6.5,-403
"Franklin County, ME",ME,2013,15374,14179,1195,7.8,-65
"Franklin County, ME",ME,2012,15439,14150,1289,8.3,-28
"Franklin County, ME",ME,2011,15467,14096,1371,8.9,-100
"Franklin County, ME",ME,2010,15567,14079,1488,9.6,0
"Franklin County, MO",MO,2021,52747,50639,2108,4.0,211
"Franklin County, MO",MO,2020,52536,49318,3218,6.1,-856
"Franklin County, MO",MO,2019,53392,51779,1613,3.0,927
"Franklin County, MO",MO,2018,52465,50888,1577,3.0,100
"Franklin County, MO",MO,2017,52365,50476,1889,3.6,-248
"Franklin County, MO",MO,2016,52613,50323,2290,4.4,406
"Franklin County, MO",MO,2015,52207,49509,2698,5.2,304
"Franklin County, MO",MO,2014,51903,48531,3372,6.5,409
"Franklin County, MO",MO,2013,51494,47750,3744,7.3,-179
"Franklin County, MO",MO,2012,51673,47472,4201,8.1,-1019
"Franklin County, MO",MO,2011,52692,47646,5046,9.6,-514
"Franklin County, MO",MO,2010,53206,47232,5974,11.2,0
"Franklin County, MS",MS,2021,2660,2478,182,6.8,-47
"Franklin County, MS",MS,2020,2707,2487,220,8.1,-73
"Franklin County, MS",MS,2019,2780,2588,192,6.9,-24
"Franklin County, MS",MS,2018,2804,2634,170,6.1,-52
"Franklin County, MS",MS,2017,2856,2657,199,7.0,15
"Franklin County, MS",MS,2016,2841,2633,208,7.3,-89
"Franklin County, MS",MS,2015,2930,2702,228,7.8,31
"Franklin County, MS",MS,2014,2899,2653,246,8.5,-57
"Franklin County, MS",MS,2013,2956,2684,272,9.2,-147
"Franklin County, MS",MS,2012,3103,2806,297,9.6,-122
"Franklin County, MS",MS,2011,3225,2884,341,10.6,-15
"Franklin County, MS",MS,2010,3240,2881,359,11.1,0
"Franklin County, NC",NC,2021,32086,30577,1509,4.7,1329
"Franklin County, NC",NC,2020,30757,28746,2011,6.5,-509
"Franklin County, NC",NC,2019,31266,30015,1251,4.0,936
"Franklin County, NC",NC,2018,30330,29087,1243,4.1,647
"Franklin County, NC",NC,2017,29683,28297,1386,4.7,428
"Franklin County, NC",NC,2016,29255,27725,1530,5.2,571
"Franklin County, NC",NC,2015,28684,27006,1678,5.8,389
"Franklin County, NC",NC,2014,28295,26507,1788,6.3,11
"Franklin County, NC",NC,2013,28284,26014,2270,8.0,-124
"Franklin County, NC",NC,2012,28408,25590,2818,9.9,319
"Franklin County, NC",NC,2011,28089,25099,2990,10.6,34
"Franklin County, NC",NC,2010,28055,25029,3026,10.8,0
"Franklin County, NE",NE,2021,1505,1472,33,2.2,25
"Franklin County, NE",NE,2020,1480,1431,49,3.3,-19
"Franklin County, NE",NE,2019,1499,1450,49,3.3,11
"Franklin County, NE",NE,2018,1488,1442,46,3.1,-2
"Franklin County, NE",NE,2017,1490,1445,45,3.0,-19
"Franklin County, NE",NE,2016,1509,1464,45,3.0,-8
"Franklin County, NE",NE,2015,1517,1481,36,2.4,-60
"Franklin County, NE",NE,2014,1577,1527,50,3.2,-18
"Franklin County, NE",NE,2013,1595,1540,55,3.4,-46
"Franklin County, NE",NE,2012,1641,1583,58,3.5,-30
"Franklin County, NE",NE,2011,1671,1601,70,4.2,38
"Franklin County, NE",NE,2010,1633,1560,73,4.5,0
"Franklin County, NY",NY,2021,19114,18211,903,4.7,-329
"Franklin County, NY",NY,2020,19443,17898,1545,7.9,-511
"Franklin County, NY",NY,2019,19954,19006,948,4.8,-63
"Franklin County, NY",NY,2018,20017,18995,1022,5.1,-93
"Franklin County, NY",NY,2017,20110,18901,1209,6.0,306
"Franklin County, NY",NY,2016,19804,18662,1142,5.8,-136
"Franklin County, NY",NY,2015,19940,18632,1308,6.6,-549
"Franklin County, NY",NY,2014,20489,18990,1499,7.3,-1040
"Franklin County, NY",NY,2013,21529,19578,1951,9.1,-239
"Franklin County, NY",NY,2012,21768,19658,2110,9.7,14
"Franklin County, NY",NY,2011,21754,19759,1995,9.2,-506
"Franklin County, NY",NY,2010,22260,20232,2028,9.1,0
"Franklin County, OH",OH,2021,709058,673958,35100,5.0,9155
"Franklin County, OH",OH,2020,699903,647092,52811,7.5,-3256
"Franklin County, OH",OH,2019,703159,678059,25100,3.6,10259
"Franklin County, OH",OH,2018,692900,666488,26412,3.8,6365
"Franklin County, OH",OH,2017,686535,658718,27817,4.1,17089
"Franklin County, OH",OH,2016,669446,641672,27774,4.1,11463
"Franklin County, OH",OH,2015,657983,630764,27219,4.1,8843
"Franklin County, OH",OH,2014,649140,617574,31566,4.9,10711
"Franklin County, OH",OH,2013,638429,597401,41028,6.4,8018
"Franklin County, OH",OH,2012,630411,589946,40465,6.4,4658
"Franklin County, OH",OH,2011,625753,577243,48510,7.8,-2111
"Franklin County, OH",OH,2010,627864,571892,55972,8.9,0
"Franklin County, PA",PA,2021,77153,73196,3957,5.1,-1349
"Franklin County, PA",PA,2020,78502,72545,5957,7.6,-25
"Franklin County, PA",PA,2019,78527,75436,3091,3.9,740
"Franklin County, PA",PA,2018,77787,74795,2992,3.8,489
"Franklin County, PA",PA,2017,77298,73804,3494,4.5,-309
"Franklin County, PA",PA,2016,77607,73651,3956,5.1,-268
"Franklin County, PA",PA,2015,77875,73942,3933,5.1,1444
"Franklin County, PA",PA,2014,76431,72222,4209,5.5,59
"Franklin County, PA",PA,2013,76372,71489,4883,6.4,186
"Franklin County, PA",PA,2012,76186,70958,5228,6.9,798
"Franklin County, PA",PA,2011,75388,69972,5416,7.2,-94
"Franklin County, PA",PA,2010,75482,69227,6255,8.3,0
"Franklin County, TN",TN,2021,19463,18718,745,3.8,-439
"Franklin County, TN",TN,2020,19902,18311,1591,8.0,-378
"Franklin County, TN",TN,2019,20280,19597,683,3.4,378
"Franklin County, TN",TN,2018,19902,19229,673,3.4,44
"Franklin County, TN",TN,2017,19858,19106,752,3.8,7
"Franklin County, TN",TN,2016,19851,18884,967,4.9,218
"Franklin County, TN",TN,2015,19633,18623,1010,5.1,-53
"Franklin County, TN",TN,2014,19686,18474,1212,6.2,14
"Franklin County, TN",TN,2013,19672,18252,1420,7.2,224
"Franklin County, TN",TN,2012,19448,17910,1538,7.9,203
"Franklin County, TN",TN,2011,19245,17416,1829,9.5,-79
"Franklin County, TN",TN,2010,19324,17338,1986,10.3,0
"Franklin County, TX",TX,2021,5223,4994,229,4.4,438
"Franklin County, TX",TX,2020,4785,4529,256,5.4,174
"Franklin County, TX",TX,2019,4611,4444,167,3.6,89
"Franklin County, TX",TX,2018,4522,4334,188,4.2,12
"Franklin County, TX",TX,2017,4510,4299,211,4.7,-2
"Franklin County, TX",TX,2016,4512,4290,222,4.9,-47
"Franklin County, TX",TX,2015,4559,4335,224,4.9,-93
"Franklin County, TX",TX,2014,4652,4409,243,5.2,-29
"Franklin County, TX",TX,2013,4681,4373,308,6.6,62
"Franklin County, TX",TX,2012,4619,4279,340,7.4,-137
"Franklin County, TX",TX,2011,4756,4355,401,8.4,-62
"Franklin County, TX",TX,2010,4818,4401,417,8.7,0
"Franklin County, VA",VA,2021,25534,24628,906,3.5,-612
"Franklin County, VA",VA,2020,26146,24731,1415,5.4,-643
"Franklin County, VA",VA,2019,26789,26013,776,2.9,346
"Franklin County, VA",VA,2018,26443,25638,805,3.0,-119
"Franklin County, VA",VA,2017,26562,25535,1027,3.9,160
"Franklin County, VA",VA,2016,26402,25288,1114,4.2,-148
"Franklin County, VA",VA,2015,26550,25328,1222,4.6,-706
"Franklin County, VA",VA,2014,27256,25824,1432,5.3,40
"Franklin County, VA",VA,2013,27216,25648,1568,5.8,-168
"Franklin County, VA",VA,2012,27384,25618,1766,6.4,-255
"Franklin County, VA",VA,2011,27639,25573,2066,7.5,-25
"Franklin County, VA",VA,2010,27664,25204,2460,8.9,0
"Franklin County, VT",VT,2021,26722,25798,924,3.5,-651
"Franklin County, VT",VT,2020,27373,25978,1395,5.1,-1125
"Franklin County, VT",VT,2019,28498,27843,655,2.3,37
"Franklin County, VT",VT,2018,28461,27756,705,2.5,57
"Franklin County, VT",VT,2017,28404,27539,865,3.0,956
"Franklin County, VT",VT,2016,27448,26623,825,3.0,10
"Franklin County, VT",VT,2015,27438,26471,967,3.5,-157
"Franklin County, VT",VT,2014,27595,26493,1102,4.0,126
"Franklin County, VT",VT,2013,27469,26318,1151,4.2,-318
"Franklin County, VT",VT,2012,27787,26578,1209,4.4,-79
"Franklin County, VT",VT,2011,27866,26409,1457,5.2,162
"Franklin County, VT",VT,2010,27704,26063,1641,5.9,0
"Franklin County, WA",WA,2021,43835,40954,2881,6.6,-3
"Franklin County, WA",WA,2020,43838,40032,3806,8.7,376
"Franklin County, WA",WA,2019,43462,40623,2839,6.5,1567
"Franklin County, WA",WA,2018,41895,39356,2539,6.1,1009
"Franklin County, WA",WA,2017,40886,38334,2552,6.2,1022
"Franklin County, WA",WA,2016,39864,36952,2912,7.3,906
"Franklin County, WA",WA,2015,38958,36088,2870,7.4,979
"Franklin County, WA",WA,2014,37979,34902,3077,8.1,-363
"Franklin County, WA",WA,2013,38342,34802,3540,9.2,-634
"Franklin County, WA",WA,2012,38976,35508,3468,8.9,634
"Franklin County, WA",WA,2011,38342,35227,3115,8.1,812
"Franklin County, WA",WA,2010,37530,34543,2987,8.0,0
"Franklin Parish, LA",LA,2021,7420,6989,431,5.8,103
"Franklin Parish, LA",LA,2020,7317,6678,639,8.7,-81
"Franklin Parish, LA",LA,2019,7398,6884,514,6.9,103
"Franklin Parish, LA",LA,2018,7295,6778,517,7.1,-23
"Franklin Parish, LA",LA,2017,7318,6772,546,7.5,30
"Franklin Parish, LA",LA,2016,7288,6627,661,9.1,-201
"Franklin Parish, LA",LA,2015,7489,6768,721,9.6,-72
"Franklin Parish, LA",LA,2014,7561,6860,701,9.3,-133
"Franklin Parish, LA",LA,2013,7694,6949,745,9.7,-25
"Franklin Parish, LA",LA,2012,7719,6951,768,9.9,-254
"Franklin Parish, LA",LA,2011,7973,7088,885,11.1,-337
"Franklin Parish, LA",LA,2010,8310,7439,871,10.5,0
"Frederick County, MD",MD,2021,134802,128334,6468,4.8,-2738
"Frederick County, MD",MD,2020,137540,129513,8027,5.8,-2781
"Frederick County, MD",MD,2019,140321,136073,4248,3.0,4628
"Frederick County, MD",MD,2018,135693,131303,4390,3.2,3061
"Frederick County, MD",MD,2017,132632,127973,4659,3.5,4099
"Frederick County, MD",MD,2016,128533,123692,4841,3.8,60
"Frederick County, MD",MD,2015,128473,122837,5636,4.4,452
"Frederick County, MD",MD,2014,128021,121643,6378,5.0,-426
"Frederick County, MD",MD,2013,128447,121130,7317,5.7,-234
"Frederick County, MD",MD,2012,128681,120933,7748,6.0,66
"Frederick County, MD",MD,2011,128615,120249,8366,6.5,515
"Frederick County, MD",MD,2010,128100,119018,9082,7.1,0
"Frederick County, VA",VA,2021,49021,47598,1423,2.9,-443
"Frederick County, VA",VA,2020,49464,47189,2275,4.6,235
"Frederick County, VA",VA,2019,49229,48048,1181,2.4,1397
"Frederick County, VA",VA,2018,47832,46597,1235,2.6,1008
"Frederick County, VA",VA,2017,46824,45346,1478,3.2,1420
"Frederick County, VA",VA,2016,45404,43842,1562,3.4,608
"Frederick County, VA",VA,2015,44796,43043,1753,3.9,160
"Frederick County, VA",VA,2014,44636,42578,2058,4.6,483
"Frederick County, VA",VA,2013,44153,41871,2282,5.2,737
"Frederick County, VA",VA,2012,43416,40959,2457,5.7,288
"Frederick County, VA",VA,2011,43128,40343,2785,6.5,1101
"Frederick County, VA",VA,2010,42027,38812,3215,7.6,0
"Fredericksburg city, VA",VA,2021,13853,13207,646,4.7,-326
"Fredericksburg city, VA",VA,2020,14179,13175,1004,7.1,-134
"Fredericksburg city, VA",VA,2019,14313,13835,478,3.3,212
"Fredericksburg city, VA",VA,2018,14101,13617,484,3.4,379
"Fredericksburg city, VA",VA,2017,13722,13128,594,4.3,147
"Fredericksburg city, VA",VA,2016,13575,12936,639,4.7,156
"Fredericksburg city, VA",VA,2015,13419,12712,707,5.3,-297
"Fredericksburg city, VA",VA,2014,13716,12894,822,6.0,-47
"Fredericksburg city, VA",VA,2013,13763,12894,869,6.3,186
"Fredericksburg city, VA",VA,2012,13577,12638,939,6.9,525
"Fredericksburg city, VA",VA,2011,13052,12006,1046,8.0,606
"Fredericksburg city, VA",VA,2010,12446,11298,1148,9.2,0
"Freeborn County, MN",MN,2021,15344,14811,533,3.5,-967
"Freeborn County, MN",MN,2020,16311,15365,946,5.8,32
"Freeborn County, MN",MN,2019,16279,15683,596,3.7,179
"Freeborn County, MN",MN,2018,16100,15549,551,3.4,-120
"Freeborn County, MN",MN,2017,16220,15622,598,3.7,-56
"Freeborn County, MN",MN,2016,16276,15654,622,3.8,-107
"Freeborn County, MN",MN,2015,16383,15751,632,3.9,100
"Freeborn County, MN",MN,2014,16283,15561,722,4.4,-193
"Freeborn County, MN",MN,2013,16476,15643,833,5.1,-219
"Freeborn County, MN",MN,2012,16695,15719,976,5.8,-393
"Freeborn County, MN",MN,2011,17088,15949,1139,6.7,-9
"Freeborn County, MN",MN,2010,17097,15775,1322,7.7,0
"Freestone County, TX",TX,2021,6323,5865,458,7.2,45
"Freestone County, TX",TX,2020,6278,5754,524,8.3,-34
"Freestone County, TX",TX,2019,6312,6009,303,4.8,-179
"Freestone County, TX",TX,2018,6491,6107,384,5.9,-215
"Freestone County, TX",TX,2017,6706,6276,430,6.4,-166
"Freestone County, TX",TX,2016,6872,6412,460,6.7,-542
"Freestone County, TX",TX,2015,7414,7009,405,5.5,-420
"Freestone County, TX",TX,2014,7834,7387,447,5.7,-11
"Freestone County, TX",TX,2013,7845,7299,546,7.0,-197
"Freestone County, TX",TX,2012,8042,7504,538,6.7,-35
"Freestone County, TX",TX,2011,8077,7423,654,8.1,-84
"Freestone County, TX",TX,2010,8161,7485,676,8.3,0
"Fremont County, CO",CO,2021,15860,14764,1096,6.9,637
"Fremont County, CO",CO,2020,15223,14104,1119,7.4,301
"Fremont County, CO",CO,2019,14922,14276,646,4.3,36
"Fremont County, CO",CO,2018,14886,14170,716,4.8,69
"Fremont County, CO",CO,2017,14817,14231,586,4.0,122
"Fremont County, CO",CO,2016,14695,13968,727,4.9,206
"Fremont County, CO",CO,2015,14489,13627,862,5.9,-35
"Fremont County, CO",CO,2014,14524,13336,1188,8.2,-405
"Fremont County, CO",CO,2013,14929,13359,1570,10.5,-667
"Fremont County, CO",CO,2012,15596,13755,1841,11.8,-317
"Fremont County, CO",CO,2011,15913,13928,1985,12.5,115
"Fremont County, CO",CO,2010,15798,13864,1934,12.2,0
"Fremont County, IA",IA,2021,3720,3613,107,2.9,-4
"Fremont County, IA",IA,2020,3724,3612,112,3.0,-62
"Fremont County, IA",IA,2019,3786,3688,98,2.6,15
"Fremont County, IA",IA,2018,3771,3701,70,1.9,-77
"Fremont County, IA",IA,2017,3848,3749,99,2.6,-161
"Fremont County, IA",IA,2016,4009,3878,131,3.3,-140
"Fremont County, IA",IA,2015,4149,4013,136,3.3,-20
"Fremont County, IA",IA,2014,4169,4008,161,3.9,36
"Fremont County, IA",IA,2013,4133,3959,174,4.2,107
"Fremont County, IA",IA,2012,4026,3819,207,5.1,40
"Fremont County, IA",IA,2011,3986,3751,235,5.9,18
"Fremont County, IA",IA,2010,3968,3730,238,6.0,0
"Fremont County, ID",ID,2021,8191,7955,236,2.9,269
"Fremont County, ID",ID,2020,7922,7625,297,3.7,104
"Fremont County, ID",ID,2019,7818,7633,185,2.4,-6
"Fremont County, ID",ID,2018,7824,7632,192,2.5,157
"Fremont County, ID",ID,2017,7667,7463,204,2.7,300
"Fremont County, ID",ID,2016,7367,7127,240,3.3,182
"Fremont County, ID",ID,2015,7185,6943,242,3.4,230
"Fremont County, ID",ID,2014,6955,6698,257,3.7,-13
"Fremont County, ID",ID,2013,6968,6560,408,5.9,16
"Fremont County, ID",ID,2012,6952,6511,441,6.3,252
"Fremont County, ID",ID,2011,6700,6190,510,7.6,-59
"Fremont County, ID",ID,2010,6759,6184,575,8.5,0
"Fremont County, WY",WY,2021,18927,18039,888,4.7,-90
"Fremont County, WY",WY,2020,19017,17833,1184,6.2,219
"Fremont County, WY",WY,2019,18798,17941,857,4.6,-188
"Fremont County, WY",WY,2018,18986,17993,993,5.2,-428
"Fremont County, WY",WY,2017,19414,18306,1108,5.7,-626
"Fremont County, WY",WY,2016,20040,18591,1449,7.2,-34
"Fremont County, WY",WY,2015,20074,18977,1097,5.5,-259
"Fremont County, WY",WY,2014,20333,19273,1060,5.2,-413
"Fremont County, WY",WY,2013,20746,19553,1193,5.8,-288
"Fremont County, WY",WY,2012,21034,19726,1308,6.2,79
"Fremont County, WY",WY,2011,20955,19519,1436,6.9,65
"Fremont County, WY",WY,2010,20890,19321,1569,7.5,0
"Fresno County, CA",CA,2021,443383,402642,40741,9.2,-1610
"Fresno County, CA",CA,2020,444993,392711,52282,11.7,-6296
"Fresno County, CA",CA,2019,451289,418064,33225,7.4,5061
"Fresno County, CA",CA,2018,446228,412260,33968,7.6,1776
"Fresno County, CA",CA,2017,444452,406265,38187,8.6,-285
"Fresno County, CA",CA,2016,444737,402364,42373,9.5,4429
"Fresno County, CA",CA,2015,440308,395174,45134,10.3,2691
"Fresno County, CA",CA,2014,437617,386366,51251,11.7,997
"Fresno County, CA",CA,2013,436620,378042,58578,13.4,-2872
"Fresno County, CA",CA,2012,439492,371963,67529,15.4,-3758
"Fresno County, CA",CA,2011,443250,368767,74483,16.8,2688
"Fresno County, CA",CA,2010,440562,365290,75272,17.1,0
"Frio County, TX",TX,2021,9396,8944,452,4.8,-71
"Frio County, TX",TX,2020,9467,8930,537,5.7,-843
"Frio County, TX",TX,2019,10310,10039,271,2.6,221
"Frio County, TX",TX,2018,10089,9799,290,2.9,795
"Frio County, TX",TX,2017,9294,8925,369,4.0,511
"Frio County, TX",TX,2016,8783,8355,428,4.9,-1023
"Frio County, TX",TX,2015,9806,9427,379,3.9,-520
"Frio County, TX",TX,2014,10326,9952,374,3.6,1058
"Frio County, TX",TX,2013,9268,8831,437,4.7,616
"Frio County, TX",TX,2012,8652,8219,433,5.0,686
"Frio County, TX",TX,2011,7966,7432,534,6.7,371
"Frio County, TX",TX,2010,7595,7038,557,7.3,0
"Frontier County, NE",NE,2021,1576,1549,27,1.7,20
"Frontier County, NE",NE,2020,1556,1512,44,2.8,-75
"Frontier County, NE",NE,2019,1631,1579,52,3.2,101
"Frontier County, NE",NE,2018,1530,1490,40,2.6,-45
"Frontier County, NE",NE,2017,1575,1535,40,2.5,-3
"Frontier County, NE",NE,2016,1578,1534,44,2.8,40
"Frontier County, NE",NE,2015,1538,1501,37,2.4,-14
"Frontier County, NE",NE,2014,1552,1509,43,2.8,-41
"Frontier County, NE",NE,2013,1593,1540,53,3.3,-16
"Frontier County, NE",NE,2012,1609,1559,50,3.1,6
"Frontier County, NE",NE,2011,1603,1546,57,3.6,9
"Frontier County, NE",NE,2010,1594,1533,61,3.8,0
"Fulton County, AR",AR,2021,4889,4711,178,3.6,-40
"Fulton County, AR",AR,2020,4929,4675,254,5.2,-54
"Fulton County, AR",AR,2019,4983,4788,195,3.9,166
"Fulton County, AR",AR,2018,4817,4627,190,3.9,99
"Fulton County, AR",AR,2017,4718,4518,200,4.2,43
"Fulton County, AR",AR,2016,4675,4472,203,4.3,-104
"Fulton County, AR",AR,2015,4779,4534,245,5.1,-44
"Fulton County, AR",AR,2014,4823,4549,274,5.7,-123
"Fulton County, AR",AR,2013,4946,4613,333,6.7,-184
"Fulton County, AR",AR,2012,5130,4775,355,6.9,25
"Fulton County, AR",AR,2011,5105,4727,378,7.4,-62
"Fulton County, AR",AR,2010,5167,4778,389,7.5,0
"Fulton County, GA",GA,2021,569144,542664,26480,4.7,10380
"Fulton County, GA",GA,2020,558764,514565,44199,7.9,-2172
"Fulton County, GA",GA,2019,560936,540379,20557,3.7,5426
"Fulton County, GA",GA,2018,555510,532702,22808,4.1,1353
"Fulton County, GA",GA,2017,554157,527208,26949,4.9,23033
"Fulton County, GA",GA,2016,531124,502170,28954,5.5,22309
"Fulton County, GA",GA,2015,508815,477884,30931,6.1,196
"Fulton County, GA",GA,2014,508619,472618,36001,7.1,1054
"Fulton County, GA",GA,2013,507565,466867,40698,8.0,-1817
"Fulton County, GA",GA,2012,509382,463742,45640,9.0,11581
"Fulton County, GA",GA,2011,497801,447564,50237,10.1,11523
"Fulton County, GA",GA,2010,486278,434852,51426,10.6,0
"Fulton County, IL",IL,2021,14421,13601,820,5.7,-135
"Fulton County, IL",IL,2020,14556,13290,1266,8.7,-649
"Fulton County, IL",IL,2019,15205,14396,809,5.3,-100
"Fulton County, IL",IL,2018,15305,14366,939,6.1,-198
"Fulton County, IL",IL,2017,15503,14512,991,6.4,-368
"Fulton County, IL",IL,2016,15871,14697,1174,7.4,58
"Fulton County, IL",IL,2015,15813,14606,1207,7.6,62
"Fulton County, IL",IL,2014,15751,14389,1362,8.6,-443
"Fulton County, IL",IL,2013,16194,14432,1762,10.9,-687
"Fulton County, IL",IL,2012,16881,15196,1685,10.0,-543
"Fulton County, IL",IL,2011,17424,15589,1835,10.5,-140
"Fulton County, IL",IL,2010,17564,15489,2075,11.8,0
"Fulton County, IN",IN,2021,9445,9133,312,3.3,-231
"Fulton County, IN",IN,2020,9676,9034,642,6.6,-248
"Fulton County, IN",IN,2019,9924,9615,309,3.1,-87
"Fulton County, IN",IN,2018,10011,9679,332,3.3,246
"Fulton County, IN",IN,2017,9765,9428,337,3.5,-131
"Fulton County, IN",IN,2016,9896,9439,457,4.6,37
"Fulton County, IN",IN,2015,9859,9391,468,4.7,63
"Fulton County, IN",IN,2014,9796,9184,612,6.2,-102
"Fulton County, IN",IN,2013,9898,9096,802,8.1,-192
"Fulton County, IN",IN,2012,10090,9258,832,8.2,-133
"Fulton County, IN",IN,2011,10223,9298,925,9.0,-61
"Fulton County, IN",IN,2010,10284,9139,1145,11.1,0
"Fulton County, KY",KY,2021,2075,1965,110,5.3,90
"Fulton County, KY",KY,2020,1985,1857,128,6.4,-50
"Fulton County, KY",KY,2019,2035,1925,110,5.4,5
"Fulton County, KY",KY,2018,2030,1918,112,5.5,-35
"Fulton County, KY",KY,2017,2065,1919,146,7.1,-1
"Fulton County, KY",KY,2016,2066,1925,141,6.8,4
"Fulton County, KY",KY,2015,2062,1905,157,7.6,-167
"Fulton County, KY",KY,2014,2229,2044,185,8.3,-158
"Fulton County, KY",KY,2013,2387,2132,255,10.7,-96
"Fulton County, KY",KY,2012,2483,2202,281,11.3,-179
"Fulton County, KY",KY,2011,2662,2333,329,12.4,-81
"Fulton County, KY",KY,2010,2743,2425,318,11.6,0
"Fulton County, NY",NY,2021,22353,21121,1232,5.5,-546
"Fulton County, NY",NY,2020,22899,21009,1890,8.3,-164
"Fulton County, NY",NY,2019,23063,21947,1116,4.8,-235
"Fulton County, NY",NY,2018,23298,22117,1181,5.1,-289
"Fulton County, NY",NY,2017,23587,22235,1352,5.7,349
"Fulton County, NY",NY,2016,23238,21886,1352,5.8,-171
"Fulton County, NY",NY,2015,23409,21892,1517,6.5,2
"Fulton County, NY",NY,2014,23407,21599,1808,7.7,-1317
"Fulton County, NY",NY,2013,24724,22323,2401,9.7,-646
"Fulton County, NY",NY,2012,25370,22534,2836,11.2,-233
"Fulton County, NY",NY,2011,25603,22871,2732,10.7,-545
"Fulton County, NY",NY,2010,26148,23317,2831,10.8,0
"Fulton County, OH",OH,2021,21631,20612,1019,4.7,-108
"Fulton County, OH",OH,2020,21739,20025,1714,7.9,-890
"Fulton County, OH",OH,2019,22629,21686,943,4.2,196
"Fulton County, OH",OH,2018,22433,21450,983,4.4,-159
"Fulton County, OH",OH,2017,22592,21485,1107,4.9,-174
"Fulton County, OH",OH,2016,22766,21700,1066,4.7,254
"Fulton County, OH",OH,2015,22512,21402,1110,4.9,89
"Fulton County, OH",OH,2014,22423,21101,1322,5.9,-12
"Fulton County, OH",OH,2013,22435,20659,1776,7.9,4
"Fulton County, OH",OH,2012,22431,20698,1733,7.7,-140
"Fulton County, OH",OH,2011,22571,20402,2169,9.6,-607
"Fulton County, OH",OH,2010,23178,20430,2748,11.9,0
"Fulton County, PA",PA,2021,7109,6661,448,6.3,-395
"Fulton County, PA",PA,2020,7504,6609,895,11.9,-286
"Fulton County, PA",PA,2019,7790,7431,359,4.6,-120
"Fulton County, PA",PA,2018,7910,7584,326,4.1,595
"Fulton County, PA",PA,2017,7315,6938,377,5.2,1
"Fulton County, PA",PA,2016,7314,6857,457,6.2,-132
"Fulton County, PA",PA,2015,7446,6973,473,6.4,150
"Fulton County, PA",PA,2014,7296,6773,523,7.2,-79
"Fulton County, PA",PA,2013,7375,6716,659,8.9,-48
"Fulton County, PA",PA,2012,7423,6753,670,9.0,90
"Fulton County, PA",PA,2011,7333,6607,726,9.9,-68
"Fulton County, PA",PA,2010,7401,6519,882,11.9,0
"Furnas County, NE",NE,2021,2583,2534,49,1.9,-33
"Furnas County, NE",NE,2020,2616,2546,70,2.7,4
"Furnas County, NE",NE,2019,2612,2540,72,2.8,-39
"Furnas County, NE",NE,2018,2651,2581,70,2.6,-51
"Furnas County, NE",NE,2017,2702,2636,66,2.4,-29
"Furnas County, NE",NE,2016,2731,2655,76,2.8,-8
"Furnas County, NE",NE,2015,2739,2667,72,2.6,28
"Furnas County, NE",NE,2014,2711,2634,77,2.8,-11
"Furnas County, NE",NE,2013,2722,2629,93,3.4,39
"Furnas County, NE",NE,2012,2683,2591,92,3.4,-30
"Furnas County, NE",NE,2011,2713,2614,99,3.6,57
"Furnas County, NE",NE,2010,2656,2565,91,3.4,0
"Gadsden County, FL",FL,2021,19283,18250,1033,5.4,1071
"Gadsden County, FL",FL,2020,18212,16840,1372,7.5,-194
"Gadsden County, FL",FL,2019,18406,17626,780,4.2,168
"Gadsden County, FL",FL,2018,18238,17380,858,4.7,215
"Gadsden County, FL",FL,2017,18023,17018,1005,5.6,-246
"Gadsden County, FL",FL,2016,18269,17114,1155,6.3,-16
"Gadsden County, FL",FL,2015,18285,16957,1328,7.3,-509
"Gadsden County, FL",FL,2014,18794,17202,1592,8.5,-41
"Gadsden County, FL",FL,2013,18835,17037,1798,9.5,45
"Gadsden County, FL",FL,2012,18790,16794,1996,10.6,-710
"Gadsden County, FL",FL,2011,19500,17244,2256,11.6,-397
"Gadsden County, FL",FL,2010,19897,17629,2268,11.4,0
"Gage County, NE",NE,2021,10945,10679,266,2.4,-28
"Gage County, NE",NE,2020,10973,10542,431,3.9,-171
"Gage County, NE",NE,2019,11144,10750,394,3.5,96
"Gage County, NE",NE,2018,11048,10690,358,3.2,-14
"Gage County, NE",NE,2017,11062,10672,390,3.5,-50
"Gage County, NE",NE,2016,11112,10749,363,3.3,22
"Gage County, NE",NE,2015,11090,10689,401,3.6,-4
"Gage County, NE",NE,2014,11094,10638,456,4.1,6
"Gage County, NE",NE,2013,11088,10590,498,4.5,-64
"Gage County, NE",NE,2012,11152,10613,539,4.8,-44
"Gage County, NE",NE,2011,11196,10547,649,5.8,-198
"Gage County, NE",NE,2010,11394,10727,667,5.9,0
"Gaines County, TX",TX,2021,9748,9300,448,4.6,104
"Gaines County, TX",TX,2020,9644,9101,543,5.6,-115
"Gaines County, TX",TX,2019,9759,9522,237,2.4,424
"Gaines County, TX",TX,2018,9335,9094,241,2.6,156
"Gaines County, TX",TX,2017,9179,8898,281,3.1,-8
"Gaines County, TX",TX,2016,9187,8844,343,3.7,-221
"Gaines County, TX",TX,2015,9408,9101,307,3.3,57
"Gaines County, TX",TX,2014,9351,9042,309,3.3,455
"Gaines County, TX",TX,2013,8896,8522,374,4.2,131
"Gaines County, TX",TX,2012,8765,8395,370,4.2,268
"Gaines County, TX",TX,2011,8497,8051,446,5.2,552
"Gaines County, TX",TX,2010,7945,7471,474,6.0,0
"Galax city, VA",VA,2021,2813,2698,115,4.1,-71
"Galax city, VA",VA,2020,2884,2661,223,7.7,-70
"Galax city, VA",VA,2019,2954,2860,94,3.2,-5
"Galax city, VA",VA,2018,2959,2858,101,3.4,-75
"Galax city, VA",VA,2017,3034,2909,125,4.1,129
"Galax city, VA",VA,2016,2905,2764,141,4.9,-52
"Galax city, VA",VA,2015,2957,2798,159,5.4,-46
"Galax city, VA",VA,2014,3003,2786,217,7.2,-15
"Galax city, VA",VA,2013,3018,2764,254,8.4,-33
"Galax city, VA",VA,2012,3051,2786,265,8.7,-48
"Galax city, VA",VA,2011,3099,2781,318,10.3,-80
"Galax city, VA",VA,2010,3179,2824,355,11.2,0
"Gallatin County, IL",IL,2021,1954,1835,119,6.1,-55
"Gallatin County, IL",IL,2020,2009,1819,190,9.5,-330
"Gallatin County, IL",IL,2019,2339,2227,112,4.8,-115
"Gallatin County, IL",IL,2018,2454,2309,145,5.9,-20
"Gallatin County, IL",IL,2017,2474,2327,147,5.9,-72
"Gallatin County, IL",IL,2016,2546,2352,194,7.6,76
"Gallatin County, IL",IL,2015,2470,2305,165,6.7,7
"Gallatin County, IL",IL,2014,2463,2286,177,7.2,-15
"Gallatin County, IL",IL,2013,2478,2245,233,9.4,-37
"Gallatin County, IL",IL,2012,2515,2302,213,8.5,-61
"Gallatin County, IL",IL,2011,2576,2347,229,8.9,-56
"Gallatin County, IL",IL,2010,2632,2377,255,9.7,0
"Gallatin County, KY",KY,2021,4000,3828,172,4.3,52
"Gallatin County, KY",KY,2020,3948,3718,230,5.8,-174
"Gallatin County, KY",KY,2019,4122,3966,156,3.8,56
"Gallatin County, KY",KY,2018,4066,3905,161,4.0,27
"Gallatin County, KY",KY,2017,4039,3859,180,4.5,135
"Gallatin County, KY",KY,2016,3904,3717,187,4.8,62
"Gallatin County, KY",KY,2015,3842,3646,196,5.1,-22
"Gallatin County, KY",KY,2014,3864,3595,269,7.0,-89
"Gallatin County, KY",KY,2013,3953,3588,365,9.2,7
"Gallatin County, KY",KY,2012,3946,3576,370,9.4,-68
"Gallatin County, KY",KY,2011,4014,3584,430,10.7,-84
"Gallatin County, KY",KY,2010,4098,3588,510,12.4,0
"Gallatin County, MT",MT,2021,73887,72116,1771,2.4,2987
"Gallatin County, MT",MT,2020,70900,67418,3482,4.9,841
"Gallatin County, MT",MT,2019,70059,68422,1637,2.3,2647
"Gallatin County, MT",MT,2018,67412,65697,1715,2.5,2490
"Gallatin County, MT",MT,2017,64922,63106,1816,2.8,2862
"Gallatin County, MT",MT,2016,62060,60245,1815,2.9,2601
"Gallatin County, MT",MT,2015,59459,57622,1837,3.1,2572
"Gallatin County, MT",MT,2014,56887,54904,1983,3.5,2050
"Gallatin County, MT",MT,2013,54837,52604,2233,4.1,2343
"Gallatin County, MT",MT,2012,52494,49895,2599,5.0,939
"Gallatin County, MT",MT,2011,51555,48602,2953,5.7,756
"Gallatin County, MT",MT,2010,50799,47397,3402,6.7,0
"Gallia County, OH",OH,2021,12111,11427,684,5.6,-88
"Gallia County, OH",OH,2020,12199,11223,976,8.0,-125
"Gallia County, OH",OH,2019,12324,11653,671,5.4,-28
"Gallia County, OH",OH,2018,12352,11608,744,6.0,2
"Gallia County, OH",OH,2017,12350,11535,815,6.6,174
"Gallia County, OH",OH,2016,12176,11340,836,6.9,-71
"Gallia County, OH",OH,2015,12247,11444,803,6.6,-192
"Gallia County, OH",OH,2014,12439,11481,958,7.7,-65
"Gallia County, OH",OH,2013,12504,11296,1208,9.7,-148
"Gallia County, OH",OH,2012,12652,11431,1221,9.7,-344
"Gallia County, OH",OH,2011,12996,11542,1454,11.2,-610
"Gallia County, OH",OH,2010,13606,11996,1610,11.8,0
"Galveston County, TX",TX,2021,165052,154065,10987,6.7,2072
"Galveston County, TX",TX,2020,162980,148692,14288,8.8,-920
"Galveston County, TX",TX,2019,163900,157262,6638,4.1,2204
"Galveston County, TX",TX,2018,161696,154144,7552,4.7,912
"Galveston County, TX",TX,2017,160784,152262,8522,5.3,613
"Galveston County, TX",TX,2016,160171,151625,8546,5.3,2159
"Galveston County, TX",TX,2015,158012,150077,7935,5.0,601
"Galveston County, TX",TX,2014,157411,148465,8946,5.7,1968
"Galveston County, TX",TX,2013,155443,144677,10766,6.9,2679
"Galveston County, TX",TX,2012,152764,141167,11597,7.6,2921
"Galveston County, TX",TX,2011,149843,136198,13645,9.1,2312
"Galveston County, TX",TX,2010,147531,133996,13535,9.2,0
"Garden County, NE",NE,2021,1119,1096,23,2.1,37
"Garden County, NE",NE,2020,1082,1044,38,3.5,-25
"Garden County, NE",NE,2019,1107,1075,32,2.9,-88
"Garden County, NE",NE,2018,1195,1165,30,2.5,-6
"Garden County, NE",NE,2017,1201,1167,34,2.8,7
"Garden County, NE",NE,2016,1194,1155,39,3.3,-7
"Garden County, NE",NE,2015,1201,1172,29,2.4,7
"Garden County, NE",NE,2014,1194,1160,34,2.8,-39
"Garden County, NE",NE,2013,1233,1199,34,2.8,-25
"Garden County, NE",NE,2012,1258,1219,39,3.1,-2
"Garden County, NE",NE,2011,1260,1215,45,3.6,-5
"Garden County, NE",NE,2010,1265,1212,53,4.2,0
"Garfield County, CO",CO,2021,32254,30749,1505,4.7,849
"Garfield County, CO",CO,2020,31405,29376,2029,6.5,-942
"Garfield County, CO",CO,2019,32347,31520,827,2.6,296
"Garfield County, CO",CO,2018,32051,31108,943,2.9,794
"Garfield County, CO",CO,2017,31257,30420,837,2.7,263
"Garfield County, CO",CO,2016,30994,29959,1035,3.3,532
"Garfield County, CO",CO,2015,30462,29247,1215,4.0,-694
"Garfield County, CO",CO,2014,31156,29525,1631,5.2,233
"Garfield County, CO",CO,2013,30923,28657,2266,7.3,-474
"Garfield County, CO",CO,2012,31397,28698,2699,8.6,77
"Garfield County, CO",CO,2011,31320,28248,3072,9.8,39
"Garfield County, CO",CO,2010,31281,27896,3385,10.8,0
"Garfield County, MT",MT,2021,742,723,19,2.6,-4
"Garfield County, MT",MT,2020,746,726,20,2.7,-3
"Garfield County, MT",MT,2019,749,731,18,2.4,7
"Garfield County, MT",MT,2018,742,722,20,2.7,-23
"Garfield County, MT",MT,2017,765,743,22,2.9,2
"Garfield County, MT",MT,2016,763,740,23,3.0,1
"Garfield County, MT",MT,2015,762,740,22,2.9,14
"Garfield County, MT",MT,2014,748,728,20,2.7,-14
"Garfield County, MT",MT,2013,762,738,24,3.1,-7
"Garfield County, MT",MT,2012,769,746,23,3.0,-9
"Garfield County, MT",MT,2011,778,749,29,3.7,13
"Garfield County, MT",MT,2010,765,738,27,3.5,0
"Garfield County, NE",NE,2021,1151,1128,23,2.0,-11
"Garfield County, NE",NE,2020,1162,1139,23,2.0,-1
"Garfield County, NE",NE,2019,1163,1132,31,2.7,-13
"Garfield County, NE",NE,2018,1176,1147,29,2.5,8
"Garfield County, NE",NE,2017,1168,1137,31,2.7,6
"Garfield County, NE",NE,2016,1162,1133,29,2.5,-36
"Garfield County, NE",NE,2015,1198,1169,29,2.4,-5
"Garfield County, NE",NE,2014,1203,1172,31,2.6,-25
"Garfield County, NE",NE,2013,1228,1191,37,3.0,10
"Garfield County, NE",NE,2012,1218,1182,36,3.0,12
"Garfield County, NE",NE,2011,1206,1165,41,3.4,6
"Garfield County, NE",NE,2010,1200,1162,38,3.2,0
"Garfield County, OK",OK,2021,26842,25917,925,3.4,-12
"Garfield County, OK",OK,2020,26854,25369,1485,5.5,-133
"Garfield County, OK",OK,2019,26987,26217,770,2.9,-131
"Garfield County, OK",OK,2018,27118,26330,788,2.9,-584
"Garfield County, OK",OK,2017,27702,26690,1012,3.7,-1267
"Garfield County, OK",OK,2016,28969,27748,1221,4.2,-1096
"Garfield County, OK",OK,2015,30065,28910,1155,3.8,419
"Garfield County, OK",OK,2014,29646,28625,1021,3.4,241
"Garfield County, OK",OK,2013,29405,28231,1174,4.0,-15
"Garfield County, OK",OK,2012,29420,28264,1156,3.9,666
"Garfield County, OK",OK,2011,28754,27543,1211,4.2,259
"Garfield County, OK",OK,2010,28495,26986,1509,5.3,0
"Garfield County, UT",UT,2021,2778,2597,181,6.5,124
"Garfield County, UT",UT,2020,2654,2379,275,10.4,-133
"Garfield County, UT",UT,2019,2787,2617,170,6.1,-5
"Garfield County, UT",UT,2018,2792,2587,205,7.3,-117
"Garfield County, UT",UT,2017,2909,2697,212,7.3,130
"Garfield County, UT",UT,2016,2779,2554,225,8.1,42
"Garfield County, UT",UT,2015,2737,2498,239,8.7,49
"Garfield County, UT",UT,2014,2688,2463,225,8.4,-43
"Garfield County, UT",UT,2013,2731,2500,231,8.5,-61
"Garfield County, UT",UT,2012,2792,2557,235,8.4,-154
"Garfield County, UT",UT,2011,2946,2619,327,11.1,-116
"Garfield County, UT",UT,2010,3062,2744,318,10.4,0
"Garfield County, WA",WA,2021,821,773,48,5.8,6
"Garfield County, WA",WA,2020,815,746,69,8.5,-102
"Garfield County, WA",WA,2019,917,865,52,5.7,7
"Garfield County, WA",WA,2018,910,858,52,5.7,1
"Garfield County, WA",WA,2017,909,861,48,5.3,-11
"Garfield County, WA",WA,2016,920,867,53,5.8,-10
"Garfield County, WA",WA,2015,930,874,56,6.0,-29
"Garfield County, WA",WA,2014,959,897,62,6.5,-25
"Garfield County, WA",WA,2013,984,913,71,7.2,-33
"Garfield County, WA",WA,2012,1017,946,71,7.0,-6
"Garfield County, WA",WA,2011,1023,953,70,6.8,-18
"Garfield County, WA",WA,2010,1041,964,77,7.4,0
"Garland County, AR",AR,2021,40528,38500,2028,5.0,-792
"Garland County, AR",AR,2020,41320,38009,3311,8.0,-170
"Garland County, AR",AR,2019,41490,39983,1507,3.6,713
"Garland County, AR",AR,2018,40777,39159,1618,4.0,447
"Garland County, AR",AR,2017,40330,38691,1639,4.1,178
"Garland County, AR",AR,2016,40152,38421,1731,4.3,41
"Garland County, AR",AR,2015,40111,37950,2161,5.4,-534
"Garland County, AR",AR,2014,40645,38129,2516,6.2,-419
"Garland County, AR",AR,2013,41064,38029,3035,7.4,-302
"Garland County, AR",AR,2012,41366,38227,3139,7.6,-200
"Garland County, AR",AR,2011,41566,38097,3469,8.3,62
"Garland County, AR",AR,2010,41504,38130,3374,8.1,0
"Garrard County, KY",KY,2021,7629,7289,340,4.5,113
"Garrard County, KY",KY,2020,7516,7058,458,6.1,-204
"Garrard County, KY",KY,2019,7720,7381,339,4.4,61
"Garrard County, KY",KY,2018,7659,7327,332,4.3,0
"Garrard County, KY",KY,2017,7659,7293,366,4.8,132
"Garrard County, KY",KY,2016,7527,7165,362,4.8,35
"Garrard County, KY",KY,2015,7492,7109,383,5.1,-100
"Garrard County, KY",KY,2014,7592,7098,494,6.5,-155
"Garrard County, KY",KY,2013,7747,7118,629,8.1,-9
"Garrard County, KY",KY,2012,7756,7098,658,8.5,-73
"Garrard County, KY",KY,2011,7829,7046,783,10.0,-148
"Garrard County, KY",KY,2010,7977,7080,897,11.2,0
"Garrett County, MD",MD,2021,15365,14561,804,5.2,-258
"Garrett County, MD",MD,2020,15623,14574,1049,6.7,-635
"Garrett County, MD",MD,2019,16258,15574,684,4.2,481
"Garrett County, MD",MD,2018,15777,15081,696,4.4,78
"Garrett County, MD",MD,2017,15699,14916,783,5.0,216
"Garrett County, MD",MD,2016,15483,14635,848,5.5,-144
"Garrett County, MD",MD,2015,15627,14660,967,6.2,93
"Garrett County, MD",MD,2014,15534,14440,1094,7.0,-207
"Garrett County, MD",MD,2013,15741,14485,1256,8.0,-92
"Garrett County, MD",MD,2012,15833,14538,1295,8.2,12
"Garrett County, MD",MD,2011,15821,14477,1344,8.5,-18
"Garrett County, MD",MD,2010,15839,14397,1442,9.1,0
"Garvin County, OK",OK,2021,12682,12206,476,3.8,-12
"Garvin County, OK",OK,2020,12694,11894,800,6.3,154
"Garvin County, OK",OK,2019,12540,12162,378,3.0,-88
"Garvin County, OK",OK,2018,12628,12231,397,3.1,43
"Garvin County, OK",OK,2017,12585,12088,497,3.9,-112
"Garvin County, OK",OK,2016,12697,12042,655,5.2,-124
"Garvin County, OK",OK,2015,12821,12233,588,4.6,198
"Garvin County, OK",OK,2014,12623,12127,496,3.9,184
"Garvin County, OK",OK,2013,12439,11837,602,4.8,-28
"Garvin County, OK",OK,2012,12467,11865,602,4.8,298
"Garvin County, OK",OK,2011,12169,11493,676,5.6,26
"Garvin County, OK",OK,2010,12143,11264,879,7.2,0
"Garza County, TX",TX,2021,1988,1888,100,5.0,-7
"Garza County, TX",TX,2020,1995,1859,136,6.8,-116
"Garza County, TX",TX,2019,2111,2056,55,2.6,-4
"Garza County, TX",TX,2018,2115,2053,62,2.9,10
"Garza County, TX",TX,2017,2105,2035,70,3.3,-26
"Garza County, TX",TX,2016,2131,2048,83,3.9,-1
"Garza County, TX",TX,2015,2132,2053,79,3.7,-107
"Garza County, TX",TX,2014,2239,2157,82,3.7,6
"Garza County, TX",TX,2013,2233,2131,102,4.6,44
"Garza County, TX",TX,2012,2189,2082,107,4.9,-33
"Garza County, TX",TX,2011,2222,2084,138,6.2,76
"Garza County, TX",TX,2010,2146,2019,127,5.9,0
"Gasconade County, MO",MO,2021,7620,7342,278,3.6,36
"Gasconade County, MO",MO,2020,7584,7153,431,5.7,-121
"Gasconade County, MO",MO,2019,7705,7460,245,3.2,-23
"Gasconade County, MO",MO,2018,7728,7507,221,2.9,-49
"Gasconade County, MO",MO,2017,7777,7479,298,3.8,85
"Gasconade County, MO",MO,2016,7692,7361,331,4.3,58
"Gasconade County, MO",MO,2015,7634,7304,330,4.3,44
"Gasconade County, MO",MO,2014,7590,7187,403,5.3,72
"Gasconade County, MO",MO,2013,7518,7038,480,6.4,29
"Gasconade County, MO",MO,2012,7489,6944,545,7.3,-107
"Gasconade County, MO",MO,2011,7596,6911,685,9.0,-122
"Gasconade County, MO",MO,2010,7718,6919,799,10.4,0
"Gaston County, NC",NC,2021,108927,103270,5657,5.2,2154
"Gaston County, NC",NC,2020,106773,98492,8281,7.8,-2457
"Gaston County, NC",NC,2019,109230,105028,4202,3.8,1692
"Gaston County, NC",NC,2018,107538,103251,4287,4.0,1271
"Gaston County, NC",NC,2017,106267,101356,4911,4.6,943
"Gaston County, NC",NC,2016,105324,99700,5624,5.3,2652
"Gaston County, NC",NC,2015,102672,96576,6096,5.9,1866
"Gaston County, NC",NC,2014,100806,94143,6663,6.6,-145
"Gaston County, NC",NC,2013,100951,92165,8786,8.7,-946
"Gaston County, NC",NC,2012,101897,90989,10908,10.7,889
"Gaston County, NC",NC,2011,101008,89038,11970,11.9,-577
"Gaston County, NC",NC,2010,101585,87999,13586,13.4,0
"Gates County, NC",NC,2021,4963,4749,214,4.3,82
"Gates County, NC",NC,2020,4881,4610,271,5.6,-375
"Gates County, NC",NC,2019,5256,5048,208,4.0,13
"Gates County, NC",NC,2018,5243,5030,213,4.1,38
"Gates County, NC",NC,2017,5205,4975,230,4.4,30
"Gates County, NC",NC,2016,5175,4909,266,5.1,36
"Gates County, NC",NC,2015,5139,4860,279,5.4,-59
"Gates County, NC",NC,2014,5198,4898,300,5.8,-68
"Gates County, NC",NC,2013,5266,4910,356,6.8,-134
"Gates County, NC",NC,2012,5400,4976,424,7.9,-55
"Gates County, NC",NC,2011,5455,5008,447,8.2,-26
"Gates County, NC",NC,2010,5481,5049,432,7.9,0
"Geary County, KS",KS,2021,11402,10916,486,4.3,-230
"Geary County, KS",KS,2020,11632,10841,791,6.8,271
"Geary County, KS",KS,2019,11361,10877,484,4.3,-112
"Geary County, KS",KS,2018,11473,10945,528,4.6,-75
"Geary County, KS",KS,2017,11548,10980,568,4.9,-564
"Geary County, KS",KS,2016,12112,11431,681,5.6,-30
"Geary County, KS",KS,2015,12142,11391,751,6.2,-207
"Geary County, KS",KS,2014,12349,11454,895,7.2,-345
"Geary County, KS",KS,2013,12694,11593,1101,8.7,-161
"Geary County, KS",KS,2012,12855,11743,1112,8.7,-376
"Geary County, KS",KS,2011,13231,12034,1197,9.0,-120
"Geary County, KS",KS,2010,13351,12146,1205,9.0,0
"Geauga County, OH",OH,2021,47402,45445,1957,4.1,741
"Geauga County, OH",OH,2020,46661,43470,3191,6.8,-3682
"Geauga County, OH",OH,2019,50343,48538,1805,3.6,463
"Geauga County, OH",OH,2018,49880,47866,2014,4.0,106
"Geauga County, OH",OH,2017,49774,47430,2344,4.7,725
"Geauga County, OH",OH,2016,49049,46852,2197,4.5,348
"Geauga County, OH",OH,2015,48701,46652,2049,4.2,-316
"Geauga County, OH",OH,2014,49017,46545,2472,5.0,83
"Geauga County, OH",OH,2013,48934,46113,2821,5.8,-109
"Geauga County, OH",OH,2012,49043,46410,2633,5.4,-326
"Geauga County, OH",OH,2011,49369,46384,2985,6.0,-401
"Geauga County, OH",OH,2010,49770,46323,3447,6.9,0
"Gem County, ID",ID,2021,8739,8380,359,4.1,220
"Gem County, ID",ID,2020,8519,8010,509,6.0,122
"Gem County, ID",ID,2019,8397,8115,282,3.4,294
"Gem County, ID",ID,2018,8103,7818,285,3.5,181
"Gem County, ID",ID,2017,7922,7605,317,4.0,199
"Gem County, ID",ID,2016,7723,7373,350,4.5,191
"Gem County, ID",ID,2015,7532,7164,368,4.9,57
"Gem County, ID",ID,2014,7475,7074,401,5.4,-106
"Gem County, ID",ID,2013,7581,6921,660,8.7,-69
"Gem County, ID",ID,2012,7650,6910,740,9.7,-49
"Gem County, ID",ID,2011,7699,6877,822,10.7,3
"Gem County, ID",ID,2010,7696,6827,869,11.3,0
"Genesee County, MI",MI,2021,174492,161241,13251,7.6,-4989
"Genesee County, MI",MI,2020,179481,158667,20814,11.6,-1968
"Genesee County, MI",MI,2019,181449,172270,9179,5.1,614
"Genesee County, MI",MI,2018,180835,171833,9002,5.0,272
"Genesee County, MI",MI,2017,180563,170419,10144,5.6,-23
"Genesee County, MI",MI,2016,180586,170150,10436,5.8,457
"Genesee County, MI",MI,2015,180129,168867,11262,6.3,-1810
"Genesee County, MI",MI,2014,181939,167392,14547,8.0,-106
"Genesee County, MI",MI,2013,182045,164277,17768,9.8,2420
"Genesee County, MI",MI,2012,179625,161660,17965,10.0,-648
"Genesee County, MI",MI,2011,180273,160278,19995,11.1,-4270
"Genesee County, MI",MI,2010,184543,159283,25260,13.7,0
"Genesee County, NY",NY,2021,29268,28024,1244,4.3,-246
"Genesee County, NY",NY,2020,29514,27427,2087,7.1,-901
"Genesee County, NY",NY,2019,30415,29270,1145,3.8,47
"Genesee County, NY",NY,2018,30368,29111,1257,4.1,290
"Genesee County, NY",NY,2017,30078,28650,1428,4.7,334
"Genesee County, NY",NY,2016,29744,28357,1387,4.7,-305
"Genesee County, NY",NY,2015,30049,28549,1500,5.0,63
"Genesee County, NY",NY,2014,29986,28310,1676,5.6,-514
"Genesee County, NY",NY,2013,30500,28357,2143,7.0,-341
"Genesee County, NY",NY,2012,30841,28365,2476,8.0,-133
"Genesee County, NY",NY,2011,30974,28539,2435,7.9,-788
"Genesee County, NY",NY,2010,31762,29163,2599,8.2,0
"Geneva County, AL",AL,2021,10993,10684,309,2.8,-36
"Geneva County, AL",AL,2020,11029,10520,509,4.6,-71
"Geneva County, AL",AL,2019,11100,10755,345,3.1,109
"Geneva County, AL",AL,2018,10991,10559,432,3.9,83
"Geneva County, AL",AL,2017,10908,10423,485,4.4,188
"Geneva County, AL",AL,2016,10720,10097,623,5.8,-41
"Geneva County, AL",AL,2015,10761,10120,641,6.0,-52
"Geneva County, AL",AL,2014,10813,10093,720,6.7,-222
"Geneva County, AL",AL,2013,11035,10255,780,7.1,-248
"Geneva County, AL",AL,2012,11283,10408,875,7.8,-202
"Geneva County, AL",AL,2011,11485,10434,1051,9.2,-79
"Geneva County, AL",AL,2010,11564,10385,1179,10.2,0
"Gentry County, MO",MO,2021,3334,3245,89,2.7,-58
"Gentry County, MO",MO,2020,3392,3278,114,3.4,-87
"Gentry County, MO",MO,2019,3479,3391,88,2.5,-89
"Gentry County, MO",MO,2018,3568,3484,84,2.4,-48
"Gentry County, MO",MO,2017,3616,3514,102,2.8,32
"Gentry County, MO",MO,2016,3584,3451,133,3.7,-8
"Gentry County, MO",MO,2015,3592,3438,154,4.3,-29
"Gentry County, MO",MO,2014,3621,3416,205,5.7,34
"Gentry County, MO",MO,2013,3587,3397,190,5.3,20
"Gentry County, MO",MO,2012,3567,3371,196,5.5,-1
"Gentry County, MO",MO,2011,3568,3315,253,7.1,59
"Gentry County, MO",MO,2010,3509,3234,275,7.8,0
"George County, MS",MS,2021,8749,8136,613,7.0,-103
"George County, MS",MS,2020,8852,8063,789,8.9,-81
"George County, MS",MS,2019,8933,8271,662,7.4,154
"George County, MS",MS,2018,8779,8192,587,6.7,-40
"George County, MS",MS,2017,8819,8171,648,7.3,42
"George County, MS",MS,2016,8777,8113,664,7.6,-54
"George County, MS",MS,2015,8831,8160,671,7.6,-60
"George County, MS",MS,2014,8891,8150,741,8.3,323
"George County, MS",MS,2013,8568,7764,804,9.4,-345
"George County, MS",MS,2012,8913,8018,895,10.0,-158
"George County, MS",MS,2011,9071,7993,1078,11.9,296
"George County, MS",MS,2010,8775,7793,982,11.2,0
"Georgetown County, SC",SC,2021,25930,24692,1238,4.8,422
"Georgetown County, SC",SC,2020,25508,23643,1865,7.3,329
"Georgetown County, SC",SC,2019,25179,24250,929,3.7,389
"Georgetown County, SC",SC,2018,24790,23671,1119,4.5,428
"Georgetown County, SC",SC,2017,24362,23022,1340,5.5,-520
"Georgetown County, SC",SC,2016,24882,23225,1657,6.7,-330
"Georgetown County, SC",SC,2015,25212,23112,2100,8.3,395
"Georgetown County, SC",SC,2014,24817,22748,2069,8.3,385
"Georgetown County, SC",SC,2013,24432,22013,2419,9.9,-264
"Georgetown County, SC",SC,2012,24696,21799,2897,11.7,-938
"Georgetown County, SC",SC,2011,25634,22194,3440,13.4,-655
"Georgetown County, SC",SC,2010,26289,22427,3862,14.7,0
"Gibson County, IN",IN,2021,19133,18653,480,2.5,-444
"Gibson County, IN",IN,2020,19577,18352,1225,6.3,-52
"Gibson County, IN",IN,2019,19629,19140,489,2.5,174
"Gibson County, IN",IN,2018,19455,18943,512,2.6,344
"Gibson County, IN",IN,2017,19111,18553,558,2.9,-108
"Gibson County, IN",IN,2016,19219,18532,687,3.6,360
"Gibson County, IN",IN,2015,18859,18147,712,3.8,419
"Gibson County, IN",IN,2014,18440,17615,825,4.5,390
"Gibson County, IN",IN,2013,18050,17013,1037,5.7,635
"Gibson County, IN",IN,2012,17415,16240,1175,6.7,89
"Gibson County, IN",IN,2011,17326,16084,1242,7.2,415
"Gibson County, IN",IN,2010,16911,15593,1318,7.8,0
"Gibson County, TN",TN,2021,21522,20600,922,4.3,-278
"Gibson County, TN",TN,2020,21800,20334,1466,6.7,-281
"Gibson County, TN",TN,2019,22081,21143,938,4.2,197
"Gibson County, TN",TN,2018,21884,20931,953,4.4,587
"Gibson County, TN",TN,2017,21297,20321,976,4.6,47
"Gibson County, TN",TN,2016,21250,20001,1249,5.9,181
"Gibson County, TN",TN,2015,21069,19528,1541,7.3,-203
"Gibson County, TN",TN,2014,21272,19367,1905,9.0,-869
"Gibson County, TN",TN,2013,22141,19710,2431,11.0,-724
"Gibson County, TN",TN,2012,22865,20473,2392,10.5,-937
"Gibson County, TN",TN,2011,23802,21044,2758,11.6,29
"Gibson County, TN",TN,2010,23773,20868,2905,12.2,0
"Gila County, AZ",AZ,2021,20390,19377,1013,5.0,35
"Gila County, AZ",AZ,2020,20355,18830,1525,7.5,-410
"Gila County, AZ",AZ,2019,20765,19586,1179,5.7,-3
"Gila County, AZ",AZ,2018,20768,19565,1203,5.8,-21
"Gila County, AZ",AZ,2017,20789,19515,1274,6.1,-295
"Gila County, AZ",AZ,2016,21084,19536,1548,7.3,-237
"Gila County, AZ",AZ,2015,21321,19633,1688,7.9,-223
"Gila County, AZ",AZ,2014,21544,19750,1794,8.3,396
"Gila County, AZ",AZ,2013,21148,19098,2050,9.7,48
"Gila County, AZ",AZ,2012,21100,18943,2157,10.2,-174
"Gila County, AZ",AZ,2011,21274,18830,2444,11.5,-390
"Gila County, AZ",AZ,2010,21664,18969,2695,12.4,0
"Gilchrist County, FL",FL,2021,7226,6956,270,3.7,191
"Gilchrist County, FL",FL,2020,7035,6661,374,5.3,-205
"Gilchrist County, FL",FL,2019,7240,6989,251,3.5,266
"Gilchrist County, FL",FL,2018,6974,6704,270,3.9,206
"Gilchrist County, FL",FL,2017,6768,6463,305,4.5,70
"Gilchrist County, FL",FL,2016,6698,6360,338,5.0,174
"Gilchrist County, FL",FL,2015,6524,6151,373,5.7,-24
"Gilchrist County, FL",FL,2014,6548,6094,454,6.9,-60
"Gilchrist County, FL",FL,2013,6608,6066,542,8.2,-67
"Gilchrist County, FL",FL,2012,6675,6051,624,9.3,-142
"Gilchrist County, FL",FL,2011,6817,6116,701,10.3,3
"Gilchrist County, FL",FL,2010,6814,6102,712,10.4,0
"Giles County, TN",TN,2021,14638,14005,633,4.3,-2
"Giles County, TN",TN,2020,14640,13427,1213,8.3,-443
"Giles County, TN",TN,2019,15083,14504,579,3.8,-230
"Giles County, TN",TN,2018,15313,14755,558,3.6,-243
"Giles County, TN",TN,2017,15556,15026,530,3.4,274
"Giles County, TN",TN,2016,15282,14665,617,4.0,700
"Giles County, TN",TN,2015,14582,13861,721,4.9,321
"Giles County, TN",TN,2014,14261,13387,874,6.1,154
"Giles County, TN",TN,2013,14107,12960,1147,8.1,87
"Giles County, TN",TN,2012,14020,12819,1201,8.6,-260
"Giles County, TN",TN,2011,14280,12834,1446,10.1,18
"Giles County, TN",TN,2010,14262,12512,1750,12.3,0
"Giles County, VA",VA,2021,7747,7479,268,3.5,-41
"Giles County, VA",VA,2020,7788,7304,484,6.2,-225
"Giles County, VA",VA,2019,8013,7755,258,3.2,100
"Giles County, VA",VA,2018,7913,7651,262,3.3,-29
"Giles County, VA",VA,2017,7942,7574,368,4.6,-8
"Giles County, VA",VA,2016,7950,7530,420,5.3,-24
"Giles County, VA",VA,2015,7974,7567,407,5.1,-118
"Giles County, VA",VA,2014,8092,7601,491,6.1,-125
"Giles County, VA",VA,2013,8217,7656,561,6.8,-10
"Giles County, VA",VA,2012,8227,7641,586,7.1,-32
"Giles County, VA",VA,2011,8259,7603,656,7.9,-58
"Giles County, VA",VA,2010,8317,7504,813,9.8,0
"Gillespie County, TX",TX,2021,13939,13478,461,3.3,787
"Gillespie County, TX",TX,2020,13152,12527,625,4.8,-244
"Gillespie County, TX",TX,2019,13396,13069,327,2.4,147
"Gillespie County, TX",TX,2018,13249,12910,339,2.6,213
"Gillespie County, TX",TX,2017,13036,12695,341,2.6,35
"Gillespie County, TX",TX,2016,13001,12631,370,2.8,354
"Gillespie County, TX",TX,2015,12647,12280,367,2.9,148
"Gillespie County, TX",TX,2014,12499,12053,446,3.6,100
"Gillespie County, TX",TX,2013,12399,11849,550,4.4,97
"Gillespie County, TX",TX,2012,12302,11728,574,4.7,-129
"Gillespie County, TX",TX,2011,12431,11748,683,5.5,217
"Gillespie County, TX",TX,2010,12214,11544,670,5.5,0
"Gilliam County, OR",OR,2021,940,895,45,4.8,-52
"Gilliam County, OR",OR,2020,992,930,62,6.3,50
"Gilliam County, OR",OR,2019,942,908,34,3.6,91
"Gilliam County, OR",OR,2018,851,819,32,3.8,1
"Gilliam County, OR",OR,2017,850,814,36,4.2,14
"Gilliam County, OR",OR,2016,836,787,49,5.9,26
"Gilliam County, OR",OR,2015,810,759,51,6.3,-19
"Gilliam County, OR",OR,2014,829,764,65,7.8,-27
"Gilliam County, OR",OR,2013,856,775,81,9.5,-86
"Gilliam County, OR",OR,2012,942,847,95,10.1,-32
"Gilliam County, OR",OR,2011,974,879,95,9.8,11
"Gilliam County, OR",OR,2010,963,875,88,9.1,0
"Gilmer County, GA",GA,2021,12343,11969,374,3.0,324
"Gilmer County, GA",GA,2020,12019,11460,559,4.7,-24
"Gilmer County, GA",GA,2019,12043,11602,441,3.7,20
"Gilmer County, GA",GA,2018,12023,11511,512,4.3,-102
"Gilmer County, GA",GA,2017,12125,11509,616,5.1,292
"Gilmer County, GA",GA,2016,11833,11152,681,5.8,244
"Gilmer County, GA",GA,2015,11589,10877,712,6.1,-357
"Gilmer County, GA",GA,2014,11946,11075,871,7.3,55
"Gilmer County, GA",GA,2013,11891,10829,1062,8.9,-221
"Gilmer County, GA",GA,2012,12112,10852,1260,10.4,-231
"Gilmer County, GA",GA,2011,12343,10905,1438,11.7,-505
"Gilmer County, GA",GA,2010,12848,11380,1468,11.4,0
"Gilmer County, WV",WV,2021,2321,2160,161,6.9,27
"Gilmer County, WV",WV,2020,2294,2066,228,9.9,-81
"Gilmer County, WV",WV,2019,2375,2214,161,6.8,-13
"Gilmer County, WV",WV,2018,2388,2239,149,6.2,-30
"Gilmer County, WV",WV,2017,2418,2245,173,7.2,-129
"Gilmer County, WV",WV,2016,2547,2337,210,8.2,-190
"Gilmer County, WV",WV,2015,2737,2528,209,7.6,-31
"Gilmer County, WV",WV,2014,2768,2591,177,6.4,14
"Gilmer County, WV",WV,2013,2754,2573,181,6.6,-17
"Gilmer County, WV",WV,2012,2771,2563,208,7.5,-43
"Gilmer County, WV",WV,2011,2814,2591,223,7.9,42
"Gilmer County, WV",WV,2010,2772,2525,247,8.9,0
"Gilpin County, CO",CO,2021,3880,3641,239,6.2,-50
"Gilpin County, CO",CO,2020,3930,3501,429,10.9,136
"Gilpin County, CO",CO,2019,3794,3712,82,2.2,107
"Gilpin County, CO",CO,2018,3687,3601,86,2.3,115
"Gilpin County, CO",CO,2017,3572,3505,67,1.9,87
"Gilpin County, CO",CO,2016,3485,3406,79,2.3,86
"Gilpin County, CO",CO,2015,3399,3297,102,3.0,-49
"Gilpin County, CO",CO,2014,3448,3298,150,4.4,135
"Gilpin County, CO",CO,2013,3313,3118,195,5.9,56
"Gilpin County, CO",CO,2012,3257,3037,220,6.8,-5
"Gilpin County, CO",CO,2011,3262,3017,245,7.5,-54
"Gilpin County, CO",CO,2010,3316,3036,280,8.4,0
"Glacier County, MT",MT,2021,5528,5139,389,7.0,20
"Glacier County, MT",MT,2020,5508,4983,525,9.5,-288
"Glacier County, MT",MT,2019,5796,5352,444,7.7,37
"Glacier County, MT",MT,2018,5759,5308,451,7.8,-6
"Glacier County, MT",MT,2017,5765,5301,464,8.0,-61
"Glacier County, MT",MT,2016,5826,5310,516,8.9,-37
"Glacier County, MT",MT,2015,5863,5323,540,9.2,-94
"Glacier County, MT",MT,2014,5957,5329,628,10.5,-385
"Glacier County, MT",MT,2013,6342,5709,633,10.0,2
"Glacier County, MT",MT,2012,6340,5730,610,9.6,290
"Glacier County, MT",MT,2011,6050,5388,662,10.9,-214
"Glacier County, MT",MT,2010,6264,5658,606,9.7,0
"Glades County, FL",FL,2021,5073,4862,211,4.2,3
"Glades County, FL",FL,2020,5070,4755,315,6.2,-233
"Glades County, FL",FL,2019,5303,5088,215,4.1,116
"Glades County, FL",FL,2018,5187,4976,211,4.1,274
"Glades County, FL",FL,2017,4913,4646,267,5.4,179
"Glades County, FL",FL,2016,4734,4436,298,6.3,5
"Glades County, FL",FL,2015,4729,4388,341,7.2,-186
"Glades County, FL",FL,2014,4915,4527,388,7.9,-540
"Glades County, FL",FL,2013,5455,5032,423,7.8,-208
"Glades County, FL",FL,2012,5663,5213,450,7.9,402
"Glades County, FL",FL,2011,5261,4761,500,9.5,-237
"Glades County, FL",FL,2010,5498,4993,505,9.2,0
"Gladwin County, MI",MI,2021,9595,8918,677,7.1,-232
"Gladwin County, MI",MI,2020,9827,8827,1000,10.2,-91
"Gladwin County, MI",MI,2019,9918,9341,577,5.8,-2
"Gladwin County, MI",MI,2018,9920,9357,563,5.7,33
"Gladwin County, MI",MI,2017,9887,9253,634,6.4,-28
"Gladwin County, MI",MI,2016,9915,9216,699,7.0,-114
"Gladwin County, MI",MI,2015,10029,9290,739,7.4,-30
"Gladwin County, MI",MI,2014,10059,9124,935,9.3,11
"Gladwin County, MI",MI,2013,10048,8885,1163,11.6,86
"Gladwin County, MI",MI,2012,9962,8797,1165,11.7,-118
"Gladwin County, MI",MI,2011,10080,8819,1261,12.5,-224
"Gladwin County, MI",MI,2010,10304,8820,1484,14.4,0
"Glascock County, GA",GA,2021,1263,1230,33,2.6,17
"Glascock County, GA",GA,2020,1246,1196,50,4.0,-32
"Glascock County, GA",GA,2019,1278,1229,49,3.8,-13
"Glascock County, GA",GA,2018,1291,1237,54,4.2,-21
"Glascock County, GA",GA,2017,1312,1246,66,5.0,44
"Glascock County, GA",GA,2016,1268,1191,77,6.1,49
"Glascock County, GA",GA,2015,1219,1137,82,6.7,-45
"Glascock County, GA",GA,2014,1264,1162,102,8.1,-24
"Glascock County, GA",GA,2013,1288,1167,121,9.4,-30
"Glascock County, GA",GA,2012,1318,1192,126,9.6,-15
"Glascock County, GA",GA,2011,1333,1192,141,10.6,5
"Glascock County, GA",GA,2010,1328,1179,149,11.2,0
"Glasscock County, TX",TX,2021,815,791,24,2.9,17
"Glasscock County, TX",TX,2020,798,769,29,3.6,9
"Glasscock County, TX",TX,2019,789,772,17,2.2,-55
"Glasscock County, TX",TX,2018,844,826,18,2.1,140
"Glasscock County, TX",TX,2017,704,685,19,2.7,-45
"Glasscock County, TX",TX,2016,749,720,29,3.9,-73
"Glasscock County, TX",TX,2015,822,799,23,2.8,-6
"Glasscock County, TX",TX,2014,828,806,22,2.7,86
"Glasscock County, TX",TX,2013,742,715,27,3.6,-19
"Glasscock County, TX",TX,2012,761,731,30,3.9,15
"Glasscock County, TX",TX,2011,746,713,33,4.4,41
"Glasscock County, TX",TX,2010,705,670,35,5.0,0
"Glenn County, CA",CA,2021,12616,11740,876,6.9,-121
"Glenn County, CA",CA,2020,12737,11581,1156,9.1,-269
"Glenn County, CA",CA,2019,13006,12196,810,6.2,238
"Glenn County, CA",CA,2018,12768,11923,845,6.6,-35
"Glenn County, CA",CA,2017,12803,11840,963,7.5,-146
"Glenn County, CA",CA,2016,12949,11867,1082,8.4,-15
"Glenn County, CA",CA,2015,12964,11827,1137,8.8,181
"Glenn County, CA",CA,2014,12783,11405,1378,10.8,-167
"Glenn County, CA",CA,2013,12950,11364,1586,12.2,-179
"Glenn County, CA",CA,2012,13129,11237,1892,14.4,-28
"Glenn County, CA",CA,2011,13157,11080,2077,15.8,-85
"Glenn County, CA",CA,2010,13242,11151,2091,15.8,0
"Gloucester County, NJ",NJ,2021,158303,148799,9504,6.0,1380
"Gloucester County, NJ",NJ,2020,156923,142899,14024,8.9,544
"Gloucester County, NJ",NJ,2019,156379,150907,5472,3.5,2906
"Gloucester County, NJ",NJ,2018,153473,147232,6241,4.1,-541
"Gloucester County, NJ",NJ,2017,154014,146898,7116,4.6,4956
"Gloucester County, NJ",NJ,2016,149058,141551,7507,5.0,1072
"Gloucester County, NJ",NJ,2015,147986,139106,8880,6.0,732
"Gloucester County, NJ",NJ,2014,147254,136496,10758,7.3,-2022
"Gloucester County, NJ",NJ,2013,149276,135537,13739,9.2,-1985
"Gloucester County, NJ",NJ,2012,151261,135879,15382,10.2,-410
"Gloucester County, NJ",NJ,2011,151671,136216,15455,10.2,-808
"Gloucester County, NJ",NJ,2010,152479,136584,15895,10.4,0
"Gloucester County, VA",VA,2021,18837,18202,635,3.4,-465
"Gloucester County, VA",VA,2020,19302,18257,1045,5.4,-592
"Gloucester County, VA",VA,2019,19894,19389,505,2.5,216
"Gloucester County, VA",VA,2018,19678,19153,525,2.7,139
"Gloucester County, VA",VA,2017,19539,18899,640,3.3,421
"Gloucester County, VA",VA,2016,19118,18430,688,3.6,-51
"Gloucester County, VA",VA,2015,19169,18399,770,4.0,-335
"Gloucester County, VA",VA,2014,19504,18581,923,4.7,177
"Gloucester County, VA",VA,2013,19327,18344,983,5.1,-21
"Gloucester County, VA",VA,2012,19348,18278,1070,5.5,-173
"Gloucester County, VA",VA,2011,19521,18298,1223,6.3,-57
"Gloucester County, VA",VA,2010,19578,18210,1368,7.0,0
"Glynn County, GA",GA,2021,39201,37727,1474,3.8,906
"Glynn County, GA",GA,2020,38295,35722,2573,6.7,-567
"Glynn County, GA",GA,2019,38862,37488,1374,3.5,-1195
"Glynn County, GA",GA,2018,40057,38556,1501,3.7,-139
"Glynn County, GA",GA,2017,40196,38282,1914,4.8,1019
"Glynn County, GA",GA,2016,39177,37071,2106,5.4,1913
"Glynn County, GA",GA,2015,37264,34962,2302,6.2,236
"Glynn County, GA",GA,2014,37028,34255,2773,7.5,-982
"Glynn County, GA",GA,2013,38010,34797,3213,8.5,-646
"Glynn County, GA",GA,2012,38656,35044,3612,9.3,477
"Glynn County, GA",GA,2011,38179,34231,3948,10.3,-271
"Glynn County, GA",GA,2010,38450,34551,3899,10.1,0
"Gogebic County, MI",MI,2021,5582,5273,309,5.5,-230
"Gogebic County, MI",MI,2020,5812,5341,471,8.1,-196
"Gogebic County, MI",MI,2019,6008,5698,310,5.2,-195
"Gogebic County, MI",MI,2018,6203,5886,317,5.1,-111
"Gogebic County, MI",MI,2017,6314,5943,371,5.9,-40
"Gogebic County, MI",MI,2016,6354,5961,393,6.2,-174
"Gogebic County, MI",MI,2015,6528,6044,484,7.4,-182
"Gogebic County, MI",MI,2014,6710,6113,597,8.9,-23
"Gogebic County, MI",MI,2013,6733,6010,723,10.7,-78
"Gogebic County, MI",MI,2012,6811,6064,747,11.0,-115
"Gogebic County, MI",MI,2011,6926,6136,790,11.4,-228
"Gogebic County, MI",MI,2010,7154,6245,909,12.7,0
"Golden Valley County, MT",MT,2021,369,356,13,3.5,4
"Golden Valley County, MT",MT,2020,365,348,17,4.7,-3
"Golden Valley County, MT",MT,2019,368,353,15,4.1,-4
"Golden Valley County, MT",MT,2018,372,355,17,4.6,-4
"Golden Valley County, MT",MT,2017,376,357,19,5.1,-2
"Golden Valley County, MT",MT,2016,378,361,17,4.5,-2
"Golden Valley County, MT",MT,2015,380,364,16,4.2,-12
"Golden Valley County, MT",MT,2014,392,374,18,4.6,-5
"Golden Valley County, MT",MT,2013,397,377,20,5.0,6
"Golden Valley County, MT",MT,2012,391,373,18,4.6,0
"Golden Valley County, MT",MT,2011,391,372,19,4.9,-28
"Golden Valley County, MT",MT,2010,419,391,28,6.7,0
"Golden Valley County, ND",ND,2021,838,815,23,2.7,-27
"Golden Valley County, ND",ND,2020,865,838,27,3.1,12
"Golden Valley County, ND",ND,2019,853,839,14,1.6,-48
"Golden Valley County, ND",ND,2018,901,885,16,1.8,-44
"Golden Valley County, ND",ND,2017,945,926,19,2.0,-24
"Golden Valley County, ND",ND,2016,969,943,26,2.7,-1
"Golden Valley County, ND",ND,2015,970,948,22,2.3,5
"Golden Valley County, ND",ND,2014,965,945,20,2.1,4
"Golden Valley County, ND",ND,2013,961,940,21,2.2,-15
"Golden Valley County, ND",ND,2012,976,953,23,2.4,-3
"Golden Valley County, ND",ND,2011,979,955,24,2.5,-5
"Golden Valley County, ND",ND,2010,984,958,26,2.6,0
"Goliad County, TX",TX,2021,3153,2946,207,6.6,46
"Goliad County, TX",TX,2020,3107,2865,242,7.8,-123
"Goliad County, TX",TX,2019,3230,3121,109,3.4,-21
"Goliad County, TX",TX,2018,3251,3126,125,3.8,-1
"Goliad County, TX",TX,2017,3252,3091,161,5.0,-68
"Goliad County, TX",TX,2016,3320,3127,193,5.8,-129
"Goliad County, TX",TX,2015,3449,3295,154,4.5,-117
"Goliad County, TX",TX,2014,3566,3418,148,4.2,36
"Goliad County, TX",TX,2013,3530,3345,185,5.2,58
"Goliad County, TX",TX,2012,3472,3282,190,5.5,98
"Goliad County, TX",TX,2011,3374,3148,226,6.7,13
"Goliad County, TX",TX,2010,3361,3111,250,7.4,0
"Gonzales County, TX",TX,2021,9594,9184,410,4.3,152
"Gonzales County, TX",TX,2020,9442,8931,511,5.4,-39
"Gonzales County, TX",TX,2019,9481,9225,256,2.7,88
"Gonzales County, TX",TX,2018,9393,9106,287,3.1,90
"Gonzales County, TX",TX,2017,9303,8976,327,3.5,-271
"Gonzales County, TX",TX,2016,9574,9168,406,4.2,-129
"Gonzales County, TX",TX,2015,9703,9344,359,3.7,-219
"Gonzales County, TX",TX,2014,9922,9534,388,3.9,425
"Gonzales County, TX",TX,2013,9497,9007,490,5.2,62
"Gonzales County, TX",TX,2012,9435,8959,476,5.0,-30
"Gonzales County, TX",TX,2011,9465,8864,601,6.3,149
"Gonzales County, TX",TX,2010,9316,8678,638,6.8,0
"Goochland County, VA",VA,2021,11232,10887,345,3.1,-194
"Goochland County, VA",VA,2020,11426,10880,546,4.8,-155
"Goochland County, VA",VA,2019,11581,11266,315,2.7,345
"Goochland County, VA",VA,2018,11236,10905,331,2.9,309
"Goochland County, VA",VA,2017,10927,10548,379,3.5,82
"Goochland County, VA",VA,2016,10845,10443,402,3.7,186
"Goochland County, VA",VA,2015,10659,10220,439,4.1,82
"Goochland County, VA",VA,2014,10577,10080,497,4.7,201
"Goochland County, VA",VA,2013,10376,9854,522,5.0,109
"Goochland County, VA",VA,2012,10267,9705,562,5.5,-93
"Goochland County, VA",VA,2011,10360,9703,657,6.3,-139
"Goochland County, VA",VA,2010,10499,9728,771,7.3,0
"Goodhue County, MN",MN,2021,26010,25176,834,3.2,-879
"Goodhue County, MN",MN,2020,26889,25281,1608,6.0,-405
"Goodhue County, MN",MN,2019,27294,26406,888,3.3,394
"Goodhue County, MN",MN,2018,26900,26107,793,2.9,-70
"Goodhue County, MN",MN,2017,26970,26092,878,3.3,140
"Goodhue County, MN",MN,2016,26830,25833,997,3.7,-112
"Goodhue County, MN",MN,2015,26942,25974,968,3.6,154
"Goodhue County, MN",MN,2014,26788,25707,1081,4.0,-61
"Goodhue County, MN",MN,2013,26849,25571,1278,4.8,109
"Goodhue County, MN",MN,2012,26740,25351,1389,5.2,-248
"Goodhue County, MN",MN,2011,26988,25365,1623,6.0,237
"Goodhue County, MN",MN,2010,26751,24866,1885,7.0,0
"Gooding County, ID",ID,2021,8381,8117,264,3.1,81
"Gooding County, ID",ID,2020,8300,7977,323,3.9,14
"Gooding County, ID",ID,2019,8286,8066,220,2.7,141
"Gooding County, ID",ID,2018,8145,7947,198,2.4,68
"Gooding County, ID",ID,2017,8077,7877,200,2.5,80
"Gooding County, ID",ID,2016,7997,7759,238,3.0,9
"Gooding County, ID",ID,2015,7988,7731,257,3.2,28
"Gooding County, ID",ID,2014,7960,7672,288,3.6,-131
"Gooding County, ID",ID,2013,8091,7647,444,5.5,-28
"Gooding County, ID",ID,2012,8119,7645,474,5.8,-226
"Gooding County, ID",ID,2011,8345,7793,552,6.6,-161
"Gooding County, ID",ID,2010,8506,7890,616,7.2,0
"Gordon County, GA",GA,2021,28846,27923,923,3.2,750
"Gordon County, GA",GA,2020,28096,26579,1517,5.4,-417
"Gordon County, GA",GA,2019,28513,27505,1008,3.5,931
"Gordon County, GA",GA,2018,27582,26503,1079,3.9,653
"Gordon County, GA",GA,2017,26929,25675,1254,4.7,1629
"Gordon County, GA",GA,2016,25300,23865,1435,5.7,-556
"Gordon County, GA",GA,2015,25856,24302,1554,6.0,-179
"Gordon County, GA",GA,2014,26035,24131,1904,7.3,-125
"Gordon County, GA",GA,2013,26160,23859,2301,8.8,-588
"Gordon County, GA",GA,2012,26748,24167,2581,9.6,541
"Gordon County, GA",GA,2011,26207,23174,3033,11.6,62
"Gordon County, GA",GA,2010,26145,22777,3368,12.9,0
"Goshen County, WY",WY,2021,6531,6304,227,3.5,26
"Goshen County, WY",WY,2020,6505,6225,280,4.3,26
"Goshen County, WY",WY,2019,6479,6232,247,3.8,-382
"Goshen County, WY",WY,2018,6861,6633,228,3.3,-79
"Goshen County, WY",WY,2017,6940,6734,206,3.0,-89
"Goshen County, WY",WY,2016,7029,6784,245,3.5,6
"Goshen County, WY",WY,2015,7023,6795,228,3.2,-34
"Goshen County, WY",WY,2014,7057,6791,266,3.8,-170
"Goshen County, WY",WY,2013,7227,6921,306,4.2,-197
"Goshen County, WY",WY,2012,7424,7066,358,4.8,-116
"Goshen County, WY",WY,2011,7540,7156,384,5.1,84
"Goshen County, WY",WY,2010,7456,7062,394,5.3,0
"Gosper County, NE",NE,2021,1211,1191,20,1.7,98
"Gosper County, NE",NE,2020,1113,1085,28,2.5,1
"Gosper County, NE",NE,2019,1112,1083,29,2.6,43
"Gosper County, NE",NE,2018,1069,1041,28,2.6,14
"Gosper County, NE",NE,2017,1055,1026,29,2.7,-7
"Gosper County, NE",NE,2016,1062,1035,27,2.5,-16
"Gosper County, NE",NE,2015,1078,1052,26,2.4,-59
"Gosper County, NE",NE,2014,1137,1103,34,3.0,-25
"Gosper County, NE",NE,2013,1162,1123,39,3.4,19
"Gosper County, NE",NE,2012,1143,1110,33,2.9,12
"Gosper County, NE",NE,2011,1131,1091,40,3.5,-14
"Gosper County, NE",NE,2010,1145,1103,42,3.7,0
"Gove County, KS",KS,2021,1465,1437,28,1.9,5
"Gove County, KS",KS,2020,1460,1423,37,2.5,-25
"Gove County, KS",KS,2019,1485,1454,31,2.1,60
"Gove County, KS",KS,2018,1425,1395,30,2.1,-6
"Gove County, KS",KS,2017,1431,1398,33,2.3,-27
"Gove County, KS",KS,2016,1458,1423,35,2.4,-32
"Gove County, KS",KS,2015,1490,1453,37,2.5,4
"Gove County, KS",KS,2014,1486,1447,39,2.6,-6
"Gove County, KS",KS,2013,1492,1442,50,3.4,-26
"Gove County, KS",KS,2012,1518,1473,45,3.0,13
"Gove County, KS",KS,2011,1505,1456,49,3.3,0
"Gove County, KS",KS,2010,1505,1455,50,3.3,0
"Grady County, GA",GA,2021,11040,10695,345,3.1,418
"Grady County, GA",GA,2020,10622,10160,462,4.3,-55
"Grady County, GA",GA,2019,10677,10304,373,3.5,2
"Grady County, GA",GA,2018,10675,10259,416,3.9,-177
"Grady County, GA",GA,2017,10852,10319,533,4.9,602
"Grady County, GA",GA,2016,10250,9685,565,5.5,-54
"Grady County, GA",GA,2015,10304,9673,631,6.1,-133
"Grady County, GA",GA,2014,10437,9669,768,7.4,-33
"Grady County, GA",GA,2013,10470,9666,804,7.7,-327
"Grady County, GA",GA,2012,10797,9882,915,8.5,-34
"Grady County, GA",GA,2011,10831,9807,1024,9.5,404
"Grady County, GA",GA,2010,10427,9320,1107,10.6,0
"Grady County, OK",OK,2021,26685,25758,927,3.5,401
"Grady County, OK",OK,2020,26284,24650,1634,6.2,-129
"Grady County, OK",OK,2019,26413,25634,779,2.9,210
"Grady County, OK",OK,2018,26203,25433,770,2.9,235
"Grady County, OK",OK,2017,25968,24972,996,3.8,-91
"Grady County, OK",OK,2016,26059,24810,1249,4.8,-141
"Grady County, OK",OK,2015,26200,25052,1148,4.4,806
"Grady County, OK",OK,2014,25394,24411,983,3.9,-106
"Grady County, OK",OK,2013,25500,24322,1178,4.6,39
"Grady County, OK",OK,2012,25461,24287,1174,4.6,257
"Grady County, OK",OK,2011,25204,23940,1264,5.0,-148
"Grady County, OK",OK,2010,25352,23775,1577,6.2,0
"Grafton County, NH",NH,2021,48491,46882,1609,3.3,626
"Grafton County, NH",NH,2020,47865,45034,2831,5.9,-1917
"Grafton County, NH",NH,2019,49782,48658,1124,2.3,103
"Grafton County, NH",NH,2018,49679,48600,1079,2.2,139
"Grafton County, NH",NH,2017,49540,48412,1128,2.3,727
"Grafton County, NH",NH,2016,48813,47659,1154,2.4,82
"Grafton County, NH",NH,2015,48731,47378,1353,2.8,147
"Grafton County, NH",NH,2014,48584,46898,1686,3.5,116
"Grafton County, NH",NH,2013,48468,46354,2114,4.4,-249
"Grafton County, NH",NH,2012,48717,46569,2148,4.4,-44
"Grafton County, NH",NH,2011,48761,46566,2195,4.5,389
"Grafton County, NH",NH,2010,48372,45941,2431,5.0,0
"Graham County, AZ",AZ,2021,15695,15047,648,4.1,283
"Graham County, AZ",AZ,2020,15412,14464,948,6.2,450
"Graham County, AZ",AZ,2019,14962,14226,736,4.9,558
"Graham County, AZ",AZ,2018,14404,13674,730,5.1,396
"Graham County, AZ",AZ,2017,14008,13235,773,5.5,-425
"Graham County, AZ",AZ,2016,14433,13445,988,6.8,-157
"Graham County, AZ",AZ,2015,14590,13515,1075,7.4,61
"Graham County, AZ",AZ,2014,14529,13447,1082,7.4,88
"Graham County, AZ",AZ,2013,14441,13317,1124,7.8,-153
"Graham County, AZ",AZ,2012,14594,13353,1241,8.5,179
"Graham County, AZ",AZ,2011,14415,12988,1427,9.9,-183
"Graham County, AZ",AZ,2010,14598,12724,1874,12.8,0
"Graham County, KS",KS,2021,1132,1099,33,2.9,-2
"Graham County, KS",KS,2020,1134,1085,49,4.3,15
"Graham County, KS",KS,2019,1119,1085,34,3.0,-27
"Graham County, KS",KS,2018,1146,1111,35,3.1,27
"Graham County, KS",KS,2017,1119,1079,40,3.6,-111
"Graham County, KS",KS,2016,1230,1176,54,4.4,-46
"Graham County, KS",KS,2015,1276,1225,51,4.0,-38
"Graham County, KS",KS,2014,1314,1272,42,3.2,-41
"Graham County, KS",KS,2013,1355,1298,57,4.2,-36
"Graham County, KS",KS,2012,1391,1344,47,3.4,-32
"Graham County, KS",KS,2011,1423,1365,58,4.1,34
"Graham County, KS",KS,2010,1389,1324,65,4.7,0
"Graham County, NC",NC,2021,3022,2814,208,6.9,36
"Graham County, NC",NC,2020,2986,2698,288,9.6,-220
"Graham County, NC",NC,2019,3206,3036,170,5.3,69
"Graham County, NC",NC,2018,3137,2952,185,5.9,53
"Graham County, NC",NC,2017,3084,2874,210,6.8,-8
"Graham County, NC",NC,2016,3092,2819,273,8.8,-89
"Graham County, NC",NC,2015,3181,2804,377,11.9,-130
"Graham County, NC",NC,2014,3311,2881,430,13.0,-206
"Graham County, NC",NC,2013,3517,2993,524,14.9,-98
"Graham County, NC",NC,2012,3615,2962,653,18.1,-23
"Graham County, NC",NC,2011,3638,2981,657,18.1,-75
"Graham County, NC",NC,2010,3713,3067,646,17.4,0
"Grainger County, TN",TN,2021,9603,9198,405,4.2,112
"Grainger County, TN",TN,2020,9491,8818,673,7.1,-89
"Grainger County, TN",TN,2019,9580,9191,389,4.1,192
"Grainger County, TN",TN,2018,9388,9017,371,4.0,59
"Grainger County, TN",TN,2017,9329,8932,397,4.3,37
"Grainger County, TN",TN,2016,9292,8786,506,5.4,129
"Grainger County, TN",TN,2015,9163,8559,604,6.6,-76
"Grainger County, TN",TN,2014,9239,8480,759,8.2,-206
"Grainger County, TN",TN,2013,9445,8503,942,10.0,-233
"Grainger County, TN",TN,2012,9678,8665,1013,10.5,-306
"Grainger County, TN",TN,2011,9984,8802,1182,11.8,-70
"Grainger County, TN",TN,2010,10054,8751,1303,13.0,0
"Grand County, CO",CO,2021,9718,9309,409,4.2,473
"Grand County, CO",CO,2020,9245,8505,740,8.0,-532
"Grand County, CO",CO,2019,9777,9579,198,2.0,-38
"Grand County, CO",CO,2018,9815,9573,242,2.5,352
"Grand County, CO",CO,2017,9463,9265,198,2.1,272
"Grand County, CO",CO,2016,9191,8955,236,2.6,135
"Grand County, CO",CO,2015,9056,8775,281,3.1,129
"Grand County, CO",CO,2014,8927,8570,357,4.0,159
"Grand County, CO",CO,2013,8768,8264,504,5.7,46
"Grand County, CO",CO,2012,8722,8081,641,7.3,-55
"Grand County, CO",CO,2011,8777,8042,735,8.4,-147
"Grand County, CO",CO,2010,8924,8102,822,9.2,0
"Grand County, UT",UT,2021,6574,6285,289,4.4,332
"Grand County, UT",UT,2020,6242,5647,595,9.5,-4
"Grand County, UT",UT,2019,6246,6005,241,3.9,138
"Grand County, UT",UT,2018,6108,5832,276,4.5,151
"Grand County, UT",UT,2017,5957,5650,307,5.2,256
"Grand County, UT",UT,2016,5701,5376,325,5.7,121
"Grand County, UT",UT,2015,5580,5247,333,6.0,110
"Grand County, UT",UT,2014,5470,5138,332,6.1,105
"Grand County, UT",UT,2013,5365,4983,382,7.1,72
"Grand County, UT",UT,2012,5293,4898,395,7.5,9
"Grand County, UT",UT,2011,5284,4749,535,10.1,-20
"Grand County, UT",UT,2010,5304,4737,567,10.7,0
"Grand Forks County, ND",ND,2021,37114,35926,1188,3.2,-182
"Grand Forks County, ND",ND,2020,37296,35591,1705,4.6,-766
"Grand Forks County, ND",ND,2019,38062,37357,705,1.9,-520
"Grand Forks County, ND",ND,2018,38582,37794,788,2.0,-874
"Grand Forks County, ND",ND,2017,39456,38594,862,2.2,723
"Grand Forks County, ND",ND,2016,38733,37818,915,2.4,1517
"Grand Forks County, ND",ND,2015,37216,36307,909,2.4,656
"Grand Forks County, ND",ND,2014,36560,35566,994,2.7,-228
"Grand Forks County, ND",ND,2013,36788,35675,1113,3.0,-292
"Grand Forks County, ND",ND,2012,37080,35877,1203,3.2,-528
"Grand Forks County, ND",ND,2011,37608,36274,1334,3.5,-331
"Grand Forks County, ND",ND,2010,37939,36648,1291,3.4,0
"Grand Isle County, VT",VT,2021,3941,3786,155,3.9,-144
"Grand Isle County, VT",VT,2020,4085,3847,238,5.8,-217
"Grand Isle County, VT",VT,2019,4302,4182,120,2.8,99
"Grand Isle County, VT",VT,2018,4203,4070,133,3.2,29
"Grand Isle County, VT",VT,2017,4174,4029,145,3.5,186
"Grand Isle County, VT",VT,2016,3988,3844,144,3.6,33
"Grand Isle County, VT",VT,2015,3955,3799,156,3.9,-130
"Grand Isle County, VT",VT,2014,4085,3901,184,4.5,34
"Grand Isle County, VT",VT,2013,4051,3869,182,4.5,-70
"Grand Isle County, VT",VT,2012,4121,3904,217,5.3,-41
"Grand Isle County, VT",VT,2011,4162,3894,268,6.4,23
"Grand Isle County, VT",VT,2010,4139,3841,298,7.2,0
"Grand Traverse County, MI",MI,2021,47928,45518,2410,5.0,-1063
"Grand Traverse County, MI",MI,2020,48991,44732,4259,8.7,-798
"Grand Traverse County, MI",MI,2019,49789,48031,1758,3.5,544
"Grand Traverse County, MI",MI,2018,49245,47408,1837,3.7,-88
"Grand Traverse County, MI",MI,2017,49333,47294,2039,4.1,-182
"Grand Traverse County, MI",MI,2016,49515,47371,2144,4.3,833
"Grand Traverse County, MI",MI,2015,48682,46381,2301,4.7,638
"Grand Traverse County, MI",MI,2014,48044,45141,2903,6.0,819
"Grand Traverse County, MI",MI,2013,47225,43658,3567,7.6,681
"Grand Traverse County, MI",MI,2012,46544,42750,3794,8.2,-18
"Grand Traverse County, MI",MI,2011,46562,42181,4381,9.4,-547
"Grand Traverse County, MI",MI,2010,47109,41783,5326,11.3,0
"Granite County, MT",MT,2021,1620,1548,72,4.4,19
"Granite County, MT",MT,2020,1601,1473,128,8.0,-123
"Granite County, MT",MT,2019,1724,1626,98,5.7,16
"Granite County, MT",MT,2018,1708,1617,91,5.3,79
"Granite County, MT",MT,2017,1629,1532,97,6.0,-3
"Granite County, MT",MT,2016,1632,1532,100,6.1,70
"Granite County, MT",MT,2015,1562,1462,100,6.4,35
"Granite County, MT",MT,2014,1527,1423,104,6.8,25
"Granite County, MT",MT,2013,1502,1389,113,7.5,29
"Granite County, MT",MT,2012,1473,1356,117,7.9,17
"Granite County, MT",MT,2011,1456,1329,127,8.7,-3
"Granite County, MT",MT,2010,1459,1326,133,9.1,0
"Grant County, AR",AR,2021,8146,7886,260,3.2,-143
"Grant County, AR",AR,2020,8289,7858,431,5.2,-143
"Grant County, AR",AR,2019,8432,8170,262,3.1,108
"Grant County, AR",AR,2018,8324,8070,254,3.1,1
"Grant County, AR",AR,2017,8323,8053,270,3.2,35
"Grant County, AR",AR,2016,8288,7989,299,3.6,-5
"Grant County, AR",AR,2015,8293,7921,372,4.5,6
"Grant County, AR",AR,2014,8287,7844,443,5.3,-35
"Grant County, AR",AR,2013,8322,7791,531,6.4,-140
"Grant County, AR",AR,2012,8462,7909,553,6.5,-60
"Grant County, AR",AR,2011,8522,7922,600,7.0,-39
"Grant County, AR",AR,2010,8561,7978,583,6.8,0
"Grant County, IN",IN,2021,31094,29939,1155,3.7,-508
"Grant County, IN",IN,2020,31602,29582,2020,6.4,-331
"Grant County, IN",IN,2019,31933,30769,1164,3.6,-269
"Grant County, IN",IN,2018,32202,30982,1220,3.8,355
"Grant County, IN",IN,2017,31847,30623,1224,3.8,-323
"Grant County, IN",IN,2016,32170,30606,1564,4.9,-347
"Grant County, IN",IN,2015,32517,30766,1751,5.4,-154
"Grant County, IN",IN,2014,32671,30437,2234,6.8,163
"Grant County, IN",IN,2013,32508,29625,2883,8.9,151
"Grant County, IN",IN,2012,32357,29253,3104,9.6,-1147
"Grant County, IN",IN,2011,33504,30096,3408,10.2,-52
"Grant County, IN",IN,2010,33556,29763,3793,11.3,0
"Grant County, KS",KS,2021,2963,2873,90,3.0,-134
"Grant County, KS",KS,2020,3097,2976,121,3.9,-124
"Grant County, KS",KS,2019,3221,3131,90,2.8,-137
"Grant County, KS",KS,2018,3358,3267,91,2.7,-127
"Grant County, KS",KS,2017,3485,3374,111,3.2,-307
"Grant County, KS",KS,2016,3792,3656,136,3.6,-121
"Grant County, KS",KS,2015,3913,3773,140,3.6,-30
"Grant County, KS",KS,2014,3943,3809,134,3.4,-57
"Grant County, KS",KS,2013,4000,3856,144,3.6,-3
"Grant County, KS",KS,2012,4003,3847,156,3.9,-121
"Grant County, KS",KS,2011,4124,3954,170,4.1,-79
"Grant County, KS",KS,2010,4203,4024,179,4.3,0
"Grant County, KY",KY,2021,11637,11113,524,4.5,48
"Grant County, KY",KY,2020,11589,10796,793,6.8,-166
"Grant County, KY",KY,2019,11755,11295,460,3.9,61
"Grant County, KY",KY,2018,11694,11205,489,4.2,86
"Grant County, KY",KY,2017,11608,11052,556,4.8,258
"Grant County, KY",KY,2016,11350,10806,544,4.8,265
"Grant County, KY",KY,2015,11085,10503,582,5.3,-123
"Grant County, KY",KY,2014,11208,10477,731,6.5,-298
"Grant County, KY",KY,2013,11506,10559,947,8.2,-2
"Grant County, KY",KY,2012,11508,10462,1046,9.1,-144
"Grant County, KY",KY,2011,11652,10415,1237,10.6,-95
"Grant County, KY",KY,2010,11747,10351,1396,11.9,0
"Grant County, MN",MN,2021,3210,3092,118,3.7,-155
"Grant County, MN",MN,2020,3365,3180,185,5.5,15
"Grant County, MN",MN,2019,3350,3192,158,4.7,35
"Grant County, MN",MN,2018,3315,3174,141,4.3,19
"Grant County, MN",MN,2017,3296,3160,136,4.1,11
"Grant County, MN",MN,2016,3285,3131,154,4.7,-70
"Grant County, MN",MN,2015,3355,3194,161,4.8,66
"Grant County, MN",MN,2014,3289,3122,167,5.1,3
"Grant County, MN",MN,2013,3286,3095,191,5.8,-55
"Grant County, MN",MN,2012,3341,3135,206,6.2,-42
"Grant County, MN",MN,2011,3383,3148,235,6.9,-19
"Grant County, MN",MN,2010,3402,3131,271,8.0,0
"Grant County, ND",ND,2021,1233,1200,33,2.7,31
"Grant County, ND",ND,2020,1202,1169,33,2.7,3
"Grant County, ND",ND,2019,1199,1175,24,2.0,-29
"Grant County, ND",ND,2018,1228,1198,30,2.4,-67
"Grant County, ND",ND,2017,1295,1257,38,2.9,1
"Grant County, ND",ND,2016,1294,1255,39,3.0,-15
"Grant County, ND",ND,2015,1309,1268,41,3.1,27
"Grant County, ND",ND,2014,1282,1247,35,2.7,21
"Grant County, ND",ND,2013,1261,1224,37,2.9,-32
"Grant County, ND",ND,2012,1293,1254,39,3.0,-96
"Grant County, ND",ND,2011,1389,1341,48,3.5,-37
"Grant County, ND",ND,2010,1426,1374,52,3.6,0
"Grant County, NE",NE,2021,428,422,6,1.4,8
"Grant County, NE",NE,2020,420,412,8,1.9,6
"Grant County, NE",NE,2019,414,403,11,2.7,-9
"Grant County, NE",NE,2018,423,412,11,2.6,-20
"Grant County, NE",NE,2017,443,433,10,2.3,-12
"Grant County, NE",NE,2016,455,445,10,2.2,18
"Grant County, NE",NE,2015,437,427,10,2.3,8
"Grant County, NE",NE,2014,429,419,10,2.3,10
"Grant County, NE",NE,2013,419,405,14,3.3,-20
"Grant County, NE",NE,2012,439,424,15,3.4,-15
"Grant County, NE",NE,2011,454,439,15,3.3,34
"Grant County, NE",NE,2010,420,404,16,3.8,0
"Grant County, NM",NM,2021,11457,10626,831,7.3,-327
"Grant County, NM",NM,2020,11784,10764,1020,8.7,-551
"Grant County, NM",NM,2019,12335,11738,597,4.8,-78
"Grant County, NM",NM,2018,12413,11818,595,4.8,34
"Grant County, NM",NM,2017,12379,11635,744,6.0,-180
"Grant County, NM",NM,2016,12559,11740,819,6.5,4
"Grant County, NM",NM,2015,12555,11733,822,6.5,-32
"Grant County, NM",NM,2014,12587,11766,821,6.5,-332
"Grant County, NM",NM,2013,12919,12048,871,6.7,-104
"Grant County, NM",NM,2012,13023,12174,849,6.5,318
"Grant County, NM",NM,2011,12705,11816,889,7.0,458
"Grant County, NM",NM,2010,12247,11110,1137,9.3,0
"Grant County, OK",OK,2021,2724,2655,69,2.5,-36
"Grant County, OK",OK,2020,2760,2667,93,3.4,108
"Grant County, OK",OK,2019,2652,2599,53,2.0,-75
"Grant County, OK",OK,2018,2727,2673,54,2.0,-152
"Grant County, OK",OK,2017,2879,2809,70,2.4,-124
"Grant County, OK",OK,2016,3003,2910,93,3.1,-286
"Grant County, OK",OK,2015,3289,3195,94,2.9,479
"Grant County, OK",OK,2014,2810,2738,72,2.6,151
"Grant County, OK",OK,2013,2659,2573,86,3.2,18
"Grant County, OK",OK,2012,2641,2554,87,3.3,101
"Grant County, OK",OK,2011,2540,2450,90,3.5,-32
"Grant County, OK",OK,2010,2572,2461,111,4.3,0
"Grant County, OR",OR,2021,3247,3030,217,6.7,46
"Grant County, OR",OR,2020,3201,2933,268,8.4,25
"Grant County, OR",OR,2019,3176,2961,215,6.8,64
"Grant County, OR",OR,2018,3112,2899,213,6.8,2
"Grant County, OR",OR,2017,3110,2900,210,6.8,12
"Grant County, OR",OR,2016,3098,2866,232,7.5,8
"Grant County, OR",OR,2015,3090,2828,262,8.5,-62
"Grant County, OR",OR,2014,3152,2827,325,10.3,-57
"Grant County, OR",OR,2013,3209,2817,392,12.2,-115
"Grant County, OR",OR,2012,3324,2860,464,14.0,-102
"Grant County, OR",OR,2011,3426,2949,477,13.9,15
"Grant County, OR",OR,2010,3411,2941,470,13.8,0
"Grant County, SD",SD,2021,4329,4181,148,3.4,-15
"Grant County, SD",SD,2020,4344,4181,163,3.8,-52
"Grant County, SD",SD,2019,4396,4269,127,2.9,-29
"Grant County, SD",SD,2018,4425,4294,131,3.0,-22
"Grant County, SD",SD,2017,4447,4302,145,3.3,-33
"Grant County, SD",SD,2016,4480,4335,145,3.2,-255
"Grant County, SD",SD,2015,4735,4598,137,2.9,8
"Grant County, SD",SD,2014,4727,4562,165,3.5,52
"Grant County, SD",SD,2013,4675,4483,192,4.1,111
"Grant County, SD",SD,2012,4564,4373,191,4.2,-102
"Grant County, SD",SD,2011,4666,4448,218,4.7,-155
"Grant County, SD",SD,2010,4821,4600,221,4.6,0
"Grant County, WA",WA,2021,47490,44357,3133,6.6,501
"Grant County, WA",WA,2020,46989,42845,4144,8.8,-779
"Grant County, WA",WA,2019,47768,44452,3316,6.9,983
"Grant County, WA",WA,2018,46785,43883,2902,6.2,1461
"Grant County, WA",WA,2017,45324,42534,2790,6.2,739
"Grant County, WA",WA,2016,44585,41462,3123,7.0,-103
"Grant County, WA",WA,2015,44688,41531,3157,7.1,-77
"Grant County, WA",WA,2014,44765,41532,3233,7.2,806
"Grant County, WA",WA,2013,43959,40239,3720,8.5,251
"Grant County, WA",WA,2012,43708,39903,3805,8.7,1356
"Grant County, WA",WA,2011,42352,38492,3860,9.1,34
"Grant County, WA",WA,2010,42318,38144,4174,9.9,0
"Grant County, WI",WI,2021,27648,26817,831,3.0,29
"Grant County, WI",WI,2020,27619,26171,1448,5.2,-275
"Grant County, WI",WI,2019,27894,27037,857,3.1,-443
"Grant County, WI",WI,2018,28337,27550,787,2.8,57
"Grant County, WI",WI,2017,28280,27397,883,3.1,154
"Grant County, WI",WI,2016,28126,27054,1072,3.8,32
"Grant County, WI",WI,2015,28094,26891,1203,4.3,386
"Grant County, WI",WI,2014,27708,26394,1314,4.7,65
"Grant County, WI",WI,2013,27643,26026,1617,5.8,-26
"Grant County, WI",WI,2012,27669,26042,1627,5.9,-195
"Grant County, WI",WI,2011,27864,26019,1845,6.6,67
"Grant County, WI",WI,2010,27797,25721,2076,7.5,0
"Grant County, WV",WV,2021,5994,5726,268,4.5,80
"Grant County, WV",WV,2020,5914,5539,375,6.3,-53
"Grant County, WV",WV,2019,5967,5639,328,5.5,93
"Grant County, WV",WV,2018,5874,5544,330,5.6,-61
"Grant County, WV",WV,2017,5935,5602,333,5.6,-39
"Grant County, WV",WV,2016,5974,5619,355,5.9,144
"Grant County, WV",WV,2015,5830,5399,431,7.4,-33
"Grant County, WV",WV,2014,5863,5420,443,7.6,-138
"Grant County, WV",WV,2013,6001,5516,485,8.1,-168
"Grant County, WV",WV,2012,6169,5644,525,8.5,-15
"Grant County, WV",WV,2011,6184,5644,540,8.7,68
"Grant County, WV",WV,2010,6116,5517,599,9.8,0
"Grant Parish, LA",LA,2021,8207,7877,330,4.0,89
"Grant Parish, LA",LA,2020,8118,7547,571,7.0,-104
"Grant Parish, LA",LA,2019,8222,7762,460,5.6,-12
"Grant Parish, LA",LA,2018,8234,7762,472,5.7,36
"Grant Parish, LA",LA,2017,8198,7682,516,6.3,-136
"Grant Parish, LA",LA,2016,8334,7752,582,7.0,-104
"Grant Parish, LA",LA,2015,8438,7825,613,7.3,67
"Grant Parish, LA",LA,2014,8371,7788,583,7.0,224
"Grant Parish, LA",LA,2013,8147,7574,573,7.0,-112
"Grant Parish, LA",LA,2012,8259,7635,624,7.6,-126
"Grant Parish, LA",LA,2011,8385,7715,670,8.0,-196
"Grant Parish, LA",LA,2010,8581,7896,685,8.0,0
"Granville County, NC",NC,2021,29541,28364,1177,4.0,638
"Granville County, NC",NC,2020,28903,27275,1628,5.6,-1055
"Granville County, NC",NC,2019,29958,28964,994,3.3,411
"Granville County, NC",NC,2018,29547,28526,1021,3.5,-50
"Granville County, NC",NC,2017,29597,28467,1130,3.8,406
"Granville County, NC",NC,2016,29191,27928,1263,4.3,686
"Granville County, NC",NC,2015,28505,27113,1392,4.9,364
"Granville County, NC",NC,2014,28141,26659,1482,5.3,-255
"Granville County, NC",NC,2013,28396,26507,1889,6.7,-133
"Granville County, NC",NC,2012,28529,26194,2335,8.2,524
"Granville County, NC",NC,2011,28005,25518,2487,8.9,522
"Granville County, NC",NC,2010,27483,24837,2646,9.6,0
"Gratiot County, MI",MI,2021,17041,16094,947,5.6,-747
"Gratiot County, MI",MI,2020,17788,16310,1478,8.3,-265
"Gratiot County, MI",MI,2019,18053,17250,803,4.4,234
"Gratiot County, MI",MI,2018,17819,16984,835,4.7,-32
"Gratiot County, MI",MI,2017,17851,16894,957,5.4,-369
"Gratiot County, MI",MI,2016,18220,17266,954,5.2,-162
"Gratiot County, MI",MI,2015,18382,17325,1057,5.8,-132
"Gratiot County, MI",MI,2014,18514,17203,1311,7.1,25
"Gratiot County, MI",MI,2013,18489,16861,1628,8.8,-157
"Gratiot County, MI",MI,2012,18646,16991,1655,8.9,-386
"Gratiot County, MI",MI,2011,19032,17201,1831,9.6,-326
"Gratiot County, MI",MI,2010,19358,17137,2221,11.5,0
"Graves County, KY",KY,2021,15892,15186,706,4.4,332
"Graves County, KY",KY,2020,15560,14669,891,5.7,-256
"Graves County, KY",KY,2019,15816,15130,686,4.3,360
"Graves County, KY",KY,2018,15456,14703,753,4.9,-226
"Graves County, KY",KY,2017,15682,14762,920,5.9,377
"Graves County, KY",KY,2016,15305,14366,939,6.1,192
"Graves County, KY",KY,2015,15113,14184,929,6.1,-754
"Graves County, KY",KY,2014,15867,14685,1182,7.4,-615
"Graves County, KY",KY,2013,16482,15100,1382,8.4,-192
"Graves County, KY",KY,2012,16674,15292,1382,8.3,-271
"Graves County, KY",KY,2011,16945,15410,1535,9.1,31
"Graves County, KY",KY,2010,16914,15294,1620,9.6,0
"Gray County, KS",KS,2021,3229,3174,55,1.7,-6
"Gray County, KS",KS,2020,3235,3167,68,2.1,-16
"Gray County, KS",KS,2019,3251,3187,64,2.0,-175
"Gray County, KS",KS,2018,3426,3359,67,2.0,3
"Gray County, KS",KS,2017,3423,3355,68,2.0,-3
"Gray County, KS",KS,2016,3426,3348,78,2.3,-184
"Gray County, KS",KS,2015,3610,3527,83,2.3,109
"Gray County, KS",KS,2014,3501,3407,94,2.7,5
"Gray County, KS",KS,2013,3496,3391,105,3.0,-80
"Gray County, KS",KS,2012,3576,3465,111,3.1,-27
"Gray County, KS",KS,2011,3603,3486,117,3.2,112
"Gray County, KS",KS,2010,3491,3379,112,3.2,0
"Gray County, TX",TX,2021,7681,7169,512,6.7,-24
"Gray County, TX",TX,2020,7705,7079,626,8.1,-246
"Gray County, TX",TX,2019,7951,7667,284,3.6,-97
"Gray County, TX",TX,2018,8048,7733,315,3.9,-125
"Gray County, TX",TX,2017,8173,7741,432,5.3,-316
"Gray County, TX",TX,2016,8489,7903,586,6.9,-790
"Gray County, TX",TX,2015,9279,8754,525,5.7,-493
"Gray County, TX",TX,2014,9772,9374,398,4.1,6
"Gray County, TX",TX,2013,9766,9259,507,5.2,88
"Gray County, TX",TX,2012,9678,9137,541,5.6,47
"Gray County, TX",TX,2011,9631,8951,680,7.1,332
"Gray County, TX",TX,2010,9299,8493,806,8.7,0
"Grays Harbor County, WA",WA,2021,29083,26828,2255,7.8,350
"Grays Harbor County, WA",WA,2020,28733,25357,3376,11.7,-519
"Grays Harbor County, WA",WA,2019,29252,27140,2112,7.2,844
"Grays Harbor County, WA",WA,2018,28408,26508,1900,6.7,448
"Grays Harbor County, WA",WA,2017,27960,26015,1945,7.0,704
"Grays Harbor County, WA",WA,2016,27256,25019,2237,8.2,359
"Grays Harbor County, WA",WA,2015,26897,24532,2365,8.8,-240
"Grays Harbor County, WA",WA,2014,27137,24462,2675,9.9,-944
"Grays Harbor County, WA",WA,2013,28081,24810,3271,11.6,-569
"Grays Harbor County, WA",WA,2012,28650,25229,3421,11.9,-626
"Grays Harbor County, WA",WA,2011,29276,25687,3589,12.3,-1012
"Grays Harbor County, WA",WA,2010,30288,26460,3828,12.6,0
"Grayson County, KY",KY,2021,10512,9923,589,5.6,-129
"Grayson County, KY",KY,2020,10641,9840,801,7.5,-357
"Grayson County, KY",KY,2019,10998,10473,525,4.8,46
"Grayson County, KY",KY,2018,10952,10429,523,4.8,59
"Grayson County, KY",KY,2017,10893,10242,651,6.0,167
"Grayson County, KY",KY,2016,10726,10015,711,6.6,224
"Grayson County, KY",KY,2015,10502,9804,698,6.6,-365
"Grayson County, KY",KY,2014,10867,9958,909,8.4,-374
"Grayson County, KY",KY,2013,11241,10095,1146,10.2,-77
"Grayson County, KY",KY,2012,11318,10149,1169,10.3,-105
"Grayson County, KY",KY,2011,11423,10027,1396,12.2,-190
"Grayson County, KY",KY,2010,11613,9945,1668,14.4,0
"Grayson County, TX",TX,2021,65711,62721,2990,4.6,2143
"Grayson County, TX",TX,2020,63568,59830,3738,5.9,56
"Grayson County, TX",TX,2019,63512,61559,1953,3.1,857
"Grayson County, TX",TX,2018,62655,60581,2074,3.3,1173
"Grayson County, TX",TX,2017,61482,59282,2200,3.6,250
"Grayson County, TX",TX,2016,61232,58868,2364,3.9,1212
"Grayson County, TX",TX,2015,60020,57580,2440,4.1,-249
"Grayson County, TX",TX,2014,60269,57302,2967,4.9,-136
"Grayson County, TX",TX,2013,60405,56592,3813,6.3,530
"Grayson County, TX",TX,2012,59875,55801,4074,6.8,-276
"Grayson County, TX",TX,2011,60151,55262,4889,8.1,580
"Grayson County, TX",TX,2010,59571,54673,4898,8.2,0
"Grayson County, VA",VA,2021,7841,7580,261,3.3,-181
"Grayson County, VA",VA,2020,8022,7563,459,5.7,-151
"Grayson County, VA",VA,2019,8173,7941,232,2.8,429
"Grayson County, VA",VA,2018,7744,7511,233,3.0,0
"Grayson County, VA",VA,2017,7744,7441,303,3.9,713
"Grayson County, VA",VA,2016,7031,6677,354,5.0,-40
"Grayson County, VA",VA,2015,7071,6659,412,5.8,-20
"Grayson County, VA",VA,2014,7091,6552,539,7.6,85
"Grayson County, VA",VA,2013,7006,6345,661,9.4,22
"Grayson County, VA",VA,2012,6984,6329,655,9.4,-207
"Grayson County, VA",VA,2011,7191,6415,776,10.8,-197
"Grayson County, VA",VA,2010,7388,6452,936,12.7,0
"Greeley County, KS",KS,2021,822,812,10,1.2,4
"Greeley County, KS",KS,2020,818,805,13,1.6,2
"Greeley County, KS",KS,2019,816,798,18,2.2,-45
"Greeley County, KS",KS,2018,861,844,17,2.0,-13
"Greeley County, KS",KS,2017,874,858,16,1.8,-42
"Greeley County, KS",KS,2016,916,897,19,2.1,-21
"Greeley County, KS",KS,2015,937,917,20,2.1,39
"Greeley County, KS",KS,2014,898,879,19,2.1,-12
"Greeley County, KS",KS,2013,910,888,22,2.4,23
"Greeley County, KS",KS,2012,887,860,27,3.0,40
"Greeley County, KS",KS,2011,847,821,26,3.1,20
"Greeley County, KS",KS,2010,827,799,28,3.4,0
"Greeley County, NE",NE,2021,1240,1217,23,1.9,0
"Greeley County, NE",NE,2020,1240,1204,36,2.9,2
"Greeley County, NE",NE,2019,1238,1201,37,3.0,14
"Greeley County, NE",NE,2018,1224,1191,33,2.7,-8
"Greeley County, NE",NE,2017,1232,1194,38,3.1,-9
"Greeley County, NE",NE,2016,1241,1203,38,3.1,-12
"Greeley County, NE",NE,2015,1253,1214,39,3.1,-19
"Greeley County, NE",NE,2014,1272,1231,41,3.2,-24
"Greeley County, NE",NE,2013,1296,1252,44,3.4,0
"Greeley County, NE",NE,2012,1296,1250,46,3.5,-66
"Greeley County, NE",NE,2011,1362,1309,53,3.9,4
"Greeley County, NE",NE,2010,1358,1308,50,3.7,0
"Green County, KY",KY,2021,5177,4984,193,3.7,31
"Green County, KY",KY,2020,5146,4878,268,5.2,14
"Green County, KY",KY,2019,5132,4921,211,4.1,55
"Green County, KY",KY,2018,5077,4868,209,4.1,-73
"Green County, KY",KY,2017,5150,4916,234,4.5,148
"Green County, KY",KY,2016,5002,4780,222,4.4,39
"Green County, KY",KY,2015,4963,4701,262,5.3,-121
"Green County, KY",KY,2014,5084,4753,331,6.5,-236
"Green County, KY",KY,2013,5320,4885,435,8.2,-136
"Green County, KY",KY,2012,5456,5000,456,8.4,-9
"Green County, KY",KY,2011,5465,4939,526,9.6,-161
"Green County, KY",KY,2010,5626,4959,667,11.9,0
"Green County, WI",WI,2021,20919,20290,629,3.0,428
"Green County, WI",WI,2020,20491,19488,1003,4.9,-669
"Green County, WI",WI,2019,21160,20583,577,2.7,26
"Green County, WI",WI,2018,21134,20595,539,2.6,-58
"Green County, WI",WI,2017,21192,20615,577,2.7,39
"Green County, WI",WI,2016,21153,20466,687,3.2,111
"Green County, WI",WI,2015,21042,20259,783,3.7,227
"Green County, WI",WI,2014,20815,19890,925,4.4,-41
"Green County, WI",WI,2013,20856,19672,1184,5.7,50
"Green County, WI",WI,2012,20806,19530,1276,6.1,-270
"Green County, WI",WI,2011,21076,19667,1409,6.7,-212
"Green County, WI",WI,2010,21288,19617,1671,7.8,0
"Green Lake County, WI",WI,2021,9386,8980,406,4.3,58
"Green Lake County, WI",WI,2020,9328,8686,642,6.9,-166
"Green Lake County, WI",WI,2019,9494,9144,350,3.7,-245
"Green Lake County, WI",WI,2018,9739,9418,321,3.3,-1
"Green Lake County, WI",WI,2017,9740,9378,362,3.7,7
"Green Lake County, WI",WI,2016,9733,9270,463,4.8,-233
"Green Lake County, WI",WI,2015,9966,9439,527,5.3,-65
"Green Lake County, WI",WI,2014,10031,9396,635,6.3,-171
"Green Lake County, WI",WI,2013,10202,9398,804,7.9,-98
"Green Lake County, WI",WI,2012,10300,9539,761,7.4,-57
"Green Lake County, WI",WI,2011,10357,9531,826,8.0,46
"Green Lake County, WI",WI,2010,10311,9368,943,9.1,0
"Greenbrier County, WV",WV,2021,15744,15043,701,4.5,206
"Greenbrier County, WV",WV,2020,15538,14316,1222,7.9,-462
"Greenbrier County, WV",WV,2019,16000,15255,745,4.7,218
"Greenbrier County, WV",WV,2018,15782,14991,791,5.0,-46
"Greenbrier County, WV",WV,2017,15828,15057,771,4.9,93
"Greenbrier County, WV",WV,2016,15735,14885,850,5.4,192
"Greenbrier County, WV",WV,2015,15543,14548,995,6.4,263
"Greenbrier County, WV",WV,2014,15280,14243,1037,6.8,-202
"Greenbrier County, WV",WV,2013,15482,14342,1140,7.4,-6
"Greenbrier County, WV",WV,2012,15488,14295,1193,7.7,-70
"Greenbrier County, WV",WV,2011,15558,14294,1264,8.1,142
"Greenbrier County, WV",WV,2010,15416,14061,1355,8.8,0
"Greene County, AL",AL,2021,2897,2698,199,6.9,-197
"Greene County, AL",AL,2020,3094,2728,366,11.8,157
"Greene County, AL",AL,2019,2937,2765,172,5.9,46
"Greene County, AL",AL,2018,2891,2700,191,6.6,6
"Greene County, AL",AL,2017,2885,2662,223,7.7,37
"Greene County, AL",AL,2016,2848,2564,284,10.0,-24
"Greene County, AL",AL,2015,2872,2552,320,11.1,-118
"Greene County, AL",AL,2014,2990,2619,371,12.4,-6
"Greene County, AL",AL,2013,2996,2608,388,13.0,-136
"Greene County, AL",AL,2012,3132,2698,434,13.9,-88
"Greene County, AL",AL,2011,3220,2669,551,17.1,-82
"Greene County, AL",AL,2010,3302,2741,561,17.0,0
"Greene County, AR",AR,2021,19318,18655,663,3.4,-283
"Greene County, AR",AR,2020,19601,18430,1171,6.0,-466
"Greene County, AR",AR,2019,20067,19385,682,3.4,243
"Greene County, AR",AR,2018,19824,19145,679,3.4,106
"Greene County, AR",AR,2017,19718,18987,731,3.7,-121
"Greene County, AR",AR,2016,19839,18987,852,4.3,-197
"Greene County, AR",AR,2015,20036,19012,1024,5.1,259
"Greene County, AR",AR,2014,19777,18553,1224,6.2,252
"Greene County, AR",AR,2013,19525,18024,1501,7.7,-552
"Greene County, AR",AR,2012,20077,18413,1664,8.3,56
"Greene County, AR",AR,2011,20021,18169,1852,9.3,380
"Greene County, AR",AR,2010,19641,17804,1837,9.4,0
"Greene County, GA",GA,2021,7231,6961,270,3.7,41
"Greene County, GA",GA,2020,7190,6774,416,5.8,-124
"Greene County, GA",GA,2019,7314,7022,292,4.0,255
"Greene County, GA",GA,2018,7059,6752,307,4.3,162
"Greene County, GA",GA,2017,6897,6538,359,5.2,292
"Greene County, GA",GA,2016,6605,6200,405,6.1,-146
"Greene County, GA",GA,2015,6751,6296,455,6.7,335
"Greene County, GA",GA,2014,6416,5888,528,8.2,73
"Greene County, GA",GA,2013,6343,5718,625,9.9,-53
"Greene County, GA",GA,2012,6396,5697,699,10.9,31
"Greene County, GA",GA,2011,6365,5586,779,12.2,-67
"Greene County, GA",GA,2010,6432,5574,858,13.3,0
"Greene County, IA",IA,2021,5336,5152,184,3.4,-14
"Greene County, IA",IA,2020,5350,5128,222,4.1,-176
"Greene County, IA",IA,2019,5526,5400,126,2.3,57
"Greene County, IA",IA,2018,5469,5345,124,2.3,-11
"Greene County, IA",IA,2017,5480,5332,148,2.7,-217
"Greene County, IA",IA,2016,5697,5520,177,3.1,127
"Greene County, IA",IA,2015,5570,5376,194,3.5,297
"Greene County, IA",IA,2014,5273,5061,212,4.0,143
"Greene County, IA",IA,2013,5130,4890,240,4.7,-8
"Greene County, IA",IA,2012,5138,4882,256,5.0,-73
"Greene County, IA",IA,2011,5211,4915,296,5.7,23
"Greene County, IA",IA,2010,5188,4877,311,6.0,0
"Greene County, IL",IL,2021,5874,5601,273,4.6,-8
"Greene County, IL",IL,2020,5882,5491,391,6.6,-178
"Greene County, IL",IL,2019,6060,5812,248,4.1,32
"Greene County, IL",IL,2018,6028,5737,291,4.8,2
"Greene County, IL",IL,2017,6026,5720,306,5.1,-69
"Greene County, IL",IL,2016,6095,5740,355,5.8,38
"Greene County, IL",IL,2015,6057,5685,372,6.1,-120
"Greene County, IL",IL,2014,6177,5756,421,6.8,-136
"Greene County, IL",IL,2013,6313,5769,544,8.6,-139
"Greene County, IL",IL,2012,6452,5907,545,8.4,-249
"Greene County, IL",IL,2011,6701,6116,585,8.7,-103
"Greene County, IL",IL,2010,6804,6167,637,9.4,0
"Greene County, IN",IN,2021,13423,12967,456,3.4,156
"Greene County, IN",IN,2020,13267,12435,832,6.3,-433
"Greene County, IN",IN,2019,13700,13140,560,4.1,-52
"Greene County, IN",IN,2018,13752,13152,600,4.4,147
"Greene County, IN",IN,2017,13605,12966,639,4.7,-146
"Greene County, IN",IN,2016,13751,12864,887,6.5,1
"Greene County, IN",IN,2015,13750,12811,939,6.8,-108
"Greene County, IN",IN,2014,13858,12760,1098,7.9,84
"Greene County, IN",IN,2013,13774,12391,1383,10.0,-45
"Greene County, IN",IN,2012,13819,12394,1425,10.3,-393
"Greene County, IN",IN,2011,14212,12764,1448,10.2,-183
"Greene County, IN",IN,2010,14395,12898,1497,10.4,0
"Greene County, MO",MO,2021,152184,146978,5206,3.4,2592
"Greene County, MO",MO,2020,149592,141608,7984,5.3,-815
"Greene County, MO",MO,2019,150407,146573,3834,2.5,2303
"Greene County, MO",MO,2018,148104,144367,3737,2.5,1315
"Greene County, MO",MO,2017,146789,142294,4495,3.1,-1624
"Greene County, MO",MO,2016,148413,142801,5612,3.8,44
"Greene County, MO",MO,2015,148369,142081,6288,4.2,1563
"Greene County, MO",MO,2014,146806,139639,7167,4.9,2723
"Greene County, MO",MO,2013,144083,136072,8011,5.6,1104
"Greene County, MO",MO,2012,142979,134238,8741,6.1,-692
"Greene County, MO",MO,2011,143671,132930,10741,7.5,-457
"Greene County, MO",MO,2010,144128,132202,11926,8.3,0
"Greene County, MS",MS,2021,4197,3879,318,7.6,-50
"Greene County, MS",MS,2020,4247,3843,404,9.5,-110
"Greene County, MS",MS,2019,4357,4013,344,7.9,73
"Greene County, MS",MS,2018,4284,4008,276,6.4,-84
"Greene County, MS",MS,2017,4368,4032,336,7.7,100
"Greene County, MS",MS,2016,4268,3951,317,7.4,-50
"Greene County, MS",MS,2015,4318,3988,330,7.6,-61
"Greene County, MS",MS,2014,4379,3987,392,9.0,-59
"Greene County, MS",MS,2013,4438,3988,450,10.1,-177
"Greene County, MS",MS,2012,4615,4106,509,11.0,-86
"Greene County, MS",MS,2011,4701,4145,556,11.8,114
"Greene County, MS",MS,2010,4587,4055,532,11.6,0
"Greene County, NC",NC,2021,9364,8980,384,4.1,134
"Greene County, NC",NC,2020,9230,8726,504,5.5,-274
"Greene County, NC",NC,2019,9504,9155,349,3.7,106
"Greene County, NC",NC,2018,9398,9032,366,3.9,-16
"Greene County, NC",NC,2017,9414,8997,417,4.4,-82
"Greene County, NC",NC,2016,9496,8992,504,5.3,27
"Greene County, NC",NC,2015,9469,8952,517,5.5,56
"Greene County, NC",NC,2014,9413,8844,569,6.0,-13
"Greene County, NC",NC,2013,9426,8705,721,7.6,-307
"Greene County, NC",NC,2012,9733,8875,858,8.8,124
"Greene County, NC",NC,2011,9609,8687,922,9.6,145
"Greene County, NC",NC,2010,9464,8516,948,10.0,0
"Greene County, NY",NY,2021,20305,19302,1003,4.9,-259
"Greene County, NY",NY,2020,20564,18925,1639,8.0,-135
"Greene County, NY",NY,2019,20699,19809,890,4.3,-356
"Greene County, NY",NY,2018,21055,20102,953,4.5,168
"Greene County, NY",NY,2017,20887,19807,1080,5.2,312
"Greene County, NY",NY,2016,20575,19517,1058,5.1,-111
"Greene County, NY",NY,2015,20686,19511,1175,5.7,-5
"Greene County, NY",NY,2014,20691,19282,1409,6.8,-648
"Greene County, NY",NY,2013,21339,19422,1917,9.0,-186
"Greene County, NY",NY,2012,21525,19354,2171,10.1,-94
"Greene County, NY",NY,2011,21619,19568,2051,9.5,-511
"Greene County, NY",NY,2010,22130,20080,2050,9.3,0
"Greene County, OH",OH,2021,82422,78872,3550,4.3,-4
"Greene County, OH",OH,2020,82426,77103,5323,6.5,-1830
"Greene County, OH",OH,2019,84256,81069,3187,3.8,1136
"Greene County, OH",OH,2018,83120,79769,3351,4.0,173
"Greene County, OH",OH,2017,82947,79418,3529,4.3,1533
"Greene County, OH",OH,2016,81414,77853,3561,4.4,769
"Greene County, OH",OH,2015,80645,77086,3559,4.4,710
"Greene County, OH",OH,2014,79935,75748,4187,5.2,577
"Greene County, OH",OH,2013,79358,73833,5525,7.0,-1305
"Greene County, OH",OH,2012,80663,75114,5549,6.9,-911
"Greene County, OH",OH,2011,81574,74846,6728,8.2,-635
"Greene County, OH",OH,2010,82209,74344,7865,9.6,0
"Greene County, PA",PA,2021,15723,14575,1148,7.3,-430
"Greene County, PA",PA,2020,16153,14579,1574,9.7,-645
"Greene County, PA",PA,2019,16798,15917,881,5.2,21
"Greene County, PA",PA,2018,16777,15929,848,5.1,-177
"Greene County, PA",PA,2017,16954,15937,1017,6.0,-364
"Greene County, PA",PA,2016,17318,15991,1327,7.7,-853
"Greene County, PA",PA,2015,18171,17061,1110,6.1,-326
"Greene County, PA",PA,2014,18497,17454,1043,5.6,-204
"Greene County, PA",PA,2013,18701,17395,1306,7.0,-336
"Greene County, PA",PA,2012,19037,17677,1360,7.1,882
"Greene County, PA",PA,2011,18155,16796,1359,7.5,799
"Greene County, PA",PA,2010,17356,15947,1409,8.1,0
"Greene County, TN",TN,2021,28818,27552,1266,4.4,-76
"Greene County, TN",TN,2020,28894,26558,2336,8.1,-1029
"Greene County, TN",TN,2019,29923,28532,1391,4.6,41
"Greene County, TN",TN,2018,29882,28500,1382,4.6,-495
"Greene County, TN",TN,2017,30377,28988,1389,4.6,-516
"Greene County, TN",TN,2016,30893,29202,1691,5.5,222
"Greene County, TN",TN,2015,30671,28707,1964,6.4,432
"Greene County, TN",TN,2014,30239,27790,2449,8.1,-226
"Greene County, TN",TN,2013,30465,27536,2929,9.6,414
"Greene County, TN",TN,2012,30051,26948,3103,10.3,-594
"Greene County, TN",TN,2011,30645,27100,3545,11.6,-386
"Greene County, TN",TN,2010,31031,26983,4048,13.0,0
"Greene County, VA",VA,2021,10165,9861,304,3.0,-196
"Greene County, VA",VA,2020,10361,9824,537,5.2,-364
"Greene County, VA",VA,2019,10725,10477,248,2.3,315
"Greene County, VA",VA,2018,10410,10150,260,2.5,170
"Greene County, VA",VA,2017,10240,9932,308,3.0,294
"Greene County, VA",VA,2016,9946,9626,320,3.2,58
"Greene County, VA",VA,2015,9888,9525,363,3.7,1
"Greene County, VA",VA,2014,9887,9460,427,4.3,197
"Greene County, VA",VA,2013,9690,9234,456,4.7,-96
"Greene County, VA",VA,2012,9786,9254,532,5.4,8
"Greene County, VA",VA,2011,9778,9189,589,6.0,111
"Greene County, VA",VA,2010,9667,9002,665,6.9,0
"Greenlee County, AZ",AZ,2021,4343,4169,174,4.0,36
"Greenlee County, AZ",AZ,2020,4307,4082,225,5.2,-39
"Greenlee County, AZ",AZ,2019,4346,4173,173,4.0,202
"Greenlee County, AZ",AZ,2018,4144,3973,171,4.1,259
"Greenlee County, AZ",AZ,2017,3885,3687,198,5.1,-31
"Greenlee County, AZ",AZ,2016,3916,3615,301,7.7,-152
"Greenlee County, AZ",AZ,2015,4068,3745,323,7.9,-680
"Greenlee County, AZ",AZ,2014,4748,4439,309,6.5,116
"Greenlee County, AZ",AZ,2013,4632,4358,274,5.9,1048
"Greenlee County, AZ",AZ,2012,3584,3289,295,8.2,215
"Greenlee County, AZ",AZ,2011,3369,2999,370,11.0,-75
"Greenlee County, AZ",AZ,2010,3444,2883,561,16.3,0
"Greensville County, VA",VA,2021,4252,4045,207,4.9,-6
"Greensville County, VA",VA,2020,4258,3975,283,6.6,-80
"Greensville County, VA",VA,2019,4338,4192,146,3.4,-77
"Greensville County, VA",VA,2018,4415,4255,160,3.6,-52
"Greensville County, VA",VA,2017,4467,4275,192,4.3,255
"Greensville County, VA",VA,2016,4212,4002,210,5.0,24
"Greensville County, VA",VA,2015,4188,3966,222,5.3,-69
"Greensville County, VA",VA,2014,4257,3987,270,6.3,-97
"Greensville County, VA",VA,2013,4354,4025,329,7.6,-105
"Greensville County, VA",VA,2012,4459,4082,377,8.5,-113
"Greensville County, VA",VA,2011,4572,4173,399,8.7,3
"Greensville County, VA",VA,2010,4569,4122,447,9.8,0
"Greenup County, KY",KY,2021,13020,12130,890,6.8,-125
"Greenup County, KY",KY,2020,13145,12010,1135,8.6,-330
"Greenup County, KY",KY,2019,13475,12638,837,6.2,53
"Greenup County, KY",KY,2018,13422,12560,862,6.4,-171
"Greenup County, KY",KY,2017,13593,12567,1026,7.5,-291
"Greenup County, KY",KY,2016,13884,12698,1186,8.5,147
"Greenup County, KY",KY,2015,13737,12703,1034,7.5,-558
"Greenup County, KY",KY,2014,14295,13080,1215,8.5,-498
"Greenup County, KY",KY,2013,14793,13297,1496,10.1,-257
"Greenup County, KY",KY,2012,15050,13552,1498,10.0,-197
"Greenup County, KY",KY,2011,15247,13540,1707,11.2,-183
"Greenup County, KY",KY,2010,15430,13635,1795,11.6,0
"Greenville County, SC",SC,2021,255544,246829,8715,3.4,4459
"Greenville County, SC",SC,2020,251085,237271,13814,5.5,648
"Greenville County, SC",SC,2019,250437,244443,5994,2.4,4365
"Greenville County, SC",SC,2018,246072,238985,7087,2.9,2762
"Greenville County, SC",SC,2017,243310,234572,8738,3.6,-1519
"Greenville County, SC",SC,2016,244829,234676,10153,4.1,1987
"Greenville County, SC",SC,2015,242842,230968,11874,4.9,7261
"Greenville County, SC",SC,2014,235581,223367,12214,5.2,4021
"Greenville County, SC",SC,2013,231560,217819,13741,5.9,4158
"Greenville County, SC",SC,2012,227402,210863,16539,7.3,2114
"Greenville County, SC",SC,2011,225288,206016,19272,8.6,3197
"Greenville County, SC",SC,2010,222091,200398,21693,9.8,0
"Greenwood County, KS",KS,2021,3011,2926,85,2.8,-92
"Greenwood County, KS",KS,2020,3103,2945,158,5.1,-143
"Greenwood County, KS",KS,2019,3246,3145,101,3.1,-4
"Greenwood County, KS",KS,2018,3250,3138,112,3.4,19
"Greenwood County, KS",KS,2017,3231,3096,135,4.2,-106
"Greenwood County, KS",KS,2016,3337,3175,162,4.9,39
"Greenwood County, KS",KS,2015,3298,3147,151,4.6,-34
"Greenwood County, KS",KS,2014,3332,3183,149,4.5,-34
"Greenwood County, KS",KS,2013,3366,3186,180,5.3,-73
"Greenwood County, KS",KS,2012,3439,3247,192,5.6,-42
"Greenwood County, KS",KS,2011,3481,3254,227,6.5,41
"Greenwood County, KS",KS,2010,3440,3184,256,7.4,0
"Greenwood County, SC",SC,2021,30333,28958,1375,4.5,-359
"Greenwood County, SC",SC,2020,30692,28785,1907,6.2,-27
"Greenwood County, SC",SC,2019,30719,29793,926,3.0,430
"Greenwood County, SC",SC,2018,30289,29199,1090,3.6,195
"Greenwood County, SC",SC,2017,30094,28757,1337,4.4,-1158
"Greenwood County, SC",SC,2016,31252,29671,1581,5.1,9
"Greenwood County, SC",SC,2015,31243,29288,1955,6.3,-413
"Greenwood County, SC",SC,2014,31656,29536,2120,6.7,20
"Greenwood County, SC",SC,2013,31636,28979,2657,8.4,-457
"Greenwood County, SC",SC,2012,32093,28905,3188,9.9,-85
"Greenwood County, SC",SC,2011,32178,28573,3605,11.2,24
"Greenwood County, SC",SC,2010,32154,28288,3866,12.0,0
"Greer County, OK",OK,2021,1859,1764,95,5.1,-8
"Greer County, OK",OK,2020,1867,1725,142,7.6,49
"Greer County, OK",OK,2019,1818,1745,73,4.0,-138
"Greer County, OK",OK,2018,1956,1881,75,3.8,-94
"Greer County, OK",OK,2017,2050,1949,101,4.9,-136
"Greer County, OK",OK,2016,2186,2030,156,7.1,20
"Greer County, OK",OK,2015,2166,2047,119,5.5,135
"Greer County, OK",OK,2014,2031,1940,91,4.5,35
"Greer County, OK",OK,2013,1996,1892,104,5.2,-69
"Greer County, OK",OK,2012,2065,1958,107,5.2,-72
"Greer County, OK",OK,2011,2137,2008,129,6.0,-50
"Greer County, OK",OK,2010,2187,2026,161,7.4,0
"Gregg County, TX",TX,2021,56193,52563,3630,6.5,225
"Gregg County, TX",TX,2020,55968,51319,4649,8.3,-1413
"Gregg County, TX",TX,2019,57381,55227,2154,3.8,455
"Gregg County, TX",TX,2018,56926,54558,2368,4.2,-56
"Gregg County, TX",TX,2017,56982,54016,2966,5.2,-1401
"Gregg County, TX",TX,2016,58383,54826,3557,6.1,-925
"Gregg County, TX",TX,2015,59308,56347,2961,5.0,-1757
"Gregg County, TX",TX,2014,61065,58055,3010,4.9,-369
"Gregg County, TX",TX,2013,61434,57749,3685,6.0,-62
"Gregg County, TX",TX,2012,61496,57708,3788,6.2,444
"Gregg County, TX",TX,2011,61052,56543,4509,7.4,585
"Gregg County, TX",TX,2010,60467,55621,4846,8.0,0
"Gregory County, SD",SD,2021,2069,2011,58,2.8,39
"Gregory County, SD",SD,2020,2030,1958,72,3.5,10
"Gregory County, SD",SD,2019,2020,1960,60,3.0,-14
"Gregory County, SD",SD,2018,2034,1973,61,3.0,-15
"Gregory County, SD",SD,2017,2049,1983,66,3.2,-37
"Gregory County, SD",SD,2016,2086,2023,63,3.0,16
"Gregory County, SD",SD,2015,2070,2006,64,3.1,-18
"Gregory County, SD",SD,2014,2088,2019,69,3.3,-25
"Gregory County, SD",SD,2013,2113,2032,81,3.8,-40
"Gregory County, SD",SD,2012,2153,2064,89,4.1,-30
"Gregory County, SD",SD,2011,2183,2085,98,4.5,-9
"Gregory County, SD",SD,2010,2192,2098,94,4.3,0
"Grenada County, MS",MS,2021,9083,8630,453,5.0,-68
"Grenada County, MS",MS,2020,9151,8506,645,7.0,-466
"Grenada County, MS",MS,2019,9617,9137,480,5.0,68
"Grenada County, MS",MS,2018,9549,9129,420,4.4,-76
"Grenada County, MS",MS,2017,9625,9171,454,4.7,62
"Grenada County, MS",MS,2016,9563,9063,500,5.2,114
"Grenada County, MS",MS,2015,9449,8881,568,6.0,186
"Grenada County, MS",MS,2014,9263,8591,672,7.3,-74
"Grenada County, MS",MS,2013,9337,8517,820,8.8,-376
"Grenada County, MS",MS,2012,9713,8835,878,9.0,-18
"Grenada County, MS",MS,2011,9731,8757,974,10.0,284
"Grenada County, MS",MS,2010,9447,8385,1062,11.2,0
"Griggs County, ND",ND,2021,1026,997,29,2.8,-1
"Griggs County, ND",ND,2020,1027,996,31,3.0,-15
"Griggs County, ND",ND,2019,1042,1019,23,2.2,-29
"Griggs County, ND",ND,2018,1071,1049,22,2.1,-66
"Griggs County, ND",ND,2017,1137,1105,32,2.8,-20
"Griggs County, ND",ND,2016,1157,1124,33,2.9,11
"Griggs County, ND",ND,2015,1146,1119,27,2.4,-26
"Griggs County, ND",ND,2014,1172,1145,27,2.3,-17
"Griggs County, ND",ND,2013,1189,1161,28,2.4,-28
"Griggs County, ND",ND,2012,1217,1186,31,2.5,-46
"Griggs County, ND",ND,2011,1263,1227,36,2.9,-60
"Griggs County, ND",ND,2010,1323,1285,38,2.9,0
"Grimes County, TX",TX,2021,11133,10386,747,6.7,126
"Grimes County, TX",TX,2020,11007,10118,889,8.1,-114
"Grimes County, TX",TX,2019,11121,10677,444,4.0,115
"Grimes County, TX",TX,2018,11006,10549,457,4.2,201
"Grimes County, TX",TX,2017,10805,10222,583,5.4,-253
"Grimes County, TX",TX,2016,11058,10326,732,6.6,-459
"Grimes County, TX",TX,2015,11517,10900,617,5.4,-290
"Grimes County, TX",TX,2014,11807,11236,571,4.8,11
"Grimes County, TX",TX,2013,11796,11082,714,6.1,8
"Grimes County, TX",TX,2012,11788,11032,756,6.4,166
"Grimes County, TX",TX,2011,11622,10681,941,8.1,273
"Grimes County, TX",TX,2010,11349,10322,1027,9.0,0
"Grundy County, IA",IA,2021,6337,6106,231,3.6,-1
"Grundy County, IA",IA,2020,6338,6068,270,4.3,-347
"Grundy County, IA",IA,2019,6685,6511,174,2.6,85
"Grundy County, IA",IA,2018,6600,6436,164,2.5,2
"Grundy County, IA",IA,2017,6598,6409,189,2.9,-71
"Grundy County, IA",IA,2016,6669,6441,228,3.4,-63
"Grundy County, IA",IA,2015,6732,6479,253,3.8,9
"Grundy County, IA",IA,2014,6723,6444,279,4.1,115
"Grundy County, IA",IA,2013,6608,6320,288,4.4,-71
"Grundy County, IA",IA,2012,6679,6373,306,4.6,-52
"Grundy County, IA",IA,2011,6731,6390,341,5.1,-7
"Grundy County, IA",IA,2010,6738,6348,390,5.8,0
"Grundy County, IL",IL,2021,25122,23796,1326,5.3,-257
"Grundy County, IL",IL,2020,25379,23211,2168,8.5,-1146
"Grundy County, IL",IL,2019,26525,25297,1228,4.6,319
"Grundy County, IL",IL,2018,26206,24936,1270,4.8,165
"Grundy County, IL",IL,2017,26041,24528,1513,5.8,274
"Grundy County, IL",IL,2016,25767,23999,1768,6.9,285
"Grundy County, IL",IL,2015,25482,23690,1792,7.0,-150
"Grundy County, IL",IL,2014,25632,23364,2268,8.8,-336
"Grundy County, IL",IL,2013,25968,22930,3038,11.7,117
"Grundy County, IL",IL,2012,25851,22876,2975,11.5,239
"Grundy County, IL",IL,2011,25612,22320,3292,12.9,-306
"Grundy County, IL",IL,2010,25918,22448,3470,13.4,0
"Grundy County, MO",MO,2021,4178,4028,150,3.6,-98
"Grundy County, MO",MO,2020,4276,4081,195,4.6,-77
"Grundy County, MO",MO,2019,4353,4209,144,3.3,-180
"Grundy County, MO",MO,2018,4533,4373,160,3.5,-260
"Grundy County, MO",MO,2017,4793,4624,169,3.5,-104
"Grundy County, MO",MO,2016,4897,4674,223,4.6,17
"Grundy County, MO",MO,2015,4880,4674,206,4.2,-2
"Grundy County, MO",MO,2014,4882,4623,259,5.3,-24
"Grundy County, MO",MO,2013,4906,4617,289,5.9,-7
"Grundy County, MO",MO,2012,4913,4586,327,6.7,-16
"Grundy County, MO",MO,2011,4929,4573,356,7.2,112
"Grundy County, MO",MO,2010,4817,4434,383,8.0,0
"Grundy County, TN",TN,2021,5030,4757,273,5.4,-97
"Grundy County, TN",TN,2020,5127,4620,507,9.9,103
"Grundy County, TN",TN,2019,5024,4815,209,4.2,121
"Grundy County, TN",TN,2018,4903,4687,216,4.4,70
"Grundy County, TN",TN,2017,4833,4591,242,5.0,40
"Grundy County, TN",TN,2016,4793,4482,311,6.5,-88
"Grundy County, TN",TN,2015,4881,4504,377,7.7,-231
"Grundy County, TN",TN,2014,5112,4632,480,9.4,-225
"Grundy County, TN",TN,2013,5337,4802,535,10.0,-190
"Grundy County, TN",TN,2012,5527,4962,565,10.2,3
"Grundy County, TN",TN,2011,5524,4828,696,12.6,-119
"Grundy County, TN",TN,2010,5643,4918,725,12.8,0
"Guadalupe County, NM",NM,2021,1634,1520,114,7.0,141
"Guadalupe County, NM",NM,2020,1493,1395,98,6.6,-88
"Guadalupe County, NM",NM,2019,1581,1497,84,5.3,-55
"Guadalupe County, NM",NM,2018,1636,1547,89,5.4,-25
"Guadalupe County, NM",NM,2017,1661,1554,107,6.4,-44
"Guadalupe County, NM",NM,2016,1705,1593,112,6.6,60
"Guadalupe County, NM",NM,2015,1645,1527,118,7.2,21
"Guadalupe County, NM",NM,2014,1624,1500,124,7.6,-17
"Guadalupe County, NM",NM,2013,1641,1499,142,8.7,-5
"Guadalupe County, NM",NM,2012,1646,1485,161,9.8,2
"Guadalupe County, NM",NM,2011,1644,1478,166,10.1,7
"Guadalupe County, NM",NM,2010,1637,1479,158,9.7,0
"Guadalupe County, TX",TX,2021,82209,78557,3652,4.4,2045
"Guadalupe County, TX",TX,2020,80164,75248,4916,6.1,-662
"Guadalupe County, TX",TX,2019,80826,78431,2395,3.0,1302
"Guadalupe County, TX",TX,2018,79524,77009,2515,3.2,1670
"Guadalupe County, TX",TX,2017,77854,75236,2618,3.4,1862
"Guadalupe County, TX",TX,2016,75992,73263,2729,3.6,3025
"Guadalupe County, TX",TX,2015,72967,70371,2596,3.6,1497
"Guadalupe County, TX",TX,2014,71470,68337,3133,4.4,1516
"Guadalupe County, TX",TX,2013,69954,66086,3868,5.5,1804
"Guadalupe County, TX",TX,2012,68150,64306,3844,5.6,1444
"Guadalupe County, TX",TX,2011,66706,62243,4463,6.7,1697
"Guadalupe County, TX",TX,2010,65009,60619,4390,6.8,0
"Guanica Municipio, PR",PR,2021,4284,3696,588,13.7,
"Guanica Municipio, PR",PR,2020,N.A.,N.A.,N.A.,N.A.,
"Guanica Municipio, PR",PR,2019,3978,3388,590,14.8,51
"Guanica Municipio, PR",PR,2018,3927,3320,607,15.5,-126
"Guanica Municipio, PR",PR,2017,4053,3312,741,18.3,-89
"Guanica Municipio, PR",PR,2016,4142,3394,748,18.1,-62
"Guanica Municipio, PR",PR,2015,4204,3380,824,19.6,-279
"Guanica Municipio, PR",PR,2014,4483,3364,1119,25.0,-293
"Guanica Municipio, PR",PR,2013,4776,3503,1273,26.7,17
"Guanica Municipio, PR",PR,2012,4759,3577,1182,24.8,-170
"Guanica Municipio, PR",PR,2011,4929,3671,1258,25.5,-187
"Guanica Municipio, PR",PR,2010,5116,3808,1308,25.6,0
"Guayama Municipio, PR",PR,2021,11695,10793,902,7.7,
"Guayama Municipio, PR",PR,2020,N.A.,N.A.,N.A.,N.A.,
"Guayama Municipio, PR",PR,2019,11144,9801,1343,12.1,72
"Guayama Municipio, PR",PR,2018,11072,9599,1473,13.3,-674
"Guayama Municipio, PR",PR,2017,11746,9908,1838,15.6,-306
"Guayama Municipio, PR",PR,2016,12052,10076,1976,16.4,-190
"Guayama Municipio, PR",PR,2015,12242,10123,2119,17.3,-73
"Guayama Municipio, PR",PR,2014,12315,9799,2516,20.4,-667
"Guayama Municipio, PR",PR,2013,12982,10159,2823,21.7,-389
"Guayama Municipio, PR",PR,2012,13371,10581,2790,20.9,-686
"Guayama Municipio, PR",PR,2011,14057,10882,3175,22.6,-947
"Guayama Municipio, PR",PR,2010,15004,11483,3521,23.5,0
"Guayanilla Municipio, PR",PR,2021,5334,4754,580,10.9,
"Guayanilla Municipio, PR",PR,2020,N.A.,N.A.,N.A.,N.A.,
"Guayanilla Municipio, PR",PR,2019,5066,4365,701,13.8,137
"Guayanilla Municipio, PR",PR,2018,4929,4219,710,14.4,-156
"Guayanilla Municipio, PR",PR,2017,5085,4251,834,16.4,-207
"Guayanilla Municipio, PR",PR,2016,5292,4302,990,18.7,-27
"Guayanilla Municipio, PR",PR,2015,5319,4284,1035,19.5,-180
"Guayanilla Municipio, PR",PR,2014,5499,4301,1198,21.8,-197
"Guayanilla Municipio, PR",PR,2013,5696,4443,1253,22.0,-70
"Guayanilla Municipio, PR",PR,2012,5766,4532,1234,21.4,-144
"Guayanilla Municipio, PR",PR,2011,5910,4568,1342,22.7,-364
"Guayanilla Municipio, PR",PR,2010,6274,4744,1530,24.4,0
"Guaynabo Municipio, PR",PR,2021,40599,38733,1866,4.6,
"Guaynabo Municipio, PR",PR,2020,N.A.,N.A.,N.A.,N.A.,
"Guaynabo Municipio, PR",PR,2019,37417,35881,1536,4.1,604
"Guaynabo Municipio, PR",PR,2018,36813,35198,1615,4.4,61
"Guaynabo Municipio, PR",PR,2017,36752,34813,1939,5.3,-438
"Guaynabo Municipio, PR",PR,2016,37190,34975,2215,6.0,-28
"Guaynabo Municipio, PR",PR,2015,37218,35051,2167,5.8,268
"Guaynabo Municipio, PR",PR,2014,36950,34644,2306,6.2,-876
"Guaynabo Municipio, PR",PR,2013,37826,35532,2294,6.1,-1064
"Guaynabo Municipio, PR",PR,2012,38890,36304,2586,6.6,-692
"Guaynabo Municipio, PR",PR,2011,39582,36423,3159,8.0,-1670
"Guaynabo Municipio, PR",PR,2010,41252,37746,3506,8.5,0
"Guernsey County, OH",OH,2021,17904,16906,998,5.6,-348
"Guernsey County, OH",OH,2020,18252,16664,1588,8.7,-511
"Guernsey County, OH",OH,2019,18763,17731,1032,5.5,-83
"Guernsey County, OH",OH,2018,18846,17810,1036,5.5,-206
"Guernsey County, OH",OH,2017,19052,17907,1145,6.0,84
"Guernsey County, OH",OH,2016,18968,17613,1355,7.1,-302
"Guernsey County, OH",OH,2015,19270,18061,1209,6.3,130
"Guernsey County, OH",OH,2014,19140,17854,1286,6.7,607
"Guernsey County, OH",OH,2013,18533,16930,1603,8.6,298
"Guernsey County, OH",OH,2012,18235,16602,1633,9.0,-186
"Guernsey County, OH",OH,2011,18421,16432,1989,10.8,-463
"Guernsey County, OH",OH,2010,18884,16472,2412,12.8,0
"Guilford County, NC",NC,2021,254780,240484,14296,5.6,2520
"Guilford County, NC",NC,2020,252260,231469,20791,8.2,-8442
"Guilford County, NC",NC,2019,260702,250142,10560,4.1,2316
"Guilford County, NC",NC,2018,258386,247437,10949,4.2,1280
"Guilford County, NC",NC,2017,257106,244858,12248,4.8,-574
"Guilford County, NC",NC,2016,257680,244175,13505,5.2,1673
"Guilford County, NC",NC,2015,256007,241158,14849,5.8,2698
"Guilford County, NC",NC,2014,253309,237205,16104,6.4,-2348
"Guilford County, NC",NC,2013,255657,235225,20432,8.0,-1286
"Guilford County, NC",NC,2012,256943,231822,25121,9.8,2458
"Guilford County, NC",NC,2011,254485,227869,26616,10.5,1548
"Guilford County, NC",NC,2010,252937,225137,27800,11.0,0
"Gulf County, FL",FL,2021,5270,5080,190,3.6,196
"Gulf County, FL",FL,2020,5074,4754,320,6.3,-82
"Gulf County, FL",FL,2019,5156,4905,251,4.9,-795
"Gulf County, FL",FL,2018,5951,5677,274,4.6,-14
"Gulf County, FL",FL,2017,5965,5729,236,4.0,-20
"Gulf County, FL",FL,2016,5985,5704,281,4.7,-34
"Gulf County, FL",FL,2015,6019,5699,320,5.3,-95
"Gulf County, FL",FL,2014,6114,5732,382,6.2,-31
"Gulf County, FL",FL,2013,6145,5712,433,7.0,95
"Gulf County, FL",FL,2012,6050,5546,504,8.3,-153
"Gulf County, FL",FL,2011,6203,5606,597,9.6,23
"Gulf County, FL",FL,2010,6180,5564,616,10.0,0
"Gunnison County, CO",CO,2021,11837,11402,435,3.7,541
"Gunnison County, CO",CO,2020,11296,10587,709,6.3,-61
"Gunnison County, CO",CO,2019,11357,11126,231,2.0,118
"Gunnison County, CO",CO,2018,11239,10981,258,2.3,636
"Gunnison County, CO",CO,2017,10603,10403,200,1.9,463
"Gunnison County, CO",CO,2016,10140,9918,222,2.2,347
"Gunnison County, CO",CO,2015,9793,9515,278,2.8,123
"Gunnison County, CO",CO,2014,9670,9281,389,4.0,37
"Gunnison County, CO",CO,2013,9633,9115,518,5.4,-168
"Gunnison County, CO",CO,2012,9801,9207,594,6.1,-105
"Gunnison County, CO",CO,2011,9906,9284,622,6.3,-141
"Gunnison County, CO",CO,2010,10047,9365,682,6.8,0
"Gurabo Municipio, PR",PR,2021,19938,18907,1031,5.2,
"Gurabo Municipio, PR",PR,2020,N.A.,N.A.,N.A.,N.A.,
"Gurabo Municipio, PR",PR,2019,18388,17349,1039,5.7,556
"Gurabo Municipio, PR",PR,2018,17832,16693,1139,6.4,273
"Gurabo Municipio, PR",PR,2017,17559,16277,1282,7.3,46
"Gurabo Municipio, PR",PR,2016,17513,16026,1487,8.5,221
"Gurabo Municipio, PR",PR,2015,17292,15789,1503,8.7,207
"Gurabo Municipio, PR",PR,2014,17085,15283,1802,10.5,-150
"Gurabo Municipio, PR",PR,2013,17235,15394,1841,10.7,-79
"Gurabo Municipio, PR",PR,2012,17314,15360,1954,11.3,12
"Gurabo Municipio, PR",PR,2011,17302,15026,2276,13.2,-364
"Gurabo Municipio, PR",PR,2010,17666,15191,2475,14.0,0
"Guthrie County, IA",IA,2021,5491,5258,233,4.2,59
"Guthrie County, IA",IA,2020,5432,5167,265,4.9,-258
"Guthrie County, IA",IA,2019,5690,5527,163,2.9,71
"Guthrie County, IA",IA,2018,5619,5473,146,2.6,7
"Guthrie County, IA",IA,2017,5612,5435,177,3.2,-42
"Guthrie County, IA",IA,2016,5654,5452,202,3.6,32
"Guthrie County, IA",IA,2015,5622,5412,210,3.7,11
"Guthrie County, IA",IA,2014,5611,5366,245,4.4,71
"Guthrie County, IA",IA,2013,5540,5255,285,5.1,-38
"Guthrie County, IA",IA,2012,5578,5263,315,5.6,-137
"Guthrie County, IA",IA,2011,5715,5360,355,6.2,-123
"Guthrie County, IA",IA,2010,5838,5454,384,6.6,0
"Gwinnett County, GA",GA,2021,492181,475000,17181,3.5,11932
"Gwinnett County, GA",GA,2020,480249,450036,30213,6.3,-10827
"Gwinnett County, GA",GA,2019,491076,475438,15638,3.2,2887
"Gwinnett County, GA",GA,2018,488189,470734,17455,3.6,1413
"Gwinnett County, GA",GA,2017,486776,465984,20792,4.3,19042
"Gwinnett County, GA",GA,2016,467734,445147,22587,4.8,20507
"Gwinnett County, GA",GA,2015,447227,423631,23596,5.3,3576
"Gwinnett County, GA",GA,2014,443651,416686,26965,6.1,5923
"Gwinnett County, GA",GA,2013,437728,407841,29887,6.8,5008
"Gwinnett County, GA",GA,2012,432720,399656,33064,7.6,6334
"Gwinnett County, GA",GA,2011,426386,389527,36859,8.6,6853
"Gwinnett County, GA",GA,2010,419533,380264,39269,9.4,0
"Haakon County, SD",SD,2021,1041,1012,29,2.8,-10
"Haakon County, SD",SD,2020,1051,1026,25,2.4,7
"Haakon County, SD",SD,2019,1044,1017,27,2.6,-23
"Haakon County, SD",SD,2018,1067,1041,26,2.4,-35
"Haakon County, SD",SD,2017,1102,1073,29,2.6,-9
"Haakon County, SD",SD,2016,1111,1084,27,2.4,6
"Haakon County, SD",SD,2015,1105,1080,25,2.3,8
"Haakon County, SD",SD,2014,1097,1068,29,2.6,9
"Haakon County, SD",SD,2013,1088,1057,31,2.8,-21
"Haakon County, SD",SD,2012,1109,1076,33,3.0,-14
"Haakon County, SD",SD,2011,1123,1082,41,3.7,-6
"Haakon County, SD",SD,2010,1129,1091,38,3.4,0
"Habersham County, GA",GA,2021,18592,17930,662,3.6,-129
"Habersham County, GA",GA,2020,18721,17713,1008,5.4,-753
"Habersham County, GA",GA,2019,19474,18784,690,3.5,3
"Habersham County, GA",GA,2018,19471,18734,737,3.8,-21
"Habersham County, GA",GA,2017,19492,18595,897,4.6,190
"Habersham County, GA",GA,2016,19302,18268,1034,5.4,700
"Habersham County, GA",GA,2015,18602,17519,1083,5.8,-339
"Habersham County, GA",GA,2014,18941,17617,1324,7.0,-351
"Habersham County, GA",GA,2013,19292,17756,1536,8.0,933
"Habersham County, GA",GA,2012,18359,16639,1720,9.4,62
"Habersham County, GA",GA,2011,18297,16393,1904,10.4,-99
"Habersham County, GA",GA,2010,18396,16410,1986,10.8,0
"Haines Borough, AK",AK,2021,1024,908,116,11.3,3
"Haines Borough, AK",AK,2020,1021,854,167,16.4,-110
"Haines Borough, AK",AK,2019,1131,1039,92,8.1,29
"Haines Borough, AK",AK,2018,1102,1005,97,8.8,22
"Haines Borough, AK",AK,2017,1080,990,90,8.3,9
"Haines Borough, AK",AK,2016,1071,966,105,9.8,-12
"Haines Borough, AK",AK,2015,1083,980,103,9.5,-25
"Haines Borough, AK",AK,2014,1108,991,117,10.6,-28
"Haines Borough, AK",AK,2013,1136,1021,115,10.1,32
"Haines Borough, AK",AK,2012,1104,992,112,10.1,-59
"Haines Borough, AK",AK,2011,1163,1044,119,10.2,12
"Haines Borough, AK",AK,2010,1151,1024,127,11.0,0
"Hale County, AL",AL,2021,5888,5553,335,5.7,-277
"Hale County, AL",AL,2020,6165,5529,636,10.3,-6
"Hale County, AL",AL,2019,6171,5915,256,4.1,128
"Hale County, AL",AL,2018,6043,5739,304,5.0,27
"Hale County, AL",AL,2017,6016,5650,366,6.1,83
"Hale County, AL",AL,2016,5933,5478,455,7.7,-101
"Hale County, AL",AL,2015,6034,5562,472,7.8,-7
"Hale County, AL",AL,2014,6041,5448,593,9.8,-165
"Hale County, AL",AL,2013,6206,5475,731,11.8,-17
"Hale County, AL",AL,2012,6223,5492,731,11.7,-65
"Hale County, AL",AL,2011,6288,5428,860,13.7,-151
"Hale County, AL",AL,2010,6439,5485,954,14.8,0
"Hale County, TX",TX,2021,11915,11191,724,6.1,279
"Hale County, TX",TX,2020,11636,10850,786,6.8,-405
"Hale County, TX",TX,2019,12041,11504,537,4.5,-331
"Hale County, TX",TX,2018,12372,11776,596,4.8,-50
"Hale County, TX",TX,2017,12422,11781,641,5.2,-174
"Hale County, TX",TX,2016,12596,11887,709,5.6,-298
"Hale County, TX",TX,2015,12894,12069,825,6.4,-620
"Hale County, TX",TX,2014,13514,12229,1285,9.5,-1277
"Hale County, TX",TX,2013,14791,12811,1980,13.4,-1031
"Hale County, TX",TX,2012,15822,14735,1087,6.9,-408
"Hale County, TX",TX,2011,16230,14976,1254,7.7,29
"Hale County, TX",TX,2010,16201,14996,1205,7.4,0
"Halifax County, NC",NC,2021,19179,17747,1432,7.5,-240
"Halifax County, NC",NC,2020,19419,17699,1720,8.9,-816
"Halifax County, NC",NC,2019,20235,19106,1129,5.6,335
"Halifax County, NC",NC,2018,19900,18677,1223,6.1,-376
"Halifax County, NC",NC,2017,20276,18799,1477,7.3,-345
"Halifax County, NC",NC,2016,20621,18985,1636,7.9,-123
"Halifax County, NC",NC,2015,20744,18936,1808,8.7,-500
"Halifax County, NC",NC,2014,21244,19245,1999,9.4,-528
"Halifax County, NC",NC,2013,21772,19276,2496,11.5,-384
"Halifax County, NC",NC,2012,22156,19086,3070,13.9,-306
"Halifax County, NC",NC,2011,22462,19188,3274,14.6,-401
"Halifax County, NC",NC,2010,22863,19530,3333,14.6,0
"Halifax County, VA",VA,2021,14798,14091,707,4.8,-378
"Halifax County, VA",VA,2020,15176,14114,1062,7.0,-582
"Halifax County, VA",VA,2019,15758,15146,612,3.9,457
"Halifax County, VA",VA,2018,15301,14682,619,4.0,-392
"Halifax County, VA",VA,2017,15693,14933,760,4.8,813
"Halifax County, VA",VA,2016,14880,14026,854,5.7,-375
"Halifax County, VA",VA,2015,15255,14299,956,6.3,-343
"Halifax County, VA",VA,2014,15598,14404,1194,7.7,-254
"Halifax County, VA",VA,2013,15852,14434,1418,8.9,-164
"Halifax County, VA",VA,2012,16016,14525,1491,9.3,-316
"Halifax County, VA",VA,2011,16332,14544,1788,10.9,-395
"Halifax County, VA",VA,2010,16727,14644,2083,12.5,0
"Hall County, GA",GA,2021,104792,102000,2792,2.7,2466
"Hall County, GA",GA,2020,102326,97547,4779,4.7,-552
"Hall County, GA",GA,2019,102878,99859,3019,2.9,534
"Hall County, GA",GA,2018,102344,99022,3322,3.2,1002
"Hall County, GA",GA,2017,101342,97352,3990,3.9,5034
"Hall County, GA",GA,2016,96308,91917,4391,4.6,4603
"Hall County, GA",GA,2015,91705,87171,4534,4.9,1781
"Hall County, GA",GA,2014,89924,84604,5320,5.9,532
"Hall County, GA",GA,2013,89392,83308,6084,6.8,564
"Hall County, GA",GA,2012,88828,82015,6813,7.7,1248
"Hall County, GA",GA,2011,87580,79868,7712,8.8,802
"Hall County, GA",GA,2010,86778,78302,8476,9.8,0
"Hall County, NE",NE,2021,32501,31559,942,2.9,286
"Hall County, NE",NE,2020,32215,30403,1812,5.6,-81
"Hall County, NE",NE,2019,32296,31164,1132,3.5,93
"Hall County, NE",NE,2018,32203,31159,1044,3.2,316
"Hall County, NE",NE,2017,31887,30781,1106,3.5,306
"Hall County, NE",NE,2016,31581,30429,1152,3.6,-136
"Hall County, NE",NE,2015,31717,30471,1246,3.9,-700
"Hall County, NE",NE,2014,32417,31160,1257,3.9,-59
"Hall County, NE",NE,2013,32476,31297,1179,3.6,-111
"Hall County, NE",NE,2012,32587,31326,1261,3.9,562
"Hall County, NE",NE,2011,32025,30589,1436,4.5,549
"Hall County, NE",NE,2010,31476,29986,1490,4.7,0
"Hall County, TX",TX,2021,1087,1028,59,5.4,30
"Hall County, TX",TX,2020,1057,996,61,5.8,1
"Hall County, TX",TX,2019,1056,1012,44,4.2,-43
"Hall County, TX",TX,2018,1099,1050,49,4.5,-22
"Hall County, TX",TX,2017,1121,1052,69,6.2,-45
"Hall County, TX",TX,2016,1166,1088,78,6.7,-38
"Hall County, TX",TX,2015,1204,1139,65,5.4,-58
"Hall County, TX",TX,2014,1262,1182,80,6.3,-26
"Hall County, TX",TX,2013,1288,1196,92,7.1,-52
"Hall County, TX",TX,2012,1340,1236,104,7.8,-60
"Hall County, TX",TX,2011,1400,1275,125,8.9,-23
"Hall County, TX",TX,2010,1423,1293,130,9.1,0
"Hamblen County, TN",TN,2021,27883,26771,1112,4.0,-54
"Hamblen County, TN",TN,2020,27937,25970,1967,7.0,-322
"Hamblen County, TN",TN,2019,28259,27167,1092,3.9,659
"Hamblen County, TN",TN,2018,27600,26546,1054,3.8,278
"Hamblen County, TN",TN,2017,27322,26215,1107,4.1,455
"Hamblen County, TN",TN,2016,26867,25489,1378,5.1,350
"Hamblen County, TN",TN,2015,26517,24885,1632,6.2,116
"Hamblen County, TN",TN,2014,26401,24445,1956,7.4,-655
"Hamblen County, TN",TN,2013,27056,24599,2457,9.1,-518
"Hamblen County, TN",TN,2012,27574,24935,2639,9.6,-683
"Hamblen County, TN",TN,2011,28257,25144,3113,11.0,-181
"Hamblen County, TN",TN,2010,28438,25093,3345,11.8,0
"Hamilton County, FL",FL,2021,4137,3887,250,6.0,-73
"Hamilton County, FL",FL,2020,4210,3856,354,8.4,-60
"Hamilton County, FL",FL,2019,4270,4089,181,4.2,-68
"Hamilton County, FL",FL,2018,4338,4151,187,4.3,59
"Hamilton County, FL",FL,2017,4279,4069,210,4.9,-394
"Hamilton County, FL",FL,2016,4673,4406,267,5.7,133
"Hamilton County, FL",FL,2015,4540,4243,297,6.5,-62
"Hamilton County, FL",FL,2014,4602,4241,361,7.8,-23
"Hamilton County, FL",FL,2013,4625,4211,414,9.0,-517
"Hamilton County, FL",FL,2012,5142,4673,469,9.1,273
"Hamilton County, FL",FL,2011,4869,4364,505,10.4,103
"Hamilton County, FL",FL,2010,4766,4238,528,11.1,0
"Hamilton County, IA",IA,2021,6826,6538,288,4.2,-2
"Hamilton County, IA",IA,2020,6828,6534,294,4.3,-215
"Hamilton County, IA",IA,2019,7043,6854,189,2.7,-3
"Hamilton County, IA",IA,2018,7046,6857,189,2.7,-84
"Hamilton County, IA",IA,2017,7130,6903,227,3.2,-48
"Hamilton County, IA",IA,2016,7178,6910,268,3.7,-50
"Hamilton County, IA",IA,2015,7228,6924,304,4.2,130
"Hamilton County, IA",IA,2014,7098,6777,321,4.5,49
"Hamilton County, IA",IA,2013,7049,6664,385,5.5,-29
"Hamilton County, IA",IA,2012,7078,6587,491,6.9,-429
"Hamilton County, IA",IA,2011,7507,6833,674,9.0,-559
"Hamilton County, IA",IA,2010,8066,7468,598,7.4,0
"Hamilton County, IL",IL,2021,4208,4025,183,4.3,7
"Hamilton County, IL",IL,2020,4201,3918,283,6.7,-228
"Hamilton County, IL",IL,2019,4429,4265,164,3.7,-58
"Hamilton County, IL",IL,2018,4487,4291,196,4.4,19
"Hamilton County, IL",IL,2017,4468,4268,200,4.5,195
"Hamilton County, IL",IL,2016,4273,4007,266,6.2,-111
"Hamilton County, IL",IL,2015,4384,4143,241,5.5,52
"Hamilton County, IL",IL,2014,4332,4072,260,6.0,248
"Hamilton County, IL",IL,2013,4084,3767,317,7.8,177
"Hamilton County, IL",IL,2012,3907,3594,313,8.0,-7
"Hamilton County, IL",IL,2011,3914,3575,339,8.7,-93
"Hamilton County, IL",IL,2010,4007,3626,381,9.5,0
"Hamilton County, IN",IN,2021,188744,184603,4141,2.2,3795
"Hamilton County, IN",IN,2020,184949,176246,8703,4.7,-3334
"Hamilton County, IN",IN,2019,188283,183590,4693,2.5,5035
"Hamilton County, IN",IN,2018,183248,178344,4904,2.7,4907
"Hamilton County, IN",IN,2017,178341,173483,4858,2.7,3655
"Hamilton County, IN",IN,2016,174686,169167,5519,3.2,7455
"Hamilton County, IN",IN,2015,167231,161612,5619,3.4,6041
"Hamilton County, IN",IN,2014,161190,154656,6534,4.1,5097
"Hamilton County, IN",IN,2013,156093,148370,7723,4.9,4773
"Hamilton County, IN",IN,2012,151320,143404,7916,5.2,2759
"Hamilton County, IN",IN,2011,148561,140111,8450,5.7,3502
"Hamilton County, IN",IN,2010,145059,135598,9461,6.5,0
"Hamilton County, KS",KS,2021,1620,1598,22,1.4,5
"Hamilton County, KS",KS,2020,1615,1590,25,1.5,13
"Hamilton County, KS",KS,2019,1602,1573,29,1.8,-29
"Hamilton County, KS",KS,2018,1631,1600,31,1.9,-8
"Hamilton County, KS",KS,2017,1639,1600,39,2.4,-11
"Hamilton County, KS",KS,2016,1650,1606,44,2.7,-7
"Hamilton County, KS",KS,2015,1657,1624,33,2.0,-7
"Hamilton County, KS",KS,2014,1664,1626,38,2.3,-55
"Hamilton County, KS",KS,2013,1719,1670,49,2.9,-113
"Hamilton County, KS",KS,2012,1832,1783,49,2.7,76
"Hamilton County, KS",KS,2011,1756,1707,49,2.8,-69
"Hamilton County, KS",KS,2010,1825,1769,56,3.1,0
"Hamilton County, NE",NE,2021,4856,4754,102,2.1,78
"Hamilton County, NE",NE,2020,4778,4604,174,3.6,-87
"Hamilton County, NE",NE,2019,4865,4719,146,3.0,72
"Hamilton County, NE",NE,2018,4793,4672,121,2.5,68
"Hamilton County, NE",NE,2017,4725,4605,120,2.5,46
"Hamilton County, NE",NE,2016,4679,4549,130,2.8,-11
"Hamilton County, NE",NE,2015,4690,4556,134,2.9,-76
"Hamilton County, NE",NE,2014,4766,4624,142,3.0,-72
"Hamilton County, NE",NE,2013,4838,4687,151,3.1,4
"Hamilton County, NE",NE,2012,4834,4677,157,3.2,0
"Hamilton County, NE",NE,2011,4834,4651,183,3.8,35
"Hamilton County, NE",NE,2010,4799,4615,184,3.8,0
"Hamilton County, NY",NY,2021,2210,2112,98,4.4,18
"Hamilton County, NY",NY,2020,2192,2023,169,7.7,-74
"Hamilton County, NY",NY,2019,2266,2136,130,5.7,-71
"Hamilton County, NY",NY,2018,2337,2178,159,6.8,-22
"Hamilton County, NY",NY,2017,2359,2186,173,7.3,-7
"Hamilton County, NY",NY,2016,2366,2210,156,6.6,-64
"Hamilton County, NY",NY,2015,2430,2265,165,6.8,3
"Hamilton County, NY",NY,2014,2427,2245,182,7.5,-3
"Hamilton County, NY",NY,2013,2430,2191,239,9.8,-18
"Hamilton County, NY",NY,2012,2448,2181,267,10.9,0
"Hamilton County, NY",NY,2011,2448,2203,245,10.0,-58
"Hamilton County, NY",NY,2010,2506,2254,252,10.1,0
"Hamilton County, OH",OH,2021,415153,394977,20176,4.9,2673
"Hamilton County, OH",OH,2020,412480,380073,32407,7.9,-7422
"Hamilton County, OH",OH,2019,419902,403800,16102,3.8,5200
"Hamilton County, OH",OH,2018,414702,397694,17008,4.1,1861
"Hamilton County, OH",OH,2017,412841,394770,18071,4.4,6299
"Hamilton County, OH",OH,2016,406542,388426,18116,4.5,3765
"Hamilton County, OH",OH,2015,402777,384465,18312,4.5,247
"Hamilton County, OH",OH,2014,402530,380542,21988,5.5,378
"Hamilton County, OH",OH,2013,402152,372904,29248,7.3,-34
"Hamilton County, OH",OH,2012,402186,372577,29609,7.4,-4170
"Hamilton County, OH",OH,2011,406356,370436,35920,8.8,-7965
"Hamilton County, OH",OH,2010,414321,373434,40887,9.9,0
"Hamilton County, TN",TN,2021,184161,176741,7420,4.0,1119
"Hamilton County, TN",TN,2020,183042,170177,12865,7.0,-2584
"Hamilton County, TN",TN,2019,185626,179605,6021,3.2,4403
"Hamilton County, TN",TN,2018,181223,175103,6120,3.4,4484
"Hamilton County, TN",TN,2017,176739,170280,6459,3.7,4728
"Hamilton County, TN",TN,2016,172011,164062,7949,4.6,4335
"Hamilton County, TN",TN,2015,167676,158840,8836,5.3,2626
"Hamilton County, TN",TN,2014,165050,154791,10259,6.2,-3926
"Hamilton County, TN",TN,2013,168976,156817,12159,7.2,-1774
"Hamilton County, TN",TN,2012,170750,158780,11970,7.0,-495
"Hamilton County, TN",TN,2011,171245,157758,13487,7.9,2121
"Hamilton County, TN",TN,2010,169124,154795,14329,8.5,0
"Hamilton County, TX",TX,2021,3792,3638,154,4.1,83
"Hamilton County, TX",TX,2020,3709,3540,169,4.6,74
"Hamilton County, TX",TX,2019,3635,3527,108,3.0,36
"Hamilton County, TX",TX,2018,3599,3480,119,3.3,4
"Hamilton County, TX",TX,2017,3595,3452,143,4.0,-7
"Hamilton County, TX",TX,2016,3602,3425,177,4.9,117
"Hamilton County, TX",TX,2015,3485,3321,164,4.7,-77
"Hamilton County, TX",TX,2014,3562,3395,167,4.7,-53
"Hamilton County, TX",TX,2013,3615,3397,218,6.0,-127
"Hamilton County, TX",TX,2012,3742,3525,217,5.8,-134
"Hamilton County, TX",TX,2011,3876,3622,254,6.6,-69
"Hamilton County, TX",TX,2010,3945,3675,270,6.8,0
"Hamlin County, SD",SD,2021,3454,3371,83,2.4,110
"Hamlin County, SD",SD,2020,3344,3236,108,3.2,44
"Hamlin County, SD",SD,2019,3300,3207,93,2.8,67
"Hamlin County, SD",SD,2018,3233,3139,94,2.9,88
"Hamlin County, SD",SD,2017,3145,3039,106,3.4,-45
"Hamlin County, SD",SD,2016,3190,3082,108,3.4,38
"Hamlin County, SD",SD,2015,3152,3049,103,3.3,3
"Hamlin County, SD",SD,2014,3149,3044,105,3.3,12
"Hamlin County, SD",SD,2013,3137,3031,106,3.4,-22
"Hamlin County, SD",SD,2012,3159,3041,118,3.7,30
"Hamlin County, SD",SD,2011,3129,2994,135,4.3,-20
"Hamlin County, SD",SD,2010,3149,2994,155,4.9,0
"Hampden County, MA",MA,2021,227099,209942,17157,7.6,1104
"Hampden County, MA",MA,2020,225995,201171,24824,11.0,-4953
"Hampden County, MA",MA,2019,230948,220973,9975,4.3,-838
"Hampden County, MA",MA,2018,231786,220751,11035,4.8,4221
"Hampden County, MA",MA,2017,227565,215770,11795,5.2,5337
"Hampden County, MA",MA,2016,222228,210141,12087,5.4,-484
"Hampden County, MA",MA,2015,222712,208496,14216,6.4,373
"Hampden County, MA",MA,2014,222339,205495,16844,7.6,1974
"Hampden County, MA",MA,2013,220365,201484,18881,8.6,-185
"Hampden County, MA",MA,2012,220550,201584,18966,8.6,491
"Hampden County, MA",MA,2011,220059,199625,20434,9.3,-815
"Hampden County, MA",MA,2010,220874,198838,22036,10.0,0
"Hampshire County, MA",MA,2021,89375,85206,4169,4.7,1015
"Hampshire County, MA",MA,2020,88360,81642,6718,7.6,-3241
"Hampshire County, MA",MA,2019,91601,88994,2607,2.8,271
"Hampshire County, MA",MA,2018,91330,88479,2851,3.1,1352
"Hampshire County, MA",MA,2017,89978,86809,3169,3.5,1899
"Hampshire County, MA",MA,2016,88079,84767,3312,3.8,703
"Hampshire County, MA",MA,2015,87376,83446,3930,4.5,306
"Hampshire County, MA",MA,2014,87070,82492,4578,5.3,1551
"Hampshire County, MA",MA,2013,85519,80401,5118,6.0,-268
"Hampshire County, MA",MA,2012,85787,80787,5000,5.8,440
"Hampshire County, MA",MA,2011,85347,80101,5246,6.1,-247
"Hampshire County, MA",MA,2010,85594,79777,5817,6.8,0
"Hampshire County, WV",WV,2021,11043,10670,373,3.4,394
"Hampshire County, WV",WV,2020,10649,10076,573,5.4,-33
"Hampshire County, WV",WV,2019,10682,10266,416,3.9,183
"Hampshire County, WV",WV,2018,10499,10057,442,4.2,105
"Hampshire County, WV",WV,2017,10394,9986,408,3.9,467
"Hampshire County, WV",WV,2016,9927,9495,432,4.4,188
"Hampshire County, WV",WV,2015,9739,9209,530,5.4,239
"Hampshire County, WV",WV,2014,9500,8911,589,6.2,-82
"Hampshire County, WV",WV,2013,9582,8918,664,6.9,-152
"Hampshire County, WV",WV,2012,9734,8989,745,7.7,-55
"Hampshire County, WV",WV,2011,9789,8950,839,8.6,37
"Hampshire County, WV",WV,2010,9752,8864,888,9.1,0
"Hampton city, VA",VA,2021,62844,59278,3566,5.7,-2141
"Hampton city, VA",VA,2020,64985,59493,5492,8.5,-533
"Hampton city, VA",VA,2019,65518,63068,2450,3.7,630
"Hampton city, VA",VA,2018,64888,62286,2602,4.0,-155
"Hampton city, VA",VA,2017,65043,61795,3248,5.0,1014
"Hampton city, VA",VA,2016,64029,60438,3591,5.6,-472
"Hampton city, VA",VA,2015,64501,60682,3819,5.9,-1292
"Hampton city, VA",VA,2014,65793,61431,4362,6.6,-37
"Hampton city, VA",VA,2013,65830,61010,4820,7.3,-27
"Hampton city, VA",VA,2012,65857,60530,5327,8.1,-483
"Hampton city, VA",VA,2011,66340,60425,5915,8.9,-442
"Hampton city, VA",VA,2010,66782,60658,6124,9.2,0
"Hampton County, SC",SC,2021,8019,7734,285,3.6,44
"Hampton County, SC",SC,2020,7975,7594,381,4.8,-211
"Hampton County, SC",SC,2019,8186,7971,215,2.6,44
"Hampton County, SC",SC,2018,8142,7868,274,3.4,198
"Hampton County, SC",SC,2017,7944,7597,347,4.4,-259
"Hampton County, SC",SC,2016,8203,7734,469,5.7,-137
"Hampton County, SC",SC,2015,8340,7647,693,8.3,31
"Hampton County, SC",SC,2014,8309,7685,624,7.5,-60
"Hampton County, SC",SC,2013,8369,7611,758,9.1,-62
"Hampton County, SC",SC,2012,8431,7508,923,10.9,-239
"Hampton County, SC",SC,2011,8670,7561,1109,12.8,-195
"Hampton County, SC",SC,2010,8865,7713,1152,13.0,0
"Hancock County, GA",GA,2021,2530,2369,161,6.4,-10
"Hancock County, GA",GA,2020,2540,2317,223,8.8,22
"Hancock County, GA",GA,2019,2518,2372,146,5.8,43
"Hancock County, GA",GA,2018,2475,2326,149,6.0,-79
"Hancock County, GA",GA,2017,2554,2372,182,7.1,22
"Hancock County, GA",GA,2016,2532,2317,215,8.5,71
"Hancock County, GA",GA,2015,2461,2216,245,10.0,-59
"Hancock County, GA",GA,2014,2520,2224,296,11.7,-117
"Hancock County, GA",GA,2013,2637,2252,385,14.6,-108
"Hancock County, GA",GA,2012,2745,2285,460,16.8,-207
"Hancock County, GA",GA,2011,2952,2372,580,19.6,-167
"Hancock County, GA",GA,2010,3119,2396,723,23.2,0
"Hancock County, IA",IA,2021,5718,5500,218,3.8,-78
"Hancock County, IA",IA,2020,5796,5533,263,4.5,-222
"Hancock County, IA",IA,2019,6018,5881,137,2.3,-40
"Hancock County, IA",IA,2018,6058,5918,140,2.3,-133
"Hancock County, IA",IA,2017,6191,6033,158,2.6,-233
"Hancock County, IA",IA,2016,6424,6252,172,2.7,57
"Hancock County, IA",IA,2015,6367,6196,171,2.7,70
"Hancock County, IA",IA,2014,6297,6090,207,3.3,79
"Hancock County, IA",IA,2013,6218,5969,249,4.0,213
"Hancock County, IA",IA,2012,6005,5730,275,4.6,42
"Hancock County, IA",IA,2011,5963,5624,339,5.7,-93
"Hancock County, IA",IA,2010,6056,5646,410,6.8,0
"Hancock County, IL",IL,2021,8079,7731,348,4.3,15
"Hancock County, IL",IL,2020,8064,7496,568,7.0,-355
"Hancock County, IL",IL,2019,8419,8041,378,4.5,-99
"Hancock County, IL",IL,2018,8518,8122,396,4.6,-14
"Hancock County, IL",IL,2017,8532,8093,439,5.1,-336
"Hancock County, IL",IL,2016,8868,8289,579,6.5,-60
"Hancock County, IL",IL,2015,8928,8376,552,6.2,47
"Hancock County, IL",IL,2014,8881,8302,579,6.5,-8
"Hancock County, IL",IL,2013,8889,8138,751,8.4,-346
"Hancock County, IL",IL,2012,9235,8465,770,8.3,-388
"Hancock County, IL",IL,2011,9623,8739,884,9.2,-316
"Hancock County, IL",IL,2010,9939,8882,1057,10.6,0
"Hancock County, IN",IN,2021,41318,40259,1059,2.6,551
"Hancock County, IN",IN,2020,40767,38451,2316,5.7,-476
"Hancock County, IN",IN,2019,41243,40094,1149,2.8,1057
"Hancock County, IN",IN,2018,40186,38982,1204,3.0,1043
"Hancock County, IN",IN,2017,39143,37972,1171,3.0,416
"Hancock County, IN",IN,2016,38727,37281,1446,3.7,1360
"Hancock County, IN",IN,2015,37367,35800,1567,4.2,741
"Hancock County, IN",IN,2014,36626,34737,1889,5.2,493
"Hancock County, IN",IN,2013,36133,33780,2353,6.5,370
"Hancock County, IN",IN,2012,35763,33179,2584,7.2,-108
"Hancock County, IN",IN,2011,35871,32988,2883,8.0,52
"Hancock County, IN",IN,2010,35819,32597,3222,9.0,0
"Hancock County, KY",KY,2021,3848,3680,168,4.4,36
"Hancock County, KY",KY,2020,3812,3587,225,5.9,-122
"Hancock County, KY",KY,2019,3934,3789,145,3.7,-59
"Hancock County, KY",KY,2018,3993,3828,165,4.1,-113
"Hancock County, KY",KY,2017,4106,3902,204,5.0,66
"Hancock County, KY",KY,2016,4040,3826,214,5.3,152
"Hancock County, KY",KY,2015,3888,3697,191,4.9,-94
"Hancock County, KY",KY,2014,3982,3743,239,6.0,-119
"Hancock County, KY",KY,2013,4101,3807,294,7.2,-51
"Hancock County, KY",KY,2012,4152,3853,299,7.2,63
"Hancock County, KY",KY,2011,4089,3748,341,8.3,8
"Hancock County, KY",KY,2010,4081,3658,423,10.4,0
"Hancock County, ME",ME,2021,28376,26953,1423,5.0,666
"Hancock County, ME",ME,2020,27710,26239,1471,5.3,-1745
"Hancock County, ME",ME,2019,29455,28517,938,3.2,-223
"Hancock County, ME",ME,2018,29678,28646,1032,3.5,125
"Hancock County, ME",ME,2017,29553,28403,1150,3.9,308
"Hancock County, ME",ME,2016,29245,27934,1311,4.5,-5
"Hancock County, ME",ME,2015,29250,27616,1634,5.6,-599
"Hancock County, ME",ME,2014,29849,27836,2013,6.7,-198
"Hancock County, ME",ME,2013,30047,27666,2381,7.9,182
"Hancock County, ME",ME,2012,29865,27383,2482,8.3,-207
"Hancock County, ME",ME,2011,30072,27465,2607,8.7,131
"Hancock County, ME",ME,2010,29941,27201,2740,9.2,0
"Hancock County, MS",MS,2021,19045,17931,1114,5.8,479
"Hancock County, MS",MS,2020,18566,17037,1529,8.2,-275
"Hancock County, MS",MS,2019,18841,17775,1066,5.7,195
"Hancock County, MS",MS,2018,18646,17670,976,5.2,-41
"Hancock County, MS",MS,2017,18687,17620,1067,5.7,-101
"Hancock County, MS",MS,2016,18788,17620,1168,6.2,169
"Hancock County, MS",MS,2015,18619,17396,1223,6.6,204
"Hancock County, MS",MS,2014,18415,17070,1345,7.3,-524
"Hancock County, MS",MS,2013,18939,17461,1478,7.8,-868
"Hancock County, MS",MS,2012,19807,18167,1640,8.3,-304
"Hancock County, MS",MS,2011,20111,18246,1865,9.3,411
"Hancock County, MS",MS,2010,19700,17980,1720,8.7,0
"Hancock County, OH",OH,2021,41002,39311,1691,4.1,-422
"Hancock County, OH",OH,2020,41424,38600,2824,6.8,-821
"Hancock County, OH",OH,2019,42245,40895,1350,3.2,687
"Hancock County, OH",OH,2018,41558,40143,1415,3.4,-273
"Hancock County, OH",OH,2017,41831,40322,1509,3.6,206
"Hancock County, OH",OH,2016,41625,40080,1545,3.7,738
"Hancock County, OH",OH,2015,40887,39373,1514,3.7,336
"Hancock County, OH",OH,2014,40551,38747,1804,4.4,379
"Hancock County, OH",OH,2013,40172,37680,2492,6.2,365
"Hancock County, OH",OH,2012,39807,37264,2543,6.4,-159
"Hancock County, OH",OH,2011,39966,36861,3105,7.8,-548
"Hancock County, OH",OH,2010,40514,36822,3692,9.1,0
"Hancock County, TN",TN,2021,2253,2144,109,4.8,58
"Hancock County, TN",TN,2020,2195,2016,179,8.2,63
"Hancock County, TN",TN,2019,2132,2007,125,5.9,4
"Hancock County, TN",TN,2018,2128,2025,103,4.8,81
"Hancock County, TN",TN,2017,2047,1928,119,5.8,12
"Hancock County, TN",TN,2016,2035,1873,162,8.0,-33
"Hancock County, TN",TN,2015,2068,1869,199,9.6,-6
"Hancock County, TN",TN,2014,2074,1870,204,9.8,-79
"Hancock County, TN",TN,2013,2153,1899,254,11.8,-102
"Hancock County, TN",TN,2012,2255,1985,270,12.0,-170
"Hancock County, TN",TN,2011,2425,2084,341,14.1,-155
"Hancock County, TN",TN,2010,2580,2165,415,16.1,0
"Hancock County, WV",WV,2021,13098,12277,821,6.3,116
"Hancock County, WV",WV,2020,12982,11712,1270,9.8,-117
"Hancock County, WV",WV,2019,13099,12421,678,5.2,89
"Hancock County, WV",WV,2018,13010,12255,755,5.8,114
"Hancock County, WV",WV,2017,12896,12114,782,6.1,-3
"Hancock County, WV",WV,2016,12899,11995,904,7.0,-248
"Hancock County, WV",WV,2015,13147,12146,1001,7.6,-106
"Hancock County, WV",WV,2014,13253,12209,1044,7.9,-156
"Hancock County, WV",WV,2013,13409,12333,1076,8.0,-334
"Hancock County, WV",WV,2012,13743,12512,1231,9.0,-134
"Hancock County, WV",WV,2011,13877,12443,1434,10.3,-283
"Hancock County, WV",WV,2010,14160,12439,1721,12.2,0
"Hand County, SD",SD,2021,1750,1707,43,2.5,11
"Hand County, SD",SD,2020,1739,1696,43,2.5,-23
"Hand County, SD",SD,2019,1762,1721,41,2.3,-42
"Hand County, SD",SD,2018,1804,1766,38,2.1,-17
"Hand County, SD",SD,2017,1821,1780,41,2.3,-20
"Hand County, SD",SD,2016,1841,1801,40,2.2,-45
"Hand County, SD",SD,2015,1886,1843,43,2.3,46
"Hand County, SD",SD,2014,1840,1794,46,2.5,0
"Hand County, SD",SD,2013,1840,1790,50,2.7,-13
"Hand County, SD",SD,2012,1853,1799,54,2.9,-29
"Hand County, SD",SD,2011,1882,1821,61,3.2,-32
"Hand County, SD",SD,2010,1914,1852,62,3.2,0
"Hanover County, VA",VA,2021,56895,55208,1687,3.0,-1161
"Hanover County, VA",VA,2020,58056,55260,2796,4.8,-2099
"Hanover County, VA",VA,2019,60155,58713,1442,2.4,783
"Hanover County, VA",VA,2018,59372,57837,1535,2.6,693
"Hanover County, VA",VA,2017,58679,56750,1929,3.3,1424
"Hanover County, VA",VA,2016,57255,55280,1975,3.4,790
"Hanover County, VA",VA,2015,56465,54307,2158,3.8,468
"Hanover County, VA",VA,2014,55997,53492,2505,4.5,568
"Hanover County, VA",VA,2013,55429,52693,2736,4.9,353
"Hanover County, VA",VA,2012,55076,52100,2976,5.4,204
"Hanover County, VA",VA,2011,54872,51605,3267,6.0,372
"Hanover County, VA",VA,2010,54500,50830,3670,6.7,0
"Hansford County, TX",TX,2021,2551,2474,77,3.0,92
"Hansford County, TX",TX,2020,2459,2373,86,3.5,-276
"Hansford County, TX",TX,2019,2735,2670,65,2.4,-91
"Hansford County, TX",TX,2018,2826,2760,66,2.3,-14
"Hansford County, TX",TX,2017,2840,2767,73,2.6,-106
"Hansford County, TX",TX,2016,2946,2854,92,3.1,-167
"Hansford County, TX",TX,2015,3113,3020,93,3.0,-123
"Hansford County, TX",TX,2014,3236,3153,83,2.6,114
"Hansford County, TX",TX,2013,3122,3019,103,3.3,74
"Hansford County, TX",TX,2012,3048,2945,103,3.4,7
"Hansford County, TX",TX,2011,3041,2913,128,4.2,7
"Hansford County, TX",TX,2010,3034,2902,132,4.4,0
"Hanson County, SD",SD,2021,1757,1687,70,4.0,8
"Hanson County, SD",SD,2020,1749,1665,84,4.8,-17
"Hanson County, SD",SD,2019,1766,1695,71,4.0,24
"Hanson County, SD",SD,2018,1742,1667,75,4.3,-27
"Hanson County, SD",SD,2017,1769,1702,67,3.8,-9
"Hanson County, SD",SD,2016,1778,1717,61,3.4,-31
"Hanson County, SD",SD,2015,1809,1750,59,3.3,-13
"Hanson County, SD",SD,2014,1822,1760,62,3.4,6
"Hanson County, SD",SD,2013,1816,1742,74,4.1,-13
"Hanson County, SD",SD,2012,1829,1748,81,4.4,10
"Hanson County, SD",SD,2011,1819,1733,86,4.7,42
"Hanson County, SD",SD,2010,1777,1685,92,5.2,0
"Haralson County, GA",GA,2021,12750,12303,447,3.5,381
"Haralson County, GA",GA,2020,12369,11651,718,5.8,-222
"Haralson County, GA",GA,2019,12591,12151,440,3.5,64
"Haralson County, GA",GA,2018,12527,12038,489,3.9,23
"Haralson County, GA",GA,2017,12504,11901,603,4.8,345
"Haralson County, GA",GA,2016,12159,11445,714,5.9,423
"Haralson County, GA",GA,2015,11736,10955,781,6.7,-120
"Haralson County, GA",GA,2014,11856,10912,944,8.0,-96
"Haralson County, GA",GA,2013,11952,10851,1101,9.2,-106
"Haralson County, GA",GA,2012,12058,10841,1217,10.1,-175
"Haralson County, GA",GA,2011,12233,10822,1411,11.5,-189
"Haralson County, GA",GA,2010,12422,10879,1543,12.4,0
"Hardee County, FL",FL,2021,8895,8471,424,4.8,429
"Hardee County, FL",FL,2020,8466,7871,595,7.0,164
"Hardee County, FL",FL,2019,8302,7870,432,5.2,-440
"Hardee County, FL",FL,2018,8742,8272,470,5.4,-156
"Hardee County, FL",FL,2017,8898,8367,531,6.0,-389
"Hardee County, FL",FL,2016,9287,8664,623,6.7,-844
"Hardee County, FL",FL,2015,10131,9416,715,7.1,-201
"Hardee County, FL",FL,2014,10332,9516,816,7.9,-696
"Hardee County, FL",FL,2013,11028,10080,948,8.6,-741
"Hardee County, FL",FL,2012,11769,10690,1079,9.2,-82
"Hardee County, FL",FL,2011,11851,10658,1193,10.1,187
"Hardee County, FL",FL,2010,11664,10359,1305,11.2,0
"Hardeman County, TN",TN,2021,8964,8423,541,6.0,-322
"Hardeman County, TN",TN,2020,9286,8556,730,7.9,-230
"Hardeman County, TN",TN,2019,9516,9041,475,5.0,131
"Hardeman County, TN",TN,2018,9385,8926,459,4.9,163
"Hardeman County, TN",TN,2017,9222,8742,480,5.2,21
"Hardeman County, TN",TN,2016,9201,8633,568,6.2,-106
"Hardeman County, TN",TN,2015,9307,8613,694,7.5,-290
"Hardeman County, TN",TN,2014,9597,8702,895,9.3,-217
"Hardeman County, TN",TN,2013,9814,8728,1086,11.1,-175
"Hardeman County, TN",TN,2012,9989,8883,1106,11.1,-167
"Hardeman County, TN",TN,2011,10156,8910,1246,12.3,-210
"Hardeman County, TN",TN,2010,10366,8972,1394,13.4,0
"Hardeman County, TX",TX,2021,1722,1648,74,4.3,30
"Hardeman County, TX",TX,2020,1692,1618,74,4.4,-8
"Hardeman County, TX",TX,2019,1700,1649,51,3.0,39
"Hardeman County, TX",TX,2018,1661,1601,60,3.6,15
"Hardeman County, TX",TX,2017,1646,1580,66,4.0,21
"Hardeman County, TX",TX,2016,1625,1561,64,3.9,4
"Hardeman County, TX",TX,2015,1621,1541,80,4.9,-25
"Hardeman County, TX",TX,2014,1646,1564,82,5.0,-49
"Hardeman County, TX",TX,2013,1695,1596,99,5.8,-64
"Hardeman County, TX",TX,2012,1759,1656,103,5.9,-115
"Hardeman County, TX",TX,2011,1874,1737,137,7.3,-70
"Hardeman County, TX",TX,2010,1944,1781,163,8.4,0
"Hardin County, IA",IA,2021,7790,7466,324,4.2,-45
"Hardin County, IA",IA,2020,7835,7481,354,4.5,-438
"Hardin County, IA",IA,2019,8273,8023,250,3.0,-90
"Hardin County, IA",IA,2018,8363,8125,238,2.8,-158
"Hardin County, IA",IA,2017,8521,8253,268,3.1,-96
"Hardin County, IA",IA,2016,8617,8285,332,3.9,-198
"Hardin County, IA",IA,2015,8815,8470,345,3.9,107
"Hardin County, IA",IA,2014,8708,8333,375,4.3,0
"Hardin County, IA",IA,2013,8708,8264,444,5.1,-85
"Hardin County, IA",IA,2012,8793,8321,472,5.4,-232
"Hardin County, IA",IA,2011,9025,8486,539,6.0,-85
"Hardin County, IA",IA,2010,9110,8506,604,6.6,0
"Hardin County, IL",IL,2021,1322,1233,89,6.7,34
"Hardin County, IL",IL,2020,1288,1166,122,9.5,-18
"Hardin County, IL",IL,2019,1306,1225,81,6.2,-28
"Hardin County, IL",IL,2018,1334,1235,99,7.4,-19
"Hardin County, IL",IL,2017,1353,1250,103,7.6,-47
"Hardin County, IL",IL,2016,1400,1269,131,9.4,-131
"Hardin County, IL",IL,2015,1531,1401,130,8.5,-108
"Hardin County, IL",IL,2014,1639,1495,144,8.8,-93
"Hardin County, IL",IL,2013,1732,1536,196,11.3,4
"Hardin County, IL",IL,2012,1728,1545,183,10.6,-21
"Hardin County, IL",IL,2011,1749,1560,189,10.8,-42
"Hardin County, IL",IL,2010,1791,1596,195,10.9,0
"Hardin County, KY",KY,2021,47078,44845,2233,4.7,-580
"Hardin County, KY",KY,2020,47658,44370,3288,6.9,-1580
"Hardin County, KY",KY,2019,49238,47315,1923,3.9,337
"Hardin County, KY",KY,2018,48901,46956,1945,4.0,148
"Hardin County, KY",KY,2017,48753,46563,2190,4.5,953
"Hardin County, KY",KY,2016,47800,45688,2112,4.4,1209
"Hardin County, KY",KY,2015,46591,44310,2281,4.9,-38
"Hardin County, KY",KY,2014,46629,43744,2885,6.2,-1201
"Hardin County, KY",KY,2013,47830,44198,3632,7.6,231
"Hardin County, KY",KY,2012,47599,43681,3918,8.2,36
"Hardin County, KY",KY,2011,47563,43199,4364,9.2,418
"Hardin County, KY",KY,2010,47145,42536,4609,9.8,0
"Hardin County, OH",OH,2021,13677,12972,705,5.2,-240
"Hardin County, OH",OH,2020,13917,12789,1128,8.1,-102
"Hardin County, OH",OH,2019,14019,13427,592,4.2,-67
"Hardin County, OH",OH,2018,14086,13472,614,4.4,-343
"Hardin County, OH",OH,2017,14429,13717,712,4.9,-5
"Hardin County, OH",OH,2016,14434,13709,725,5.0,-110
"Hardin County, OH",OH,2015,14544,13835,709,4.9,-603
"Hardin County, OH",OH,2014,15147,14282,865,5.7,223
"Hardin County, OH",OH,2013,14924,13776,1148,7.7,29
"Hardin County, OH",OH,2012,14895,13785,1110,7.5,-164
"Hardin County, OH",OH,2011,15059,13626,1433,9.5,-442
"Hardin County, OH",OH,2010,15501,13762,1739,11.2,0
"Hardin County, TN",TN,2021,10193,9735,458,4.5,-67
"Hardin County, TN",TN,2020,10260,9553,707,6.9,-139
"Hardin County, TN",TN,2019,10399,9955,444,4.3,47
"Hardin County, TN",TN,2018,10352,9899,453,4.4,-54
"Hardin County, TN",TN,2017,10406,9914,492,4.7,195
"Hardin County, TN",TN,2016,10211,9599,612,6.0,-71
"Hardin County, TN",TN,2015,10282,9549,733,7.1,-211
"Hardin County, TN",TN,2014,10493,9547,946,9.0,-522
"Hardin County, TN",TN,2013,11015,9879,1136,10.3,-124
"Hardin County, TN",TN,2012,11139,9999,1140,10.2,-292
"Hardin County, TN",TN,2011,11431,10126,1305,11.4,-13
"Hardin County, TN",TN,2010,11444,10043,1401,12.2,0
"Hardin County, TX",TX,2021,24760,22791,1969,8.0,-295
"Hardin County, TX",TX,2020,25055,22819,2236,8.9,-217
"Hardin County, TX",TX,2019,25272,24120,1152,4.6,123
"Hardin County, TX",TX,2018,25149,23836,1313,5.2,30
"Hardin County, TX",TX,2017,25119,23566,1553,6.2,-51
"Hardin County, TX",TX,2016,25170,23636,1534,6.1,168
"Hardin County, TX",TX,2015,25002,23581,1421,5.7,-361
"Hardin County, TX",TX,2014,25363,23751,1612,6.4,108
"Hardin County, TX",TX,2013,25255,23208,2047,8.1,-567
"Hardin County, TX",TX,2012,25822,23653,2169,8.4,-462
"Hardin County, TX",TX,2011,26284,23691,2593,9.9,383
"Hardin County, TX",TX,2010,25901,23305,2596,10.0,0
"Harding County, NM",NM,2021,281,268,13,4.6,5
"Harding County, NM",NM,2020,276,265,11,4.0,6
"Harding County, NM",NM,2019,270,258,12,4.4,-11
"Harding County, NM",NM,2018,281,266,15,5.3,-3
"Harding County, NM",NM,2017,284,267,17,6.0,4
"Harding County, NM",NM,2016,280,260,20,7.1,-8
"Harding County, NM",NM,2015,288,263,25,8.7,-31
"Harding County, NM",NM,2014,319,304,15,4.7,33
"Harding County, NM",NM,2013,286,271,15,5.2,-7
"Harding County, NM",NM,2012,293,275,18,6.1,-2
"Harding County, NM",NM,2011,295,277,18,6.1,2
"Harding County, NM",NM,2010,293,276,17,5.8,0
"Harding County, SD",SD,2021,718,698,20,2.8,2
"Harding County, SD",SD,2020,716,692,24,3.4,-18
"Harding County, SD",SD,2019,734,717,17,2.3,7
"Harding County, SD",SD,2018,727,711,16,2.2,2
"Harding County, SD",SD,2017,725,705,20,2.8,-40
"Harding County, SD",SD,2016,765,743,22,2.9,-20
"Harding County, SD",SD,2015,785,766,19,2.4,5
"Harding County, SD",SD,2014,780,762,18,2.3,1
"Harding County, SD",SD,2013,779,757,22,2.8,-36
"Harding County, SD",SD,2012,815,787,28,3.4,-14
"Harding County, SD",SD,2011,829,797,32,3.9,28
"Harding County, SD",SD,2010,801,773,28,3.5,0
"Hardy County, WV",WV,2021,5672,5393,279,4.9,-74
"Hardy County, WV",WV,2020,5746,5341,405,7.0,-62
"Hardy County, WV",WV,2019,5808,5508,300,5.2,-28
"Hardy County, WV",WV,2018,5836,5519,317,5.4,-104
"Hardy County, WV",WV,2017,5940,5649,291,4.9,204
"Hardy County, WV",WV,2016,5736,5409,327,5.7,203
"Hardy County, WV",WV,2015,5533,5129,404,7.3,133
"Hardy County, WV",WV,2014,5400,4952,448,8.3,-58
"Hardy County, WV",WV,2013,5458,4945,513,9.4,-107
"Hardy County, WV",WV,2012,5565,4994,571,10.3,-120
"Hardy County, WV",WV,2011,5685,5104,581,10.2,-18
"Hardy County, WV",WV,2010,5703,5041,662,11.6,0
"Harford County, MD",MD,2021,139296,132625,6671,4.8,-2084
"Harford County, MD",MD,2020,141380,133250,8130,5.8,-4684
"Harford County, MD",MD,2019,146064,141410,4654,3.2,3891
"Harford County, MD",MD,2018,142173,137414,4759,3.3,2017
"Harford County, MD",MD,2017,140156,134920,5236,3.7,3957
"Harford County, MD",MD,2016,136199,130653,5546,4.1,392
"Harford County, MD",MD,2015,135807,129254,6553,4.8,588
"Harford County, MD",MD,2014,135219,127649,7570,5.6,-455
"Harford County, MD",MD,2013,135674,126915,8759,6.5,56
"Harford County, MD",MD,2012,135618,126328,9290,6.9,1743
"Harford County, MD",MD,2011,133875,124122,9753,7.3,868
"Harford County, MD",MD,2010,133007,122387,10620,8.0,0
"Harlan County, KY",KY,2021,6466,5908,558,8.6,-40
"Harlan County, KY",KY,2020,6506,5764,742,11.4,-221
"Harlan County, KY",KY,2019,6727,6124,603,9.0,191
"Harlan County, KY",KY,2018,6536,6069,467,7.1,62
"Harlan County, KY",KY,2017,6474,5841,633,9.8,-264
"Harlan County, KY",KY,2016,6738,5862,876,13.0,-247
"Harlan County, KY",KY,2015,6985,6107,878,12.6,-1415
"Harlan County, KY",KY,2014,8400,7233,1167,13.9,-1103
"Harlan County, KY",KY,2013,9503,7801,1702,17.9,-429
"Harlan County, KY",KY,2012,9932,8526,1406,14.2,-117
"Harlan County, KY",KY,2011,10049,8929,1120,11.1,-198
"Harlan County, KY",KY,2010,10247,9016,1231,12.0,0
"Harlan County, NE",NE,2021,1797,1763,34,1.9,44
"Harlan County, NE",NE,2020,1753,1704,49,2.8,-47
"Harlan County, NE",NE,2019,1800,1750,50,2.8,11
"Harlan County, NE",NE,2018,1789,1746,43,2.4,0
"Harlan County, NE",NE,2017,1789,1743,46,2.6,22
"Harlan County, NE",NE,2016,1767,1723,44,2.5,-26
"Harlan County, NE",NE,2015,1793,1755,38,2.1,-10
"Harlan County, NE",NE,2014,1803,1756,47,2.6,-54
"Harlan County, NE",NE,2013,1857,1801,56,3.0,-17
"Harlan County, NE",NE,2012,1874,1815,59,3.1,-21
"Harlan County, NE",NE,2011,1895,1833,62,3.3,5
"Harlan County, NE",NE,2010,1890,1828,62,3.3,0
"Harmon County, OK",OK,2021,1184,1154,30,2.5,16
"Harmon County, OK",OK,2020,1168,1126,42,3.6,-6
"Harmon County, OK",OK,2019,1174,1142,32,2.7,-30
"Harmon County, OK",OK,2018,1204,1170,34,2.8,-64
"Harmon County, OK",OK,2017,1268,1222,46,3.6,-24
"Harmon County, OK",OK,2016,1292,1244,48,3.7,-10
"Harmon County, OK",OK,2015,1302,1258,44,3.4,24
"Harmon County, OK",OK,2014,1278,1228,50,3.9,-70
"Harmon County, OK",OK,2013,1348,1291,57,4.2,-61
"Harmon County, OK",OK,2012,1409,1345,64,4.5,94
"Harmon County, OK",OK,2011,1315,1248,67,5.1,2
"Harmon County, OK",OK,2010,1313,1239,74,5.6,0
"Harnett County, NC",NC,2021,52943,50144,2799,5.3,1387
"Harnett County, NC",NC,2020,51556,47823,3733,7.2,-1371
"Harnett County, NC",NC,2019,52927,50521,2406,4.5,789
"Harnett County, NC",NC,2018,52138,49659,2479,4.8,308
"Harnett County, NC",NC,2017,51830,49181,2649,5.1,528
"Harnett County, NC",NC,2016,51302,48328,2974,5.8,1114
"Harnett County, NC",NC,2015,50188,46864,3324,6.6,825
"Harnett County, NC",NC,2014,49363,45824,3539,7.2,-379
"Harnett County, NC",NC,2013,49742,45276,4466,9.0,-421
"Harnett County, NC",NC,2012,50163,44712,5451,10.9,765
"Harnett County, NC",NC,2011,49398,43788,5610,11.4,450
"Harnett County, NC",NC,2010,48948,43463,5485,11.2,0
"Harney County, OR",OR,2021,3761,3568,193,5.1,126
"Harney County, OR",OR,2020,3635,3420,215,5.9,71
"Harney County, OR",OR,2019,3564,3379,185,5.2,56
"Harney County, OR",OR,2018,3508,3303,205,5.8,121
"Harney County, OR",OR,2017,3387,3178,209,6.2,-26
"Harney County, OR",OR,2016,3413,3204,209,6.1,108
"Harney County, OR",OR,2015,3305,3074,231,7.0,7
"Harney County, OR",OR,2014,3298,2987,311,9.4,-48
"Harney County, OR",OR,2013,3346,2964,382,11.4,-190
"Harney County, OR",OR,2012,3536,3120,416,11.8,-195
"Harney County, OR",OR,2011,3731,3230,501,13.4,-120
"Harney County, OR",OR,2010,3851,3299,552,14.3,0
"Harper County, KS",KS,2021,2774,2701,73,2.6,-8
"Harper County, KS",KS,2020,2782,2664,118,4.2,-90
"Harper County, KS",KS,2019,2872,2800,72,2.5,122
"Harper County, KS",KS,2018,2750,2674,76,2.8,93
"Harper County, KS",KS,2017,2657,2559,98,3.7,-237
"Harper County, KS",KS,2016,2894,2791,103,3.6,31
"Harper County, KS",KS,2015,2863,2752,111,3.9,-122
"Harper County, KS",KS,2014,2985,2875,110,3.7,-126
"Harper County, KS",KS,2013,3111,2986,125,4.0,-8
"Harper County, KS",KS,2012,3119,2984,135,4.3,210
"Harper County, KS",KS,2011,2909,2747,162,5.6,-28
"Harper County, KS",KS,2010,2937,2756,181,6.2,0
"Harper County, OK",OK,2021,1789,1745,44,2.5,26
"Harper County, OK",OK,2020,1763,1702,61,3.5,40
"Harper County, OK",OK,2019,1723,1676,47,2.7,-66
"Harper County, OK",OK,2018,1789,1749,40,2.2,-79
"Harper County, OK",OK,2017,1868,1814,54,2.9,-40
"Harper County, OK",OK,2016,1908,1838,70,3.7,-78
"Harper County, OK",OK,2015,1986,1927,59,3.0,15
"Harper County, OK",OK,2014,1971,1918,53,2.7,53
"Harper County, OK",OK,2013,1918,1856,62,3.2,6
"Harper County, OK",OK,2012,1912,1853,59,3.1,46
"Harper County, OK",OK,2011,1866,1800,66,3.5,1
"Harper County, OK",OK,2010,1865,1784,81,4.3,0
"Harris County, GA",GA,2021,16881,16397,484,2.9,36
"Harris County, GA",GA,2020,16845,16087,758,4.5,-104
"Harris County, GA",GA,2019,16949,16409,540,3.2,32
"Harris County, GA",GA,2018,16917,16334,583,3.4,110
"Harris County, GA",GA,2017,16807,16103,704,4.2,741
"Harris County, GA",GA,2016,16066,15271,795,4.9,546
"Harris County, GA",GA,2015,15520,14692,828,5.3,-180
"Harris County, GA",GA,2014,15700,14758,942,6.0,-92
"Harris County, GA",GA,2013,15792,14766,1026,6.5,-431
"Harris County, GA",GA,2012,16223,15072,1151,7.1,-147
"Harris County, GA",GA,2011,16370,15168,1202,7.3,-84
"Harris County, GA",GA,2010,16454,15168,1286,7.8,0
"Harris County, TX",TX,2021,2283959,2136470,147489,6.5,20699
"Harris County, TX",TX,2020,2263260,2060208,203052,9.0,-10912
"Harris County, TX",TX,2019,2274172,2186363,87809,3.9,9549
"Harris County, TX",TX,2018,2264623,2164048,100575,4.4,15583
"Harris County, TX",TX,2017,2249040,2134095,114945,5.1,-2276
"Harris County, TX",TX,2016,2251316,2131125,120191,5.3,15923
"Harris County, TX",TX,2015,2235393,2130793,104600,4.7,8416
"Harris County, TX",TX,2014,2226977,2114484,112493,5.1,32046
"Harris County, TX",TX,2013,2194931,2061042,133889,6.1,43289
"Harris County, TX",TX,2012,2151642,2009784,141858,6.6,41915
"Harris County, TX",TX,2011,2109727,1938837,170890,8.1,42518
"Harris County, TX",TX,2010,2067209,1894670,172539,8.3,0
"Harrison County, IA",IA,2021,7029,6755,274,3.9,3
"Harrison County, IA",IA,2020,7026,6745,281,4.0,-408
"Harrison County, IA",IA,2019,7434,7259,175,2.4,73
"Harrison County, IA",IA,2018,7361,7197,164,2.2,-13
"Harrison County, IA",IA,2017,7374,7175,199,2.7,-115
"Harrison County, IA",IA,2016,7489,7238,251,3.4,-49
"Harrison County, IA",IA,2015,7538,7285,253,3.4,0
"Harrison County, IA",IA,2014,7538,7236,302,4.0,20
"Harrison County, IA",IA,2013,7518,7179,339,4.5,-50
"Harrison County, IA",IA,2012,7568,7185,383,5.1,-284
"Harrison County, IA",IA,2011,7852,7409,443,5.6,-128
"Harrison County, IA",IA,2010,7980,7527,453,5.7,0
"Harrison County, IN",IN,2021,20019,19485,534,2.7,53
"Harrison County, IN",IN,2020,19966,18699,1267,6.3,-544
"Harrison County, IN",IN,2019,20510,19861,649,3.2,76
"Harrison County, IN",IN,2018,20434,19741,693,3.4,512
"Harrison County, IN",IN,2017,19922,19237,685,3.4,-54
"Harrison County, IN",IN,2016,19976,19148,828,4.1,597
"Harrison County, IN",IN,2015,19379,18496,883,4.6,330
"Harrison County, IN",IN,2014,19049,17988,1061,5.6,311
"Harrison County, IN",IN,2013,18738,17454,1284,6.9,163
"Harrison County, IN",IN,2012,18575,17161,1414,7.6,-243
"Harrison County, IN",IN,2011,18818,17169,1649,8.8,-180
"Harrison County, IN",IN,2010,18998,17174,1824,9.6,0
"Harrison County, KY",KY,2021,8766,8426,340,3.9,94
"Harrison County, KY",KY,2020,8672,8156,516,6.0,-168
"Harrison County, KY",KY,2019,8840,8481,359,4.1,196
"Harrison County, KY",KY,2018,8644,8297,347,4.0,-43
"Harrison County, KY",KY,2017,8687,8294,393,4.5,193
"Harrison County, KY",KY,2016,8494,8099,395,4.7,173
"Harrison County, KY",KY,2015,8321,7939,382,4.6,-105
"Harrison County, KY",KY,2014,8426,7924,502,6.0,-321
"Harrison County, KY",KY,2013,8747,8092,655,7.5,-158
"Harrison County, KY",KY,2012,8905,8199,706,7.9,-71
"Harrison County, KY",KY,2011,8976,8073,903,10.1,-89
"Harrison County, KY",KY,2010,9065,8047,1018,11.2,0
"Harrison County, MO",MO,2021,3761,3629,132,3.5,-25
"Harrison County, MO",MO,2020,3786,3615,171,4.5,9
"Harrison County, MO",MO,2019,3777,3657,120,3.2,-60
"Harrison County, MO",MO,2018,3837,3722,115,3.0,-76
"Harrison County, MO",MO,2017,3913,3776,137,3.5,-55
"Harrison County, MO",MO,2016,3968,3801,167,4.2,5
"Harrison County, MO",MO,2015,3963,3758,205,5.2,-3
"Harrison County, MO",MO,2014,3966,3706,260,6.6,11
"Harrison County, MO",MO,2013,3955,3663,292,7.4,13
"Harrison County, MO",MO,2012,3942,3647,295,7.5,-59
"Harrison County, MO",MO,2011,4001,3654,347,8.7,-44
"Harrison County, MO",MO,2010,4045,3663,382,9.4,0
"Harrison County, MS",MS,2021,87481,82697,4784,5.5,996
"Harrison County, MS",MS,2020,86485,78493,7992,9.2,-337
"Harrison County, MS",MS,2019,86822,82294,4528,5.2,1018
"Harrison County, MS",MS,2018,85804,81731,4073,4.7,-103
"Harrison County, MS",MS,2017,85907,81617,4290,5.0,-427
"Harrison County, MS",MS,2016,86334,81468,4866,5.6,950
"Harrison County, MS",MS,2015,85384,80244,5140,6.0,886
"Harrison County, MS",MS,2014,84498,78755,5743,6.8,-2169
"Harrison County, MS",MS,2013,86667,80193,6474,7.5,-3259
"Harrison County, MS",MS,2012,89926,82714,7212,8.0,-882
"Harrison County, MS",MS,2011,90808,82898,7910,8.7,1859
"Harrison County, MS",MS,2010,88949,81369,7580,8.5,0
"Harrison County, OH",OH,2021,6502,6096,406,6.2,-179
"Harrison County, OH",OH,2020,6681,6061,620,9.3,-198
"Harrison County, OH",OH,2019,6879,6515,364,5.3,-83
"Harrison County, OH",OH,2018,6962,6599,363,5.2,-211
"Harrison County, OH",OH,2017,7173,6745,428,6.0,175
"Harrison County, OH",OH,2016,6998,6460,538,7.7,-210
"Harrison County, OH",OH,2015,7208,6750,458,6.4,-166
"Harrison County, OH",OH,2014,7374,6928,446,6.0,89
"Harrison County, OH",OH,2013,7285,6709,576,7.9,308
"Harrison County, OH",OH,2012,6977,6381,596,8.5,-28
"Harrison County, OH",OH,2011,7005,6261,744,10.6,-246
"Harrison County, OH",OH,2010,7251,6344,907,12.5,0
"Harrison County, TX",TX,2021,28650,26757,1893,6.6,-168
"Harrison County, TX",TX,2020,28818,26551,2267,7.9,-265
"Harrison County, TX",TX,2019,29083,27919,1164,4.0,-559
"Harrison County, TX",TX,2018,29642,28343,1299,4.4,395
"Harrison County, TX",TX,2017,29247,27707,1540,5.3,-714
"Harrison County, TX",TX,2016,29961,28159,1802,6.0,-1256
"Harrison County, TX",TX,2015,31217,29575,1642,5.3,-934
"Harrison County, TX",TX,2014,32151,30358,1793,5.6,-112
"Harrison County, TX",TX,2013,32263,30032,2231,6.9,361
"Harrison County, TX",TX,2012,31902,29549,2353,7.4,366
"Harrison County, TX",TX,2011,31536,28758,2778,8.8,658
"Harrison County, TX",TX,2010,30878,27961,2917,9.4,0
"Harrison County, WV",WV,2021,33767,32186,1581,4.7,67
"Harrison County, WV",WV,2020,33700,31085,2615,7.8,-889
"Harrison County, WV",WV,2019,34589,33043,1546,4.5,167
"Harrison County, WV",WV,2018,34422,32885,1537,4.5,1053
"Harrison County, WV",WV,2017,33369,31759,1610,4.8,921
"Harrison County, WV",WV,2016,32448,30555,1893,5.8,220
"Harrison County, WV",WV,2015,32228,30244,1984,6.2,119
"Harrison County, WV",WV,2014,32109,30415,1694,5.3,287
"Harrison County, WV",WV,2013,31822,30071,1751,5.5,398
"Harrison County, WV",WV,2012,31424,29445,1979,6.3,49
"Harrison County, WV",WV,2011,31375,29197,2178,6.9,162
"Harrison County, WV",WV,2010,31213,28833,2380,7.6,0
"Harrisonburg city, VA",VA,2021,23996,23027,969,4.0,-378
"Harrisonburg city, VA",VA,2020,24374,22818,1556,6.4,-644
"Harrisonburg city, VA",VA,2019,25018,24218,800,3.2,219
"Harrisonburg city, VA",VA,2018,24799,23942,857,3.5,-206
"Harrisonburg city, VA",VA,2017,25005,23915,1090,4.4,746
"Harrisonburg city, VA",VA,2016,24259,23107,1152,4.7,282
"Harrisonburg city, VA",VA,2015,23977,22722,1255,5.2,-319
"Harrisonburg city, VA",VA,2014,24296,22843,1453,6.0,263
"Harrisonburg city, VA",VA,2013,24033,22446,1587,6.6,-51
"Harrisonburg city, VA",VA,2012,24084,22345,1739,7.2,337
"Harrisonburg city, VA",VA,2011,23747,21903,1844,7.8,545
"Harrisonburg city, VA",VA,2010,23202,21240,1962,8.5,0
"Hart County, GA",GA,2021,11640,11184,456,3.9,311
"Hart County, GA",GA,2020,11329,10719,610,5.4,-291
"Hart County, GA",GA,2019,11620,11198,422,3.6,-133
"Hart County, GA",GA,2018,11753,11320,433,3.7,394
"Hart County, GA",GA,2017,11359,10851,508,4.5,346
"Hart County, GA",GA,2016,11013,10414,599,5.4,729
"Hart County, GA",GA,2015,10284,9635,649,6.3,-85
"Hart County, GA",GA,2014,10369,9588,781,7.5,-116
"Hart County, GA",GA,2013,10485,9527,958,9.1,-298
"Hart County, GA",GA,2012,10783,9690,1093,10.1,-337
"Hart County, GA",GA,2011,11120,9887,1233,11.1,130
"Hart County, GA",GA,2010,10990,9709,1281,11.7,0
"Hart County, KY",KY,2021,7645,7307,338,4.4,7
"Hart County, KY",KY,2020,7638,7157,481,6.3,-299
"Hart County, KY",KY,2019,7937,7578,359,4.5,-107
"Hart County, KY",KY,2018,8044,7731,313,3.9,-58
"Hart County, KY",KY,2017,8102,7749,353,4.4,199
"Hart County, KY",KY,2016,7903,7534,369,4.7,238
"Hart County, KY",KY,2015,7665,7275,390,5.1,-156
"Hart County, KY",KY,2014,7821,7329,492,6.3,-238
"Hart County, KY",KY,2013,8059,7427,632,7.8,-83
"Hart County, KY",KY,2012,8142,7464,678,8.3,-75
"Hart County, KY",KY,2011,8217,7408,809,9.8,65
"Hart County, KY",KY,2010,8152,7294,858,10.5,0
"Hartford County, CT",CT,2021,468861,438180,30681,6.5,-13740
"Hartford County, CT",CT,2020,482601,443952,38649,8.0,-10534
"Hartford County, CT",CT,2019,493135,475091,18044,3.7,6530
"Hartford County, CT",CT,2018,486605,466922,19683,4.0,2606
"Hartford County, CT",CT,2017,483999,461941,22058,4.6,9505
"Hartford County, CT",CT,2016,474494,450542,23952,5.0,-331
"Hartford County, CT",CT,2015,474825,447489,27336,5.8,938
"Hartford County, CT",CT,2014,473887,441855,32032,6.8,6049
"Hartford County, CT",CT,2013,467838,429826,38012,8.1,-4688
"Hartford County, CT",CT,2012,472526,432127,40399,8.5,-7130
"Hartford County, CT",CT,2011,479656,435305,44351,9.2,126
"Hartford County, CT",CT,2010,479530,431989,47541,9.9,0
"Hartley County, TX",TX,2021,2733,2676,57,2.1,139
"Hartley County, TX",TX,2020,2594,2543,51,2.0,-172
"Hartley County, TX",TX,2019,2766,2720,46,1.7,-69
"Hartley County, TX",TX,2018,2835,2783,52,1.8,-84
"Hartley County, TX",TX,2017,2919,2861,58,2.0,-42
"Hartley County, TX",TX,2016,2961,2901,60,2.0,-43
"Hartley County, TX",TX,2015,3004,2940,64,2.1,108
"Hartley County, TX",TX,2014,2896,2822,74,2.6,-30
"Hartley County, TX",TX,2013,2926,2833,93,3.2,30
"Hartley County, TX",TX,2012,2896,2800,96,3.3,87
"Hartley County, TX",TX,2011,2809,2694,115,4.1,111
"Hartley County, TX",TX,2010,2698,2586,112,4.2,0
"Harvey County, KS",KS,2021,16918,16421,497,2.9,150
"Harvey County, KS",KS,2020,16768,15902,866,5.2,-434
"Harvey County, KS",KS,2019,17202,16709,493,2.9,368
"Harvey County, KS",KS,2018,16834,16304,530,3.1,-93
"Harvey County, KS",KS,2017,16927,16238,689,4.1,-356
"Harvey County, KS",KS,2016,17283,16554,729,4.2,29
"Harvey County, KS",KS,2015,17254,16582,672,3.9,115
"Harvey County, KS",KS,2014,17139,16415,724,4.2,-11
"Harvey County, KS",KS,2013,17150,16315,835,4.9,-164
"Harvey County, KS",KS,2012,17314,16376,938,5.4,-154
"Harvey County, KS",KS,2011,17468,16425,1043,6.0,-303
"Harvey County, KS",KS,2010,17771,16511,1260,7.1,0
"Haskell County, KS",KS,2021,2223,2183,40,1.8,-17
"Haskell County, KS",KS,2020,2240,2191,49,2.2,10
"Haskell County, KS",KS,2019,2230,2180,50,2.2,25
"Haskell County, KS",KS,2018,2205,2159,46,2.1,-35
"Haskell County, KS",KS,2017,2240,2190,50,2.2,-75
"Haskell County, KS",KS,2016,2315,2255,60,2.6,-50
"Haskell County, KS",KS,2015,2365,2306,59,2.5,5
"Haskell County, KS",KS,2014,2360,2299,61,2.6,-35
"Haskell County, KS",KS,2013,2395,2325,70,2.9,-76
"Haskell County, KS",KS,2012,2471,2388,83,3.4,44
"Haskell County, KS",KS,2011,2427,2343,84,3.5,-19
"Haskell County, KS",KS,2010,2446,2359,87,3.6,0
"Haskell County, OK",OK,2021,4248,4027,221,5.2,32
"Haskell County, OK",OK,2020,4216,3877,339,8.0,2
"Haskell County, OK",OK,2019,4214,4003,211,5.0,14
"Haskell County, OK",OK,2018,4200,3994,206,4.9,-145
"Haskell County, OK",OK,2017,4345,4073,272,6.3,-148
"Haskell County, OK",OK,2016,4493,4134,359,8.0,21
"Haskell County, OK",OK,2015,4472,4126,346,7.7,137
"Haskell County, OK",OK,2014,4335,4023,312,7.2,-127
"Haskell County, OK",OK,2013,4462,4064,398,8.9,-133
"Haskell County, OK",OK,2012,4595,4199,396,8.6,-63
"Haskell County, OK",OK,2011,4658,4262,396,8.5,-119
"Haskell County, OK",OK,2010,4777,4328,449,9.4,0
"Haskell County, TX",TX,2021,2740,2632,108,3.9,90
"Haskell County, TX",TX,2020,2650,2537,113,4.3,423
"Haskell County, TX",TX,2019,2227,2154,73,3.3,-106
"Haskell County, TX",TX,2018,2333,2242,91,3.9,-87
"Haskell County, TX",TX,2017,2420,2303,117,4.8,-89
"Haskell County, TX",TX,2016,2509,2403,106,4.2,-74
"Haskell County, TX",TX,2015,2583,2492,91,3.5,-107
"Haskell County, TX",TX,2014,2690,2583,107,4.0,-17
"Haskell County, TX",TX,2013,2707,2572,135,5.0,-61
"Haskell County, TX",TX,2012,2768,2622,146,5.3,-267
"Haskell County, TX",TX,2011,3035,2867,168,5.5,37
"Haskell County, TX",TX,2010,2998,2834,164,5.5,0
"Hatillo Municipio, PR",PR,2021,14310,13197,1113,7.8,
"Hatillo Municipio, PR",PR,2020,N.A.,N.A.,N.A.,N.A.,
"Hatillo Municipio, PR",PR,2019,13702,12035,1667,12.2,544
"Hatillo Municipio, PR",PR,2018,13158,11488,1670,12.7,72
"Hatillo Municipio, PR",PR,2017,13086,11258,1828,14.0,-237
"Hatillo Municipio, PR",PR,2016,13323,11253,2070,15.5,259
"Hatillo Municipio, PR",PR,2015,13064,11024,2040,15.6,-29
"Hatillo Municipio, PR",PR,2014,13093,10962,2131,16.3,-330
"Hatillo Municipio, PR",PR,2013,13423,11264,2159,16.1,-12
"Hatillo Municipio, PR",PR,2012,13435,11252,2183,16.2,-265
"Hatillo Municipio, PR",PR,2011,13700,11388,2312,16.9,-336
"Hatillo Municipio, PR",PR,2010,14036,11738,2298,16.4,0
"Hawaii County, HI",HI,2021,93848,88679,5169,5.5,2212
"Hawaii County, HI",HI,2020,91636,80942,10694,11.7,-1964
"Hawaii County, HI",HI,2019,93600,90674,2926,3.1,-1121
"Hawaii County, HI",HI,2018,94721,92033,2688,2.8,-383
"Hawaii County, HI",HI,2017,95104,92655,2449,2.6,2630
"Hawaii County, HI",HI,2016,92474,89228,3246,3.5,3056
"Hawaii County, HI",HI,2015,89418,85690,3728,4.2,1016
"Hawaii County, HI",HI,2014,88402,83722,4680,5.3,1548
"Hawaii County, HI",HI,2013,86854,81283,5571,6.4,-439
"Hawaii County, HI",HI,2012,87293,80231,7062,8.1,-2185
"Hawaii County, HI",HI,2011,89478,80752,8726,9.8,939
"Hawaii County, HI",HI,2010,88539,79996,8543,9.6,0
"Hawkins County, TN",TN,2021,23137,22112,1025,4.4,-252
"Hawkins County, TN",TN,2020,23389,21605,1784,7.6,-589
"Hawkins County, TN",TN,2019,23978,22989,989,4.1,185
"Hawkins County, TN",TN,2018,23793,22846,947,4.0,102
"Hawkins County, TN",TN,2017,23691,22678,1013,4.3,-32
"Hawkins County, TN",TN,2016,23723,22439,1284,5.4,143
"Hawkins County, TN",TN,2015,23580,22085,1495,6.3,-336
"Hawkins County, TN",TN,2014,23916,22158,1758,7.4,-842
"Hawkins County, TN",TN,2013,24758,22593,2165,8.7,-306
"Hawkins County, TN",TN,2012,25064,22816,2248,9.0,-621
"Hawkins County, TN",TN,2011,25685,23098,2587,10.1,98
"Hawkins County, TN",TN,2010,25587,22757,2830,11.1,0
"Hayes County, NE",NE,2021,617,609,8,1.3,-17
"Hayes County, NE",NE,2020,634,620,14,2.2,10
"Hayes County, NE",NE,2019,624,608,16,2.6,19
"Hayes County, NE",NE,2018,605,592,13,2.1,28
"Hayes County, NE",NE,2017,577,563,14,2.4,-16
"Hayes County, NE",NE,2016,593,579,14,2.4,-25
"Hayes County, NE",NE,2015,618,604,14,2.3,-11
"Hayes County, NE",NE,2014,629,611,18,2.9,-16
"Hayes County, NE",NE,2013,645,624,21,3.3,-18
"Hayes County, NE",NE,2012,663,644,19,2.9,-16
"Hayes County, NE",NE,2011,679,658,21,3.1,39
"Hayes County, NE",NE,2010,640,617,23,3.6,0
"Hays County, TX",TX,2021,129600,124271,5329,4.1,6925
"Hays County, TX",TX,2020,122675,114991,7684,6.3,3247
"Hays County, TX",TX,2019,119428,116098,3330,2.8,4373
"Hays County, TX",TX,2018,115055,111627,3428,3.0,5170
"Hays County, TX",TX,2017,109885,106395,3490,3.2,4964
"Hays County, TX",TX,2016,104921,101416,3505,3.3,6424
"Hays County, TX",TX,2015,98497,95094,3403,3.5,4600
"Hays County, TX",TX,2014,93897,89833,4064,4.3,4179
"Hays County, TX",TX,2013,89718,84890,4828,5.4,4108
"Hays County, TX",TX,2012,85610,80647,4963,5.8,2346
"Hays County, TX",TX,2011,83264,77502,5762,6.9,2770
"Hays County, TX",TX,2010,80494,74809,5685,7.1,0
"Haywood County, NC",NC,2021,28887,27662,1225,4.2,795
"Haywood County, NC",NC,2020,28092,26047,2045,7.3,-1593
"Haywood County, NC",NC,2019,29685,28690,995,3.4,449
"Haywood County, NC",NC,2018,29236,28229,1007,3.4,698
"Haywood County, NC",NC,2017,28538,27389,1149,4.0,142
"Haywood County, NC",NC,2016,28396,27104,1292,4.5,773
"Haywood County, NC",NC,2015,27623,26189,1434,5.2,371
"Haywood County, NC",NC,2014,27252,25713,1539,5.6,-389
"Haywood County, NC",NC,2013,27641,25536,2105,7.6,-111
"Haywood County, NC",NC,2012,27752,25160,2592,9.3,91
"Haywood County, NC",NC,2011,27661,24871,2790,10.1,-44
"Haywood County, NC",NC,2010,27705,24883,2822,10.2,0
"Haywood County, TN",TN,2021,7624,7175,449,5.9,-151
"Haywood County, TN",TN,2020,7775,7107,668,8.6,37
"Haywood County, TN",TN,2019,7738,7364,374,4.8,-5
"Haywood County, TN",TN,2018,7743,7332,411,5.3,-60
"Haywood County, TN",TN,2017,7803,7396,407,5.2,122
"Haywood County, TN",TN,2016,7681,7181,500,6.5,37
"Haywood County, TN",TN,2015,7644,7009,635,8.3,-132
"Haywood County, TN",TN,2014,7776,7009,767,9.9,-351
"Haywood County, TN",TN,2013,8127,7172,955,11.8,-96
"Haywood County, TN",TN,2012,8223,7258,965,11.7,-266
"Haywood County, TN",TN,2011,8489,7298,1191,14.0,-489
"Haywood County, TN",TN,2010,8978,7554,1424,15.9,0
"Heard County, GA",GA,2021,5239,5036,203,3.9,132
"Heard County, GA",GA,2020,5107,4778,329,6.4,-127
"Heard County, GA",GA,2019,5234,5052,182,3.5,1
"Heard County, GA",GA,2018,5233,5027,206,3.9,15
"Heard County, GA",GA,2017,5218,4956,262,5.0,222
"Heard County, GA",GA,2016,4996,4697,299,6.0,140
"Heard County, GA",GA,2015,4856,4539,317,6.5,-103
"Heard County, GA",GA,2014,4959,4565,394,7.9,-45
"Heard County, GA",GA,2013,5004,4536,468,9.4,-99
"Heard County, GA",GA,2012,5103,4584,519,10.2,-54
"Heard County, GA",GA,2011,5157,4579,578,11.2,-108
"Heard County, GA",GA,2010,5265,4621,644,12.2,0
"Hemphill County, TX",TX,2021,1635,1564,71,4.3,-145
"Hemphill County, TX",TX,2020,1780,1699,81,4.6,-201
"Hemphill County, TX",TX,2019,1981,1929,52,2.6,-246
"Hemphill County, TX",TX,2018,2227,2180,47,2.1,-71
"Hemphill County, TX",TX,2017,2298,2240,58,2.5,183
"Hemphill County, TX",TX,2016,2115,2036,79,3.7,-187
"Hemphill County, TX",TX,2015,2302,2229,73,3.2,-238
"Hemphill County, TX",TX,2014,2540,2479,61,2.4,70
"Hemphill County, TX",TX,2013,2470,2395,75,3.0,-72
"Hemphill County, TX",TX,2012,2542,2468,74,2.9,156
"Hemphill County, TX",TX,2011,2386,2300,86,3.6,254
"Hemphill County, TX",TX,2010,2132,2048,84,3.9,0
"Hempstead County, AR",AR,2021,9182,8862,320,3.5,-446
"Hempstead County, AR",AR,2020,9628,9125,503,5.2,-297
"Hempstead County, AR",AR,2019,9925,9555,370,3.7,-14
"Hempstead County, AR",AR,2018,9939,9597,342,3.4,46
"Hempstead County, AR",AR,2017,9893,9551,342,3.5,-126
"Hempstead County, AR",AR,2016,10019,9643,376,3.8,54
"Hempstead County, AR",AR,2015,9965,9483,482,4.8,-91
"Hempstead County, AR",AR,2014,10056,9473,583,5.8,-128
"Hempstead County, AR",AR,2013,10184,9466,718,7.1,-741
"Hempstead County, AR",AR,2012,10925,10162,763,7.0,-78
"Hempstead County, AR",AR,2011,11003,10080,923,8.4,310
"Hempstead County, AR",AR,2010,10693,9740,953,8.9,0
"Henderson County, IL",IL,2021,3543,3401,142,4.0,9
"Henderson County, IL",IL,2020,3534,3283,251,7.1,-100
"Henderson County, IL",IL,2019,3634,3469,165,4.5,-32
"Henderson County, IL",IL,2018,3666,3489,177,4.8,13
"Henderson County, IL",IL,2017,3653,3467,186,5.1,-79
"Henderson County, IL",IL,2016,3732,3505,227,6.1,-24
"Henderson County, IL",IL,2015,3756,3530,226,6.0,18
"Henderson County, IL",IL,2014,3738,3499,239,6.4,69
"Henderson County, IL",IL,2013,3669,3380,289,7.9,-44
"Henderson County, IL",IL,2012,3713,3416,297,8.0,-141
"Henderson County, IL",IL,2011,3854,3546,308,8.0,-68
"Henderson County, IL",IL,2010,3922,3554,368,9.4,0
"Henderson County, KY",KY,2021,20775,19843,932,4.5,112
"Henderson County, KY",KY,2020,20663,19427,1236,6.0,-1009
"Henderson County, KY",KY,2019,21672,20875,797,3.7,-311
"Henderson County, KY",KY,2018,21983,21164,819,3.7,7
"Henderson County, KY",KY,2017,21976,20996,980,4.5,369
"Henderson County, KY",KY,2016,21607,20594,1013,4.7,192
"Henderson County, KY",KY,2015,21415,20394,1021,4.8,-242
"Henderson County, KY",KY,2014,21657,20346,1311,6.1,-479
"Henderson County, KY",KY,2013,22136,20495,1641,7.4,-508
"Henderson County, KY",KY,2012,22644,20931,1713,7.6,-279
"Henderson County, KY",KY,2011,22923,20868,2055,9.0,-45
"Henderson County, KY",KY,2010,22968,20588,2380,10.4,0
"Henderson County, NC",NC,2021,53037,50879,2158,4.1,1702
"Henderson County, NC",NC,2020,51335,47904,3431,6.7,-3278
"Henderson County, NC",NC,2019,54613,52832,1781,3.3,857
"Henderson County, NC",NC,2018,53756,51978,1778,3.3,1012
"Henderson County, NC",NC,2017,52744,50731,2013,3.8,610
"Henderson County, NC",NC,2016,52134,49909,2225,4.3,1520
"Henderson County, NC",NC,2015,50614,48238,2376,4.7,1169
"Henderson County, NC",NC,2014,49445,47025,2420,4.9,272
"Henderson County, NC",NC,2013,49173,46201,2972,6.0,191
"Henderson County, NC",NC,2012,48982,45221,3761,7.7,314
"Henderson County, NC",NC,2011,48668,44531,4137,8.5,181
"Henderson County, NC",NC,2010,48487,44115,4372,9.0,0
"Henderson County, TN",TN,2021,11873,11356,517,4.4,-16
"Henderson County, TN",TN,2020,11889,10939,950,8.0,-358
"Henderson County, TN",TN,2019,12247,11708,539,4.4,225
"Henderson County, TN",TN,2018,12022,11458,564,4.7,121
"Henderson County, TN",TN,2017,11901,11288,613,5.2,-94
"Henderson County, TN",TN,2016,11995,11172,823,6.9,-302
"Henderson County, TN",TN,2015,12297,11324,973,7.9,61
"Henderson County, TN",TN,2014,12236,11176,1060,8.7,-474
"Henderson County, TN",TN,2013,12710,11381,1329,10.5,-482
"Henderson County, TN",TN,2012,13192,11895,1297,9.8,-363
"Henderson County, TN",TN,2011,13555,12022,1533,11.3,537
"Henderson County, TN",TN,2010,13018,11133,1885,14.5,0
"Henderson County, TX",TX,2021,38202,36240,1962,5.1,1404
"Henderson County, TX",TX,2020,36798,34432,2366,6.4,597
"Henderson County, TX",TX,2019,36201,34931,1270,3.5,404
"Henderson County, TX",TX,2018,35797,34436,1361,3.8,423
"Henderson County, TX",TX,2017,35374,33885,1489,4.2,-24
"Henderson County, TX",TX,2016,35398,33741,1657,4.7,1014
"Henderson County, TX",TX,2015,34384,32700,1684,4.9,-308
"Henderson County, TX",TX,2014,34692,32729,1963,5.7,196
"Henderson County, TX",TX,2013,34496,32023,2473,7.2,34
"Henderson County, TX",TX,2012,34462,31868,2594,7.5,-584
"Henderson County, TX",TX,2011,35046,31967,3079,8.8,244
"Henderson County, TX",TX,2010,34802,31722,3080,8.9,0
"Hendricks County, IN",IN,2021,91963,89665,2298,2.5,1712
"Hendricks County, IN",IN,2020,90251,85655,4596,5.1,-1543
"Hendricks County, IN",IN,2019,91794,89345,2449,2.7,2093
"Hendricks County, IN",IN,2018,89701,87137,2564,2.9,2496
"Hendricks County, IN",IN,2017,87205,84702,2503,2.9,1327
"Hendricks County, IN",IN,2016,85878,82920,2958,3.4,3022
"Hendricks County, IN",IN,2015,82856,79705,3151,3.8,2127
"Hendricks County, IN",IN,2014,80729,77028,3701,4.6,1919
"Hendricks County, IN",IN,2013,78810,74332,4478,5.7,1828
"Hendricks County, IN",IN,2012,76982,72185,4797,6.2,762
"Hendricks County, IN",IN,2011,76220,71016,5204,6.8,1428
"Hendricks County, IN",IN,2010,74792,69076,5716,7.6,0
"Hendry County, FL",FL,2021,15734,14782,952,6.1,447
"Hendry County, FL",FL,2020,15287,13907,1380,9.0,58
"Hendry County, FL",FL,2019,15229,14299,930,6.1,-284
"Hendry County, FL",FL,2018,15513,14533,980,6.3,-375
"Hendry County, FL",FL,2017,15888,14712,1176,7.4,426
"Hendry County, FL",FL,2016,15462,14133,1329,8.6,300
"Hendry County, FL",FL,2015,15162,13535,1627,10.7,-663
"Hendry County, FL",FL,2014,15825,13984,1841,11.6,-819
"Hendry County, FL",FL,2013,16644,14574,2070,12.4,-267
"Hendry County, FL",FL,2012,16911,14690,2221,13.1,-942
"Hendry County, FL",FL,2011,17853,15394,2459,13.8,-321
"Hendry County, FL",FL,2010,18174,15707,2467,13.6,0
"Hennepin County, MN",MN,2021,693393,669687,23706,3.4,-21847
"Hennepin County, MN",MN,2020,715240,667542,47698,6.7,-667
"Hennepin County, MN",MN,2019,715907,694727,21180,3.0,9864
"Hennepin County, MN",MN,2018,706043,687099,18944,2.7,4346
"Hennepin County, MN",MN,2017,701697,680190,21507,3.1,16591
"Hennepin County, MN",MN,2016,685106,662298,22808,3.3,6719
"Hennepin County, MN",MN,2015,678387,655614,22773,3.4,4475
"Hennepin County, MN",MN,2014,673912,647791,26121,3.9,6403
"Hennepin County, MN",MN,2013,667509,636456,31053,4.7,6945
"Hennepin County, MN",MN,2012,660564,625770,34794,5.3,3187
"Hennepin County, MN",MN,2011,657377,617481,39896,6.1,6293
"Hennepin County, MN",MN,2010,651084,605608,45476,7.0,0
"Henrico County, VA",VA,2021,176593,169543,7050,4.0,-4793
"Henrico County, VA",VA,2020,181386,169700,11686,6.4,-3436
"Henrico County, VA",VA,2019,184822,179699,5123,2.8,2246
"Henrico County, VA",VA,2018,182576,177154,5422,3.0,673
"Henrico County, VA",VA,2017,181903,175322,6581,3.6,2818
"Henrico County, VA",VA,2016,179085,172221,6864,3.8,1451
"Henrico County, VA",VA,2015,177634,170112,7522,4.2,782
"Henrico County, VA",VA,2014,176852,168004,8848,5.0,2721
"Henrico County, VA",VA,2013,174131,164651,9480,5.4,1793
"Henrico County, VA",VA,2012,172338,162124,10214,5.9,2073
"Henrico County, VA",VA,2011,170265,158821,11444,6.7,2317
"Henrico County, VA",VA,2010,167948,155376,12572,7.5,0
"Henry County, AL",AL,2021,6881,6662,219,3.2,-28
"Henry County, AL",AL,2020,6909,6535,374,5.4,-81
"Henry County, AL",AL,2019,6990,6725,265,3.8,86
"Henry County, AL",AL,2018,6904,6600,304,4.4,113
"Henry County, AL",AL,2017,6791,6453,338,5.0,125
"Henry County, AL",AL,2016,6666,6231,435,6.5,-36
"Henry County, AL",AL,2015,6702,6243,459,6.8,-86
"Henry County, AL",AL,2014,6788,6281,507,7.5,-162
"Henry County, AL",AL,2013,6950,6407,543,7.8,-87
"Henry County, AL",AL,2012,7037,6439,598,8.5,-232
"Henry County, AL",AL,2011,7269,6566,703,9.7,4
"Henry County, AL",AL,2010,7265,6483,782,10.8,0
"Henry County, GA",GA,2021,118685,113693,4992,4.2,2275
"Henry County, GA",GA,2020,116410,107965,8445,7.3,-551
"Henry County, GA",GA,2019,116961,112605,4356,3.7,1825
"Henry County, GA",GA,2018,115136,110310,4826,4.2,1627
"Henry County, GA",GA,2017,113509,107957,5552,4.9,4592
"Henry County, GA",GA,2016,108917,102845,6072,5.6,5074
"Henry County, GA",GA,2015,103843,97333,6510,6.3,471
"Henry County, GA",GA,2014,103372,95844,7528,7.3,75
"Henry County, GA",GA,2013,103297,94630,8667,8.4,452
"Henry County, GA",GA,2012,102845,93325,9520,9.3,357
"Henry County, GA",GA,2011,102488,91988,10500,10.2,1078
"Henry County, GA",GA,2010,101410,90799,10611,10.5,0
"Henry County, IA",IA,2021,9502,9104,398,4.2,-28
"Henry County, IA",IA,2020,9530,9036,494,5.2,-474
"Henry County, IA",IA,2019,10004,9753,251,2.5,147
"Henry County, IA",IA,2018,9857,9615,242,2.5,93
"Henry County, IA",IA,2017,9764,9478,286,2.9,152
"Henry County, IA",IA,2016,9612,9273,339,3.5,15
"Henry County, IA",IA,2015,9597,9225,372,3.9,53
"Henry County, IA",IA,2014,9544,9126,418,4.4,-17
"Henry County, IA",IA,2013,9561,9055,506,5.3,-100
"Henry County, IA",IA,2012,9661,9084,577,6.0,-213
"Henry County, IA",IA,2011,9874,9192,682,6.9,-65
"Henry County, IA",IA,2010,9939,9099,840,8.5,0
"Henry County, IL",IL,2021,23644,22491,1153,4.9,-56
"Henry County, IL",IL,2020,23700,21809,1891,8.0,-1376
"Henry County, IL",IL,2019,25076,23934,1142,4.6,-7
"Henry County, IL",IL,2018,25083,23838,1245,5.0,55
"Henry County, IL",IL,2017,25028,23750,1278,5.1,-294
"Henry County, IL",IL,2016,25322,23793,1529,6.0,86
"Henry County, IL",IL,2015,25236,23688,1548,6.1,-105
"Henry County, IL",IL,2014,25341,23642,1699,6.7,-150
"Henry County, IL",IL,2013,25491,23526,1965,7.7,-650
"Henry County, IL",IL,2012,26141,24196,1945,7.4,-452
"Henry County, IL",IL,2011,26593,24508,2085,7.8,-176
"Henry County, IL",IL,2010,26769,24312,2457,9.2,0
"Henry County, IN",IN,2021,21673,20971,702,3.2,-210
"Henry County, IN",IN,2020,21883,20431,1452,6.6,-369
"Henry County, IN",IN,2019,22252,21534,718,3.2,-193
"Henry County, IN",IN,2018,22445,21667,778,3.5,268
"Henry County, IN",IN,2017,22177,21373,804,3.6,41
"Henry County, IN",IN,2016,22136,21128,1008,4.6,477
"Henry County, IN",IN,2015,21659,20516,1143,5.3,188
"Henry County, IN",IN,2014,21471,20015,1456,6.8,130
"Henry County, IN",IN,2013,21341,19489,1852,8.7,185
"Henry County, IN",IN,2012,21156,19059,2097,9.9,-167
"Henry County, IN",IN,2011,21323,18919,2404,11.3,-52
"Henry County, IN",IN,2010,21375,18486,2889,13.5,0
"Henry County, KY",KY,2021,8151,7825,326,4.0,128
"Henry County, KY",KY,2020,8023,7574,449,5.6,-244
"Henry County, KY",KY,2019,8267,7980,287,3.5,48
"Henry County, KY",KY,2018,8219,7914,305,3.7,84
"Henry County, KY",KY,2017,8135,7808,327,4.0,208
"Henry County, KY",KY,2016,7927,7606,321,4.0,267
"Henry County, KY",KY,2015,7660,7309,351,4.6,17
"Henry County, KY",KY,2014,7643,7206,437,5.7,-121
"Henry County, KY",KY,2013,7764,7209,555,7.1,61
"Henry County, KY",KY,2012,7703,7138,565,7.3,-67
"Henry County, KY",KY,2011,7770,7090,680,8.8,-103
"Henry County, KY",KY,2010,7873,7090,783,9.9,0
"Henry County, MO",MO,2021,10059,9661,398,4.0,415
"Henry County, MO",MO,2020,9644,9080,564,5.8,-24
"Henry County, MO",MO,2019,9668,9326,342,3.5,-104
"Henry County, MO",MO,2018,9772,9428,344,3.5,-108
"Henry County, MO",MO,2017,9880,9476,404,4.1,0
"Henry County, MO",MO,2016,9880,9388,492,5.0,-170
"Henry County, MO",MO,2015,10050,9491,559,5.6,-35
"Henry County, MO",MO,2014,10085,9427,658,6.5,246
"Henry County, MO",MO,2013,9839,9129,710,7.2,54
"Henry County, MO",MO,2012,9785,8999,786,8.0,-94
"Henry County, MO",MO,2011,9879,8905,974,9.9,-216
"Henry County, MO",MO,2010,10095,9013,1082,10.7,0
"Henry County, OH",OH,2021,12745,12088,657,5.2,-253
"Henry County, OH",OH,2020,12998,11945,1053,8.1,-284
"Henry County, OH",OH,2019,13282,12662,620,4.7,-83
"Henry County, OH",OH,2018,13365,12708,657,4.9,-232
"Henry County, OH",OH,2017,13597,12894,703,5.2,-63
"Henry County, OH",OH,2016,13660,12924,736,5.4,65
"Henry County, OH",OH,2015,13595,12826,769,5.7,-191
"Henry County, OH",OH,2014,13786,12895,891,6.5,-230
"Henry County, OH",OH,2013,14016,12781,1235,8.8,-109
"Henry County, OH",OH,2012,14125,12890,1235,8.7,-231
"Henry County, OH",OH,2011,14356,12821,1535,10.7,-300
"Henry County, OH",OH,2010,14656,12740,1916,13.1,0
"Henry County, TN",TN,2021,14147,13585,562,4.0,8
"Henry County, TN",TN,2020,14139,13146,993,7.0,-76
"Henry County, TN",TN,2019,14215,13622,593,4.2,-40
"Henry County, TN",TN,2018,14255,13658,597,4.2,267
"Henry County, TN",TN,2017,13988,13352,636,4.5,56
"Henry County, TN",TN,2016,13932,13109,823,5.9,28
"Henry County, TN",TN,2015,13904,13002,902,6.5,-49
"Henry County, TN",TN,2014,13953,12824,1129,8.1,-396
"Henry County, TN",TN,2013,14349,12995,1354,9.4,69
"Henry County, TN",TN,2012,14280,12913,1367,9.6,-137
"Henry County, TN",TN,2011,14417,12833,1584,11.0,-66
"Henry County, TN",TN,2010,14483,12806,1677,11.6,0
"Henry County, VA",VA,2021,23520,22423,1097,4.7,-241
"Henry County, VA",VA,2020,23761,21957,1804,7.6,-307
"Henry County, VA",VA,2019,24068,23272,796,3.3,165
"Henry County, VA",VA,2018,23903,23027,876,3.7,-76
"Henry County, VA",VA,2017,23979,22876,1103,4.6,1814
"Henry County, VA",VA,2016,22165,20946,1219,5.5,-272
"Henry County, VA",VA,2015,22437,21019,1418,6.3,-552
"Henry County, VA",VA,2014,22989,21257,1732,7.5,-403
"Henry County, VA",VA,2013,23392,21311,2081,8.9,694
"Henry County, VA",VA,2012,22698,20347,2351,10.4,-83
"Henry County, VA",VA,2011,22781,19921,2860,12.6,-1310
"Henry County, VA",VA,2010,24091,20457,3634,15.1,0
"Herkimer County, NY",NY,2021,27514,25918,1596,5.8,-459
"Herkimer County, NY",NY,2020,27973,25770,2203,7.9,-583
"Herkimer County, NY",NY,2019,28556,27209,1347,4.7,166
"Herkimer County, NY",NY,2018,28390,27001,1389,4.9,-151
"Herkimer County, NY",NY,2017,28541,26923,1618,5.7,354
"Herkimer County, NY",NY,2016,28187,26620,1567,5.6,-186
"Herkimer County, NY",NY,2015,28373,26590,1783,6.3,-444
"Herkimer County, NY",NY,2014,28817,26846,1971,6.8,-1158
"Herkimer County, NY",NY,2013,29975,27569,2406,8.0,-521
"Herkimer County, NY",NY,2012,30496,27786,2710,8.9,-274
"Herkimer County, NY",NY,2011,30770,28070,2700,8.8,-817
"Herkimer County, NY",NY,2010,31587,28817,2770,8.8,0
"Hernando County, FL",FL,2021,73476,69734,3742,5.1,1524
"Hernando County, FL",FL,2020,71952,65730,6222,8.6,655
"Hernando County, FL",FL,2019,71297,68222,3075,4.3,1187
"Hernando County, FL",FL,2018,70110,66821,3289,4.7,1251
"Hernando County, FL",FL,2017,68859,65184,3675,5.3,707
"Hernando County, FL",FL,2016,68152,63991,4161,6.1,1779
"Hernando County, FL",FL,2015,66373,61707,4666,7.0,185
"Hernando County, FL",FL,2014,66188,60781,5407,8.2,-32
"Hernando County, FL",FL,2013,66220,60023,6197,9.4,310
"Hernando County, FL",FL,2012,65910,58728,7182,10.9,103
"Hernando County, FL",FL,2011,65807,57597,8210,12.5,-21
"Hernando County, FL",FL,2010,65828,57188,8640,13.1,0
"Hertford County, NC",NC,2021,8518,7962,556,6.5,-185
"Hertford County, NC",NC,2020,8703,8120,583,6.7,-430
"Hertford County, NC",NC,2019,9133,8672,461,5.0,134
"Hertford County, NC",NC,2018,8999,8539,460,5.1,-57
"Hertford County, NC",NC,2017,9056,8535,521,5.8,-231
"Hertford County, NC",NC,2016,9287,8676,611,6.6,76
"Hertford County, NC",NC,2015,9211,8568,643,7.0,-169
"Hertford County, NC",NC,2014,9380,8706,674,7.2,-135
"Hertford County, NC",NC,2013,9515,8646,869,9.1,-145
"Hertford County, NC",NC,2012,9660,8595,1065,11.0,-22
"Hertford County, NC",NC,2011,9682,8585,1097,11.3,-183
"Hertford County, NC",NC,2010,9865,8830,1035,10.5,0
"Hettinger County, ND",ND,2021,1392,1347,45,3.2,-6
"Hettinger County, ND",ND,2020,1398,1342,56,4.0,-5
"Hettinger County, ND",ND,2019,1403,1379,24,1.7,-23
"Hettinger County, ND",ND,2018,1426,1399,27,1.9,-67
"Hettinger County, ND",ND,2017,1493,1465,28,1.9,-43
"Hettinger County, ND",ND,2016,1536,1490,46,3.0,-7
"Hettinger County, ND",ND,2015,1543,1504,39,2.5,22
"Hettinger County, ND",ND,2014,1521,1490,31,2.0,58
"Hettinger County, ND",ND,2013,1463,1424,39,2.7,17
"Hettinger County, ND",ND,2012,1446,1409,37,2.6,-38
"Hettinger County, ND",ND,2011,1484,1443,41,2.8,1
"Hettinger County, ND",ND,2010,1483,1438,45,3.0,0
"Hickman County, KY",KY,2021,1719,1642,77,4.5,1
"Hickman County, KY",KY,2020,1718,1630,88,5.1,-47
"Hickman County, KY",KY,2019,1765,1684,81,4.6,-27
"Hickman County, KY",KY,2018,1792,1693,99,5.5,-27
"Hickman County, KY",KY,2017,1819,1685,134,7.4,-101
"Hickman County, KY",KY,2016,1920,1807,113,5.9,-6
"Hickman County, KY",KY,2015,1926,1810,116,6.0,-203
"Hickman County, KY",KY,2014,2129,1997,132,6.2,-32
"Hickman County, KY",KY,2013,2161,2008,153,7.1,-5
"Hickman County, KY",KY,2012,2166,1990,176,8.1,-122
"Hickman County, KY",KY,2011,2288,2084,204,8.9,-24
"Hickman County, KY",KY,2010,2312,2121,191,8.3,0
"Hickman County, TN",TN,2021,11445,11047,398,3.5,345
"Hickman County, TN",TN,2020,11100,10458,642,5.8,-361
"Hickman County, TN",TN,2019,11461,11108,353,3.1,283
"Hickman County, TN",TN,2018,11178,10816,362,3.2,329
"Hickman County, TN",TN,2017,10849,10476,373,3.4,407
"Hickman County, TN",TN,2016,10442,9957,485,4.6,102
"Hickman County, TN",TN,2015,10340,9756,584,5.6,-13
"Hickman County, TN",TN,2014,10353,9667,686,6.6,-170
"Hickman County, TN",TN,2013,10523,9653,870,8.3,-117
"Hickman County, TN",TN,2012,10640,9679,961,9.0,-229
"Hickman County, TN",TN,2011,10869,9738,1131,10.4,-124
"Hickman County, TN",TN,2010,10993,9747,1246,11.3,0
"Hickory County, MO",MO,2021,3963,3805,158,4.0,97
"Hickory County, MO",MO,2020,3866,3673,193,5.0,47
"Hickory County, MO",MO,2019,3819,3667,152,4.0,-17
"Hickory County, MO",MO,2018,3836,3679,157,4.1,80
"Hickory County, MO",MO,2017,3756,3589,167,4.4,65
"Hickory County, MO",MO,2016,3691,3484,207,5.6,-9
"Hickory County, MO",MO,2015,3700,3450,250,6.8,17
"Hickory County, MO",MO,2014,3683,3374,309,8.4,4
"Hickory County, MO",MO,2013,3679,3310,369,10.0,76
"Hickory County, MO",MO,2012,3603,3158,445,12.4,46
"Hickory County, MO",MO,2011,3557,3134,423,11.9,-104
"Hickory County, MO",MO,2010,3661,3202,459,12.5,0
"Hidalgo County, NM",NM,2021,1888,1786,102,5.4,-25
"Hidalgo County, NM",NM,2020,1913,1805,108,5.6,-194
"Hidalgo County, NM",NM,2019,2107,2016,91,4.3,-126
"Hidalgo County, NM",NM,2018,2233,2149,84,3.8,79
"Hidalgo County, NM",NM,2017,2154,2045,109,5.1,-65
"Hidalgo County, NM",NM,2016,2219,2095,124,5.6,69
"Hidalgo County, NM",NM,2015,2150,2015,135,6.3,-9
"Hidalgo County, NM",NM,2014,2159,2007,152,7.0,-28
"Hidalgo County, NM",NM,2013,2187,2023,164,7.5,-153
"Hidalgo County, NM",NM,2012,2340,2172,168,7.2,68
"Hidalgo County, NM",NM,2011,2272,2107,165,7.3,-12
"Hidalgo County, NM",NM,2010,2284,2097,187,8.2,0
"Hidalgo County, TX",TX,2021,366220,332109,34111,9.3,8919
"Hidalgo County, TX",TX,2020,357301,315643,41658,11.7,9527
"Hidalgo County, TX",TX,2019,347774,325960,21814,6.3,3383
"Hidalgo County, TX",TX,2018,344391,321529,22862,6.6,3870
"Hidalgo County, TX",TX,2017,340521,314913,25608,7.5,3270
"Hidalgo County, TX",TX,2016,337251,310858,26393,7.8,6132
"Hidalgo County, TX",TX,2015,331119,304695,26424,8.0,-614
"Hidalgo County, TX",TX,2014,331733,302287,29446,8.9,1033
"Hidalgo County, TX",TX,2013,330700,296229,34471,10.4,3508
"Hidalgo County, TX",TX,2012,327192,292711,34481,10.5,549
"Hidalgo County, TX",TX,2011,326643,287651,38992,11.9,7850
"Hidalgo County, TX",TX,2010,318793,281155,37638,11.8,0
"Highland County, OH",OH,2021,17499,16511,988,5.6,103
"Highland County, OH",OH,2020,17396,15886,1510,8.7,179
"Highland County, OH",OH,2019,17217,16316,901,5.2,-9
"Highland County, OH",OH,2018,17226,16276,950,5.5,-7
"Highland County, OH",OH,2017,17233,16210,1023,5.9,235
"Highland County, OH",OH,2016,16998,15913,1085,6.4,3
"Highland County, OH",OH,2015,16995,15902,1093,6.4,-375
"Highland County, OH",OH,2014,17370,16023,1347,7.8,-126
"Highland County, OH",OH,2013,17496,15667,1829,10.5,-117
"Highland County, OH",OH,2012,17613,15781,1832,10.4,-443
"Highland County, OH",OH,2011,18056,15633,2423,13.4,-1159
"Highland County, OH",OH,2010,19215,15888,3327,17.3,0
"Highland County, VA",VA,2021,1223,1188,35,2.9,-10
"Highland County, VA",VA,2020,1233,1187,46,3.7,-34
"Highland County, VA",VA,2019,1267,1233,34,2.7,-1
"Highland County, VA",VA,2018,1268,1233,35,2.8,-37
"Highland County, VA",VA,2017,1305,1263,42,3.2,-3
"Highland County, VA",VA,2016,1308,1268,40,3.1,-37
"Highland County, VA",VA,2015,1345,1298,47,3.5,-80
"Highland County, VA",VA,2014,1425,1371,54,3.8,6
"Highland County, VA",VA,2013,1419,1360,59,4.2,-41
"Highland County, VA",VA,2012,1460,1390,70,4.8,3
"Highland County, VA",VA,2011,1457,1376,81,5.6,10
"Highland County, VA",VA,2010,1447,1355,92,6.4,0
"Highlands County, FL",FL,2021,34977,32919,2058,5.9,353
"Highlands County, FL",FL,2020,34624,31723,2901,8.4,-869
"Highlands County, FL",FL,2019,35493,33817,1676,4.7,-718
"Highlands County, FL",FL,2018,36211,34397,1814,5.0,88
"Highlands County, FL",FL,2017,36123,34046,2077,5.7,277
"Highlands County, FL",FL,2016,35846,33481,2365,6.6,361
"Highlands County, FL",FL,2015,35485,32799,2686,7.6,-328
"Highlands County, FL",FL,2014,35813,32705,3108,8.7,-262
"Highlands County, FL",FL,2013,36075,32494,3581,9.9,-1087
"Highlands County, FL",FL,2012,37162,33227,3935,10.6,-768
"Highlands County, FL",FL,2011,37930,33583,4347,11.5,1031
"Highlands County, FL",FL,2010,36899,32428,4471,12.1,0
"Hill County, MT",MT,2021,7543,7308,235,3.1,-68
"Hill County, MT",MT,2020,7611,7241,370,4.9,-164
"Hill County, MT",MT,2019,7775,7483,292,3.8,33
"Hill County, MT",MT,2018,7742,7466,276,3.6,-101
"Hill County, MT",MT,2017,7843,7541,302,3.9,46
"Hill County, MT",MT,2016,7797,7448,349,4.5,-2
"Hill County, MT",MT,2015,7799,7464,335,4.3,-34
"Hill County, MT",MT,2014,7833,7381,452,5.8,-111
"Hill County, MT",MT,2013,7944,7427,517,6.5,-90
"Hill County, MT",MT,2012,8034,7581,453,5.6,48
"Hill County, MT",MT,2011,7986,7509,477,6.0,-1
"Hill County, MT",MT,2010,7987,7531,456,5.7,0
"Hill County, TX",TX,2021,16822,15980,842,5.0,671
"Hill County, TX",TX,2020,16151,15133,1018,6.3,-51
"Hill County, TX",TX,2019,16202,15663,539,3.3,71
"Hill County, TX",TX,2018,16131,15540,591,3.7,82
"Hill County, TX",TX,2017,16049,15412,637,4.0,237
"Hill County, TX",TX,2016,15812,15114,698,4.4,189
"Hill County, TX",TX,2015,15623,14907,716,4.6,-237
"Hill County, TX",TX,2014,15860,15013,847,5.3,-80
"Hill County, TX",TX,2013,15940,14908,1032,6.5,174
"Hill County, TX",TX,2012,15766,14681,1085,6.9,-121
"Hill County, TX",TX,2011,15887,14537,1350,8.5,-75
"Hill County, TX",TX,2010,15962,14618,1344,8.4,0
"Hillsborough County, FL",FL,2021,769097,736399,32698,4.3,15066
"Hillsborough County, FL",FL,2020,754031,695631,58400,7.7,3469
"Hillsborough County, FL",FL,2019,750562,726662,23900,3.2,19806
"Hillsborough County, FL",FL,2018,730756,705101,25655,3.5,11904
"Hillsborough County, FL",FL,2017,718852,690198,28654,4.0,9314
"Hillsborough County, FL",FL,2016,709538,677812,31726,4.5,17506
"Hillsborough County, FL",FL,2015,692032,656690,35342,5.1,10337
"Hillsborough County, FL",FL,2014,681695,641101,40594,6.0,10191
"Hillsborough County, FL",FL,2013,671504,625343,46161,6.9,7430
"Hillsborough County, FL",FL,2012,664074,609993,54081,8.1,6505
"Hillsborough County, FL",FL,2011,657569,594729,62840,9.6,17455
"Hillsborough County, FL",FL,2010,640114,573638,66476,10.4,0
"Hillsborough County, NH",NH,2021,237144,228610,8534,3.6,-2633
"Hillsborough County, NH",NH,2020,239777,222896,16881,7.0,-3950
"Hillsborough County, NH",NH,2019,243727,237190,6537,2.7,4104
"Hillsborough County, NH",NH,2018,239623,233073,6550,2.7,4400
"Hillsborough County, NH",NH,2017,235223,228253,6970,3.0,2911
"Hillsborough County, NH",NH,2016,232312,225276,7036,3.0,2186
"Hillsborough County, NH",NH,2015,230126,221822,8304,3.6,915
"Hillsborough County, NH",NH,2014,229211,218847,10364,4.5,880
"Hillsborough County, NH",NH,2013,228331,215685,12646,5.5,1515
"Hillsborough County, NH",NH,2012,226816,213815,13001,5.7,1581
"Hillsborough County, NH",NH,2011,225235,212365,12870,5.7,-1263
"Hillsborough County, NH",NH,2010,226498,211916,14582,6.4,0
"Hillsdale County, MI",MI,2021,19704,18630,1074,5.5,-380
"Hillsdale County, MI",MI,2020,20084,18199,1885,9.4,-429
"Hillsdale County, MI",MI,2019,20513,19641,872,4.3,-85
"Hillsdale County, MI",MI,2018,20598,19760,838,4.1,-327
"Hillsdale County, MI",MI,2017,20925,19914,1011,4.8,-308
"Hillsdale County, MI",MI,2016,21233,20150,1083,5.1,104
"Hillsdale County, MI",MI,2015,21129,20005,1124,5.3,583
"Hillsdale County, MI",MI,2014,20546,19106,1440,7.0,-39
"Hillsdale County, MI",MI,2013,20585,18771,1814,8.8,48
"Hillsdale County, MI",MI,2012,20537,18681,1856,9.0,-63
"Hillsdale County, MI",MI,2011,20600,18496,2104,10.2,-671
"Hillsdale County, MI",MI,2010,21271,18474,2797,13.1,0
"Hinds County, MS",MS,2021,101911,95588,6323,6.2,-121
"Hinds County, MS",MS,2020,102032,92650,9382,9.2,-3162
"Hinds County, MS",MS,2019,105194,99638,5556,5.3,-1653
"Hinds County, MS",MS,2018,106847,101675,5172,4.8,-2143
"Hinds County, MS",MS,2017,108990,103552,5438,5.0,-491
"Hinds County, MS",MS,2016,109481,103402,6079,5.6,617
"Hinds County, MS",MS,2015,108864,102227,6637,6.1,1125
"Hinds County, MS",MS,2014,107739,99866,7873,7.3,-3060
"Hinds County, MS",MS,2013,110799,101471,9328,8.4,-6139
"Hinds County, MS",MS,2012,116938,106870,10068,8.6,-1683
"Hinds County, MS",MS,2011,118621,107566,11055,9.3,4483
"Hinds County, MS",MS,2010,114138,103236,10902,9.6,0
"Hinsdale County, CO",CO,2021,450,434,16,3.6,27
"Hinsdale County, CO",CO,2020,423,406,17,4.0,-12
"Hinsdale County, CO",CO,2019,435,421,14,3.2,-4
"Hinsdale County, CO",CO,2018,439,428,11,2.5,-30
"Hinsdale County, CO",CO,2017,469,459,10,2.1,22
"Hinsdale County, CO",CO,2016,447,437,10,2.2,7
"Hinsdale County, CO",CO,2015,440,427,13,3.0,6
"Hinsdale County, CO",CO,2014,434,418,16,3.7,2
"Hinsdale County, CO",CO,2013,432,412,20,4.6,-3
"Hinsdale County, CO",CO,2012,435,414,21,4.8,-36
"Hinsdale County, CO",CO,2011,471,446,25,5.3,3
"Hinsdale County, CO",CO,2010,468,440,28,6.0,0
"Hitchcock County, NE",NE,2021,1325,1295,30,2.3,3
"Hitchcock County, NE",NE,2020,1322,1277,45,3.4,49
"Hitchcock County, NE",NE,2019,1273,1231,42,3.3,5
"Hitchcock County, NE",NE,2018,1268,1224,44,3.5,-6
"Hitchcock County, NE",NE,2017,1274,1230,44,3.5,-39
"Hitchcock County, NE",NE,2016,1313,1266,47,3.6,-13
"Hitchcock County, NE",NE,2015,1326,1283,43,3.2,-16
"Hitchcock County, NE",NE,2014,1342,1296,46,3.4,-17
"Hitchcock County, NE",NE,2013,1359,1305,54,4.0,3
"Hitchcock County, NE",NE,2012,1356,1302,54,4.0,-21
"Hitchcock County, NE",NE,2011,1377,1310,67,4.9,-21
"Hitchcock County, NE",NE,2010,1398,1325,73,5.2,0
"Hocking County, OH",OH,2021,12874,12255,619,4.8,161
"Hocking County, OH",OH,2020,12713,11760,953,7.5,-360
"Hocking County, OH",OH,2019,13073,12463,610,4.7,48
"Hocking County, OH",OH,2018,13025,12363,662,5.1,-123
"Hocking County, OH",OH,2017,13148,12436,712,5.4,85
"Hocking County, OH",OH,2016,13063,12329,734,5.6,6
"Hocking County, OH",OH,2015,13057,12319,738,5.7,-156
"Hocking County, OH",OH,2014,13213,12359,854,6.5,22
"Hocking County, OH",OH,2013,13191,12124,1067,8.1,-364
"Hocking County, OH",OH,2012,13555,12434,1121,8.3,-210
"Hocking County, OH",OH,2011,13765,12397,1368,9.9,-297
"Hocking County, OH",OH,2010,14062,12414,1648,11.7,0
"Hockley County, TX",TX,2021,10657,10015,642,6.0,74
"Hockley County, TX",TX,2020,10583,9741,842,8.0,-552
"Hockley County, TX",TX,2019,11135,10806,329,3.0,-188
"Hockley County, TX",TX,2018,11323,10969,354,3.1,146
"Hockley County, TX",TX,2017,11177,10759,418,3.7,1
"Hockley County, TX",TX,2016,11176,10656,520,4.7,-547
"Hockley County, TX",TX,2015,11723,11232,491,4.2,-348
"Hockley County, TX",TX,2014,12071,11599,472,3.9,171
"Hockley County, TX",TX,2013,11900,11297,603,5.1,136
"Hockley County, TX",TX,2012,11764,11145,619,5.3,412
"Hockley County, TX",TX,2011,11352,10607,745,6.6,306
"Hockley County, TX",TX,2010,11046,10261,785,7.1,0
"Hodgeman County, KS",KS,2021,1036,1017,19,1.8,21
"Hodgeman County, KS",KS,2020,1015,990,25,2.5,21
"Hodgeman County, KS",KS,2019,994,970,24,2.4,5
"Hodgeman County, KS",KS,2018,989,965,24,2.4,-3
"Hodgeman County, KS",KS,2017,992,967,25,2.5,-42
"Hodgeman County, KS",KS,2016,1034,1007,27,2.6,4
"Hodgeman County, KS",KS,2015,1030,998,32,3.1,-6
"Hodgeman County, KS",KS,2014,1036,1001,35,3.4,-82
"Hodgeman County, KS",KS,2013,1118,1075,43,3.8,3
"Hodgeman County, KS",KS,2012,1115,1077,38,3.4,0
"Hodgeman County, KS",KS,2011,1115,1073,42,3.8,29
"Hodgeman County, KS",KS,2010,1086,1046,40,3.7,0
"Hoke County, NC",NC,2021,19848,18568,1280,6.4,372
"Hoke County, NC",NC,2020,19476,17863,1613,8.3,-498
"Hoke County, NC",NC,2019,19974,18999,975,4.9,148
"Hoke County, NC",NC,2018,19826,18814,1012,5.1,191
"Hoke County, NC",NC,2017,19635,18502,1133,5.8,-220
"Hoke County, NC",NC,2016,19855,18545,1310,6.6,52
"Hoke County, NC",NC,2015,19803,18251,1552,7.8,419
"Hoke County, NC",NC,2014,19384,17811,1573,8.1,-394
"Hoke County, NC",NC,2013,19778,17883,1895,9.6,-233
"Hoke County, NC",NC,2012,20011,17822,2189,10.9,451
"Hoke County, NC",NC,2011,19560,17429,2131,10.9,911
"Hoke County, NC",NC,2010,18649,16777,1872,10.0,0
"Holmes County, FL",FL,2021,6935,6652,283,4.1,121
"Holmes County, FL",FL,2020,6814,6407,407,6.0,-73
"Holmes County, FL",FL,2019,6887,6637,250,3.6,54
"Holmes County, FL",FL,2018,6833,6554,279,4.1,-4
"Holmes County, FL",FL,2017,6837,6507,330,4.8,103
"Holmes County, FL",FL,2016,6734,6367,367,5.4,16
"Holmes County, FL",FL,2015,6718,6301,417,6.2,-134
"Holmes County, FL",FL,2014,6852,6361,491,7.2,-144
"Holmes County, FL",FL,2013,6996,6422,574,8.2,-126
"Holmes County, FL",FL,2012,7122,6473,649,9.1,-34
"Holmes County, FL",FL,2011,7156,6452,704,9.8,26
"Holmes County, FL",FL,2010,7130,6414,716,10.0,0
"Holmes County, MS",MS,2021,5208,4635,573,11.0,-232
"Holmes County, MS",MS,2020,5440,4576,864,15.9,-164
"Holmes County, MS",MS,2019,5604,5031,573,10.2,-82
"Holmes County, MS",MS,2018,5686,5165,521,9.2,-124
"Holmes County, MS",MS,2017,5810,5250,560,9.6,-148
"Holmes County, MS",MS,2016,5958,5290,668,11.2,-145
"Holmes County, MS",MS,2015,6103,5360,743,12.2,-23
"Holmes County, MS",MS,2014,6126,5198,928,15.1,-176
"Holmes County, MS",MS,2013,6302,5252,1050,16.7,-375
"Holmes County, MS",MS,2012,6677,5593,1084,16.2,-220
"Holmes County, MS",MS,2011,6897,5688,1209,17.5,55
"Holmes County, MS",MS,2010,6842,5535,1307,19.1,0
"Holmes County, OH",OH,2021,21400,20808,592,2.8,520
"Holmes County, OH",OH,2020,20880,20064,816,3.9,-125
"Holmes County, OH",OH,2019,21005,20368,637,3.0,249
"Holmes County, OH",OH,2018,20756,20080,676,3.3,-158
"Holmes County, OH",OH,2017,20914,20175,739,3.5,-159
"Holmes County, OH",OH,2016,21073,20309,764,3.6,382
"Holmes County, OH",OH,2015,20691,19975,716,3.5,738
"Holmes County, OH",OH,2014,19953,19151,802,4.0,-81
"Holmes County, OH",OH,2013,20034,18991,1043,5.2,279
"Holmes County, OH",OH,2012,19755,18741,1014,5.1,218
"Holmes County, OH",OH,2011,19537,18306,1231,6.3,212
"Holmes County, OH",OH,2010,19325,17841,1484,7.7,0
"Holt County, MO",MO,2021,2479,2406,73,2.9,-60
"Holt County, MO",MO,2020,2539,2454,85,3.3,-30
"Holt County, MO",MO,2019,2569,2501,68,2.6,-75
"Holt County, MO",MO,2018,2644,2582,62,2.3,-46
"Holt County, MO",MO,2017,2690,2613,77,2.9,8
"Holt County, MO",MO,2016,2682,2595,87,3.2,-10
"Holt County, MO",MO,2015,2692,2593,99,3.7,5
"Holt County, MO",MO,2014,2687,2555,132,4.9,-47
"Holt County, MO",MO,2013,2734,2585,149,5.4,59
"Holt County, MO",MO,2012,2675,2529,146,5.5,-12
"Holt County, MO",MO,2011,2687,2489,198,7.4,6
"Holt County, MO",MO,2010,2681,2470,211,7.9,0
"Holt County, NE",NE,2021,5736,5636,100,1.7,-35
"Holt County, NE",NE,2020,5771,5632,139,2.4,-29
"Holt County, NE",NE,2019,5800,5651,149,2.6,-2
"Holt County, NE",NE,2018,5802,5651,151,2.6,-3
"Holt County, NE",NE,2017,5805,5662,143,2.5,-87
"Holt County, NE",NE,2016,5892,5747,145,2.5,2
"Holt County, NE",NE,2015,5890,5750,140,2.4,-35
"Holt County, NE",NE,2014,5925,5769,156,2.6,-70
"Holt County, NE",NE,2013,5995,5811,184,3.1,35
"Holt County, NE",NE,2012,5960,5775,185,3.1,18
"Holt County, NE",NE,2011,5942,5738,204,3.4,120
"Holt County, NE",NE,2010,5822,5608,214,3.7,0
"Honolulu County/city, HI",HI,2021,451661,427780,23881,5.3,2259
"Honolulu County/city, HI",HI,2020,449402,402127,47275,10.5,-14493
"Honolulu County/city, HI",HI,2019,463895,453077,10818,2.3,-5582
"Honolulu County/city, HI",HI,2018,469477,458834,10643,2.3,-3115
"Honolulu County/city, HI",HI,2017,472592,462531,10061,2.1,9222
"Honolulu County/city, HI",HI,2016,463370,450745,12625,2.7,2765
"Honolulu County/city, HI",HI,2015,460605,445679,14926,3.2,3535
"Honolulu County/city, HI",HI,2014,457070,438886,18184,4.0,8354
"Honolulu County/city, HI",HI,2013,448716,429206,19510,4.3,722
"Honolulu County/city, HI",HI,2012,447994,424107,23887,5.3,-6255
"Honolulu County/city, HI",HI,2011,454249,427287,26962,5.9,9129
"Honolulu County/city, HI",HI,2010,445120,418973,26147,5.9,0
"Hood County, TX",TX,2021,28814,27325,1489,5.2,1036
"Hood County, TX",TX,2020,27778,25945,1833,6.6,355
"Hood County, TX",TX,2019,27423,26487,936,3.4,630
"Hood County, TX",TX,2018,26793,25797,996,3.7,1062
"Hood County, TX",TX,2017,25731,24640,1091,4.2,455
"Hood County, TX",TX,2016,25276,24086,1190,4.7,729
"Hood County, TX",TX,2015,24547,23431,1116,4.5,324
"Hood County, TX",TX,2014,24223,23014,1209,5.0,256
"Hood County, TX",TX,2013,23967,22504,1463,6.1,242
"Hood County, TX",TX,2012,23725,22188,1537,6.5,104
"Hood County, TX",TX,2011,23621,21683,1938,8.2,231
"Hood County, TX",TX,2010,23390,21384,2006,8.6,0
"Hood River County, OR",OR,2021,14410,13758,652,4.5,310
"Hood River County, OR",OR,2020,14100,13215,885,6.3,-289
"Hood River County, OR",OR,2019,14389,13940,449,3.1,25
"Hood River County, OR",OR,2018,14364,13902,462,3.2,109
"Hood River County, OR",OR,2017,14255,13753,502,3.5,378
"Hood River County, OR",OR,2016,13877,13312,565,4.1,340
"Hood River County, OR",OR,2015,13537,12914,623,4.6,-279
"Hood River County, OR",OR,2014,13816,13077,739,5.3,-15
"Hood River County, OR",OR,2013,13831,12967,864,6.2,-288
"Hood River County, OR",OR,2012,14119,13097,1022,7.2,-224
"Hood River County, OR",OR,2011,14343,13194,1149,8.0,97
"Hood River County, OR",OR,2010,14246,13058,1188,8.3,0
"Hooker County, NE",NE,2021,430,423,7,1.6,20
"Hooker County, NE",NE,2020,410,399,11,2.7,-13
"Hooker County, NE",NE,2019,423,411,12,2.8,18
"Hooker County, NE",NE,2018,405,390,15,3.7,6
"Hooker County, NE",NE,2017,399,384,15,3.8,5
"Hooker County, NE",NE,2016,394,380,14,3.6,-12
"Hooker County, NE",NE,2015,406,389,17,4.2,-18
"Hooker County, NE",NE,2014,424,406,18,4.2,-9
"Hooker County, NE",NE,2013,433,413,20,4.6,-5
"Hooker County, NE",NE,2012,438,418,20,4.6,-8
"Hooker County, NE",NE,2011,446,426,20,4.5,37
"Hooker County, NE",NE,2010,409,388,21,5.1,0
"Hoonah-Angoon Census Area, AK",AK,2021,1156,1049,107,9.3,101
"Hoonah-Angoon Census Area, AK",AK,2020,1055,908,147,13.9,-136
"Hoonah-Angoon Census Area, AK",AK,2019,1191,1070,121,10.2,42
"Hoonah-Angoon Census Area, AK",AK,2018,1149,1017,132,11.5,12
"Hoonah-Angoon Census Area, AK",AK,2017,1137,1006,131,11.5,-63
"Hoonah-Angoon Census Area, AK",AK,2016,1200,1064,136,11.3,72
"Hoonah-Angoon Census Area, AK",AK,2015,1128,962,166,14.7,-6
"Hoonah-Angoon Census Area, AK",AK,2014,1134,965,169,14.9,15
"Hoonah-Angoon Census Area, AK",AK,2013,1119,954,165,14.7,13
"Hoonah-Angoon Census Area, AK",AK,2012,1106,945,161,14.6,9
"Hoonah-Angoon Census Area, AK",AK,2011,1097,928,169,15.4,30
"Hoonah-Angoon Census Area, AK",AK,2010,1067,912,155,14.5,0
"Hopewell city, VA",VA,2021,9361,8662,699,7.5,-362
"Hopewell city, VA",VA,2020,9723,8676,1047,10.8,-31
"Hopewell city, VA",VA,2019,9754,9337,417,4.3,14
"Hopewell city, VA",VA,2018,9740,9277,463,4.8,-93
"Hopewell city, VA",VA,2017,9833,9236,597,6.1,47
"Hopewell city, VA",VA,2016,9786,9157,629,6.4,131
"Hopewell city, VA",VA,2015,9655,8933,722,7.5,-27
"Hopewell city, VA",VA,2014,9682,8828,854,8.8,32
"Hopewell city, VA",VA,2013,9650,8729,921,9.5,-69
"Hopewell city, VA",VA,2012,9719,8760,959,9.9,-176
"Hopewell city, VA",VA,2011,9895,8779,1116,11.3,11
"Hopewell city, VA",VA,2010,9884,8717,1167,11.8,0
"Hopkins County, KY",KY,2021,18031,17106,925,5.1,10
"Hopkins County, KY",KY,2020,18021,16728,1293,7.2,-432
"Hopkins County, KY",KY,2019,18453,17656,797,4.3,72
"Hopkins County, KY",KY,2018,18381,17559,822,4.5,-1096
"Hopkins County, KY",KY,2017,19477,18525,952,4.9,-160
"Hopkins County, KY",KY,2016,19637,18530,1107,5.6,523
"Hopkins County, KY",KY,2015,19114,18028,1086,5.7,-1308
"Hopkins County, KY",KY,2014,20422,19113,1309,6.4,-1088
"Hopkins County, KY",KY,2013,21510,19827,1683,7.8,-81
"Hopkins County, KY",KY,2012,21591,19917,1674,7.8,-3
"Hopkins County, KY",KY,2011,21594,19775,1819,8.4,276
"Hopkins County, KY",KY,2010,21318,19237,2081,9.8,0
"Hopkins County, TX",TX,2021,17828,17055,773,4.3,494
"Hopkins County, TX",TX,2020,17334,16449,885,5.1,-2
"Hopkins County, TX",TX,2019,17336,16805,531,3.1,181
"Hopkins County, TX",TX,2018,17155,16571,584,3.4,114
"Hopkins County, TX",TX,2017,17041,16423,618,3.6,-290
"Hopkins County, TX",TX,2016,17331,16639,692,4.0,312
"Hopkins County, TX",TX,2015,17019,16298,721,4.2,-446
"Hopkins County, TX",TX,2014,17465,16635,830,4.8,226
"Hopkins County, TX",TX,2013,17239,16238,1001,5.8,194
"Hopkins County, TX",TX,2012,17045,15949,1096,6.4,192
"Hopkins County, TX",TX,2011,16853,15575,1278,7.6,206
"Hopkins County, TX",TX,2010,16647,15401,1246,7.5,0
"Hormigueros Municipio, PR",PR,2021,5988,5462,526,8.8,
"Hormigueros Municipio, PR",PR,2020,N.A.,N.A.,N.A.,N.A.,
"Hormigueros Municipio, PR",PR,2019,5406,4942,464,8.6,-12
"Hormigueros Municipio, PR",PR,2018,5418,4886,532,9.8,-120
"Hormigueros Municipio, PR",PR,2017,5538,4833,705,12.7,-83
"Hormigueros Municipio, PR",PR,2016,5621,4933,688,12.2,38
"Hormigueros Municipio, PR",PR,2015,5583,4934,649,11.6,-79
"Hormigueros Municipio, PR",PR,2014,5662,4836,826,14.6,-197
"Hormigueros Municipio, PR",PR,2013,5859,4863,996,17.0,-57
"Hormigueros Municipio, PR",PR,2012,5916,5036,880,14.9,-33
"Hormigueros Municipio, PR",PR,2011,5949,5019,930,15.6,-306
"Hormigueros Municipio, PR",PR,2010,6255,5232,1023,16.4,0
"Horry County, SC",SC,2021,148763,141225,7538,5.1,4490
"Horry County, SC",SC,2020,144273,132169,12104,8.4,-288
"Horry County, SC",SC,2019,144561,139392,5169,3.6,2671
"Horry County, SC",SC,2018,141890,135888,6002,4.2,1229
"Horry County, SC",SC,2017,140661,133715,6946,4.9,921
"Horry County, SC",SC,2016,139740,131738,8002,5.7,2503
"Horry County, SC",SC,2015,137237,127562,9675,7.0,3093
"Horry County, SC",SC,2014,134144,124494,9650,7.2,927
"Horry County, SC",SC,2013,133217,122022,11195,8.4,362
"Horry County, SC",SC,2012,132855,119373,13482,10.1,-42
"Horry County, SC",SC,2011,132897,117260,15637,11.8,776
"Horry County, SC",SC,2010,132121,115661,16460,12.5,0
"Hot Spring County, AR",AR,2021,13797,13264,533,3.9,-278
"Hot Spring County, AR",AR,2020,14075,13256,819,5.8,12
"Hot Spring County, AR",AR,2019,14063,13565,498,3.5,113
"Hot Spring County, AR",AR,2018,13950,13433,517,3.7,-167
"Hot Spring County, AR",AR,2017,14117,13592,525,3.7,-22
"Hot Spring County, AR",AR,2016,14139,13582,557,3.9,-121
"Hot Spring County, AR",AR,2015,14260,13552,708,5.0,136
"Hot Spring County, AR",AR,2014,14124,13327,797,5.6,-114
"Hot Spring County, AR",AR,2013,14238,13228,1010,7.1,-362
"Hot Spring County, AR",AR,2012,14600,13592,1008,6.9,19
"Hot Spring County, AR",AR,2011,14581,13434,1147,7.9,356
"Hot Spring County, AR",AR,2010,14225,13051,1174,8.3,0
"Hot Springs County, WY",WY,2021,2246,2159,87,3.9,17
"Hot Springs County, WY",WY,2020,2229,2119,110,4.9,35
"Hot Springs County, WY",WY,2019,2194,2116,78,3.6,-45
"Hot Springs County, WY",WY,2018,2239,2157,82,3.7,-100
"Hot Springs County, WY",WY,2017,2339,2245,94,4.0,-86
"Hot Springs County, WY",WY,2016,2425,2308,117,4.8,45
"Hot Springs County, WY",WY,2015,2380,2282,98,4.1,-79
"Hot Springs County, WY",WY,2014,2459,2352,107,4.4,-61
"Hot Springs County, WY",WY,2013,2520,2400,120,4.8,-28
"Hot Springs County, WY",WY,2012,2548,2424,124,4.9,-17
"Hot Springs County, WY",WY,2011,2565,2427,138,5.4,10
"Hot Springs County, WY",WY,2010,2555,2411,144,5.6,0
"Houghton County, MI",MI,2021,15678,14888,790,5.0,-202
"Houghton County, MI",MI,2020,15880,14664,1216,7.7,-372
"Houghton County, MI",MI,2019,16252,15452,800,4.9,73
"Houghton County, MI",MI,2018,16179,15348,831,5.1,-286
"Houghton County, MI",MI,2017,16465,15502,963,5.8,-147
"Houghton County, MI",MI,2016,16612,15585,1027,6.2,-36
"Houghton County, MI",MI,2015,16648,15577,1071,6.4,-330
"Houghton County, MI",MI,2014,16978,15674,1304,7.7,90
"Houghton County, MI",MI,2013,16888,15408,1480,8.8,-81
"Houghton County, MI",MI,2012,16969,15469,1500,8.8,-317
"Houghton County, MI",MI,2011,17286,15697,1589,9.2,-491
"Houghton County, MI",MI,2010,17777,15920,1857,10.4,0
"Houston County, AL",AL,2021,46880,45286,1594,3.4,-341
"Houston County, AL",AL,2020,47221,44396,2825,6.0,207
"Houston County, AL",AL,2019,47014,45523,1491,3.2,942
"Houston County, AL",AL,2018,46072,44221,1851,4.0,851
"Houston County, AL",AL,2017,45221,43200,2021,4.5,1036
"Houston County, AL",AL,2016,44185,41621,2564,5.8,-255
"Houston County, AL",AL,2015,44440,41655,2785,6.3,-784
"Houston County, AL",AL,2014,45224,42172,3052,6.7,-445
"Houston County, AL",AL,2013,45669,42463,3206,7.0,-431
"Houston County, AL",AL,2012,46100,42525,3575,7.8,-694
"Houston County, AL",AL,2011,46794,42767,4027,8.6,331
"Houston County, AL",AL,2010,46463,42261,4202,9.0,0
"Houston County, GA",GA,2021,71710,69142,2568,3.6,1224
"Houston County, GA",GA,2020,70486,66812,3674,5.2,-788
"Houston County, GA",GA,2019,71274,68789,2485,3.5,885
"Houston County, GA",GA,2018,70389,67520,2869,4.1,536
"Houston County, GA",GA,2017,69853,66524,3329,4.8,2182
"Houston County, GA",GA,2016,67671,64005,3666,5.4,2735
"Houston County, GA",GA,2015,64936,61086,3850,5.9,-895
"Houston County, GA",GA,2014,65831,61332,4499,6.8,-1550
"Houston County, GA",GA,2013,67381,62345,5036,7.5,-1134
"Houston County, GA",GA,2012,68515,63085,5430,7.9,292
"Houston County, GA",GA,2011,68223,62446,5777,8.5,964
"Houston County, GA",GA,2010,67259,61498,5761,8.6,0
"Houston County, MN",MN,2021,10158,9868,290,2.9,-258
"Houston County, MN",MN,2020,10416,9952,464,4.5,-90
"Houston County, MN",MN,2019,10506,10148,358,3.4,65
"Houston County, MN",MN,2018,10441,10120,321,3.1,-63
"Houston County, MN",MN,2017,10504,10140,364,3.5,-89
"Houston County, MN",MN,2016,10593,10179,414,3.9,84
"Houston County, MN",MN,2015,10509,10100,409,3.9,130
"Houston County, MN",MN,2014,10379,9909,470,4.5,-109
"Houston County, MN",MN,2013,10488,9955,533,5.1,-95
"Houston County, MN",MN,2012,10583,9964,619,5.8,-105
"Houston County, MN",MN,2011,10688,9948,740,6.9,-152
"Houston County, MN",MN,2010,10840,10005,835,7.7,0
"Houston County, TN",TN,2021,3208,3053,155,4.8,-38
"Houston County, TN",TN,2020,3246,2995,251,7.7,-40
"Houston County, TN",TN,2019,3286,3136,150,4.6,42
"Houston County, TN",TN,2018,3244,3067,177,5.5,40
"Houston County, TN",TN,2017,3204,3017,187,5.8,4
"Houston County, TN",TN,2016,3200,2959,241,7.5,-3
"Houston County, TN",TN,2015,3203,2929,274,8.6,-102
"Houston County, TN",TN,2014,3305,2977,328,9.9,-72
"Houston County, TN",TN,2013,3377,3008,369,10.9,-138
"Houston County, TN",TN,2012,3515,3116,399,11.4,-45
"Houston County, TN",TN,2011,3560,3157,403,11.3,20
"Houston County, TN",TN,2010,3540,3109,431,12.2,0
"Houston County, TX",TX,2021,10581,10068,513,4.8,580
"Houston County, TX",TX,2020,10001,9477,524,5.2,-157
"Houston County, TX",TX,2019,10158,9840,318,3.1,55
"Houston County, TX",TX,2018,10103,9723,380,3.8,-207
"Houston County, TX",TX,2017,10310,9859,451,4.4,243
"Houston County, TX",TX,2016,10067,9602,465,4.6,126
"Houston County, TX",TX,2015,9941,9495,446,4.5,153
"Houston County, TX",TX,2014,9788,9297,491,5.0,-42
"Houston County, TX",TX,2013,9830,9215,615,6.3,-222
"Houston County, TX",TX,2012,10052,9347,705,7.0,-599
"Houston County, TX",TX,2011,10651,9799,852,8.0,99
"Houston County, TX",TX,2010,10552,9739,813,7.7,0
"Howard County, AR",AR,2021,5455,5278,177,3.2,-98
"Howard County, AR",AR,2020,5553,5273,280,5.0,-138
"Howard County, AR",AR,2019,5691,5511,180,3.2,-210
"Howard County, AR",AR,2018,5901,5701,200,3.4,-86
"Howard County, AR",AR,2017,5987,5805,182,3.0,-2
"Howard County, AR",AR,2016,5989,5793,196,3.3,-121
"Howard County, AR",AR,2015,6110,5856,254,4.2,-144
"Howard County, AR",AR,2014,6254,5900,354,5.7,-41
"Howard County, AR",AR,2013,6295,5903,392,6.2,-201
"Howard County, AR",AR,2012,6496,6080,416,6.4,-250
"Howard County, AR",AR,2011,6746,6265,481,7.1,171
"Howard County, AR",AR,2010,6575,6086,489,7.4,0
"Howard County, IA",IA,2021,5126,4930,196,3.8,-11
"Howard County, IA",IA,2020,5137,4914,223,4.3,-133
"Howard County, IA",IA,2019,5270,5129,141,2.7,9
"Howard County, IA",IA,2018,5261,5128,133,2.5,115
"Howard County, IA",IA,2017,5146,4993,153,3.0,-211
"Howard County, IA",IA,2016,5357,5166,191,3.6,-19
"Howard County, IA",IA,2015,5376,5185,191,3.6,60
"Howard County, IA",IA,2014,5316,5101,215,4.0,79
"Howard County, IA",IA,2013,5237,4995,242,4.6,16
"Howard County, IA",IA,2012,5221,4979,242,4.6,-124
"Howard County, IA",IA,2011,5345,5053,292,5.5,16
"Howard County, IA",IA,2010,5329,4985,344,6.5,0
"Howard County, IN",IN,2021,34727,32591,2136,6.2,-2413
"Howard County, IN",IN,2020,37140,33065,4075,11.0,544
"Howard County, IN",IN,2019,36596,35132,1464,4.0,-872
"Howard County, IN",IN,2018,37468,35952,1516,4.0,-505
"Howard County, IN",IN,2017,37973,36537,1436,3.8,-141
"Howard County, IN",IN,2016,38114,36365,1749,4.6,1132
"Howard County, IN",IN,2015,36982,35148,1834,5.0,32
"Howard County, IN",IN,2014,36950,34640,2310,6.3,483
"Howard County, IN",IN,2013,36467,33555,2912,8.0,526
"Howard County, IN",IN,2012,35941,32729,3212,8.9,-179
"Howard County, IN",IN,2011,36120,32428,3692,10.2,328
"Howard County, IN",IN,2010,35792,31402,4390,12.3,0
"Howard County, MD",MD,2021,186574,178469,8105,4.3,-2346
"Howard County, MD",MD,2020,188920,179273,9647,5.1,-5955
"Howard County, MD",MD,2019,194875,189759,5116,2.6,5661
"Howard County, MD",MD,2018,189214,183944,5270,2.8,3075
"Howard County, MD",MD,2017,186139,180542,5597,3.0,7019
"Howard County, MD",MD,2016,179120,173421,5699,3.2,2436
"Howard County, MD",MD,2015,176684,170079,6605,3.7,3299
"Howard County, MD",MD,2014,173385,165997,7388,4.3,2061
"Howard County, MD",MD,2013,171324,163135,8189,4.8,2986
"Howard County, MD",MD,2012,168338,160013,8325,4.9,4359
"Howard County, MD",MD,2011,163979,155375,8604,5.2,3164
"Howard County, MD",MD,2010,160815,151535,9280,5.8,0
"Howard County, MO",MO,2021,4853,4696,157,3.2,50
"Howard County, MO",MO,2020,4803,4605,198,4.1,-53
"Howard County, MO",MO,2019,4856,4714,142,2.9,-106
"Howard County, MO",MO,2018,4962,4823,139,2.8,-112
"Howard County, MO",MO,2017,5074,4881,193,3.8,50
"Howard County, MO",MO,2016,5024,4802,222,4.4,9
"Howard County, MO",MO,2015,5015,4765,250,5.0,45
"Howard County, MO",MO,2014,4970,4701,269,5.4,58
"Howard County, MO",MO,2013,4912,4592,320,6.5,103
"Howard County, MO",MO,2012,4809,4473,336,7.0,-33
"Howard County, MO",MO,2011,4842,4435,407,8.4,-139
"Howard County, MO",MO,2010,4981,4549,432,8.7,0
"Howard County, NE",NE,2021,3439,3364,75,2.2,36
"Howard County, NE",NE,2020,3403,3258,145,4.3,-5
"Howard County, NE",NE,2019,3408,3288,120,3.5,21
"Howard County, NE",NE,2018,3387,3282,105,3.1,38
"Howard County, NE",NE,2017,3349,3246,103,3.1,31
"Howard County, NE",NE,2016,3318,3209,109,3.3,-4
"Howard County, NE",NE,2015,3322,3201,121,3.6,-47
"Howard County, NE",NE,2014,3369,3244,125,3.7,-44
"Howard County, NE",NE,2013,3413,3291,122,3.6,-3
"Howard County, NE",NE,2012,3416,3296,120,3.5,20
"Howard County, NE",NE,2011,3396,3258,138,4.1,54
"Howard County, NE",NE,2010,3342,3191,151,4.5,0
"Howard County, TX",TX,2021,13256,12390,866,6.5,-85
"Howard County, TX",TX,2020,13341,12257,1084,8.1,-515
"Howard County, TX",TX,2019,13856,13427,429,3.1,391
"Howard County, TX",TX,2018,13465,13018,447,3.3,343
"Howard County, TX",TX,2017,13122,12558,564,4.3,-96
"Howard County, TX",TX,2016,13218,12486,732,5.5,-144
"Howard County, TX",TX,2015,13362,12742,620,4.6,-209
"Howard County, TX",TX,2014,13571,12969,602,4.4,28
"Howard County, TX",TX,2013,13543,12807,736,5.4,173
"Howard County, TX",TX,2012,13370,12625,745,5.6,125
"Howard County, TX",TX,2011,13245,12351,894,6.7,1
"Howard County, TX",TX,2010,13244,12287,957,7.2,0
"Howell County, MO",MO,2021,16165,15387,778,4.8,-23
"Howell County, MO",MO,2020,16188,15108,1080,6.7,-184
"Howell County, MO",MO,2019,16372,15743,629,3.8,135
"Howell County, MO",MO,2018,16237,15668,569,3.5,353
"Howell County, MO",MO,2017,15884,15133,751,4.7,-213
"Howell County, MO",MO,2016,16097,15079,1018,6.3,-157
"Howell County, MO",MO,2015,16254,15189,1065,6.6,32
"Howell County, MO",MO,2014,16222,15058,1164,7.2,-147
"Howell County, MO",MO,2013,16369,15075,1294,7.9,-79
"Howell County, MO",MO,2012,16448,15064,1384,8.4,-14
"Howell County, MO",MO,2011,16462,14849,1613,9.8,-528
"Howell County, MO",MO,2010,16990,15165,1825,10.7,0
"Hubbard County, MN",MN,2021,9978,9571,407,4.1,-90
"Hubbard County, MN",MN,2020,10068,9335,733,7.3,-41
"Hubbard County, MN",MN,2019,10109,9530,579,5.7,178
"Hubbard County, MN",MN,2018,9931,9403,528,5.3,63
"Hubbard County, MN",MN,2017,9868,9309,559,5.7,78
"Hubbard County, MN",MN,2016,9790,9154,636,6.5,207
"Hubbard County, MN",MN,2015,9583,8984,599,6.3,121
"Hubbard County, MN",MN,2014,9462,8844,618,6.5,-83
"Hubbard County, MN",MN,2013,9545,8847,698,7.3,-6
"Hubbard County, MN",MN,2012,9551,8779,772,8.1,19
"Hubbard County, MN",MN,2011,9532,8654,878,9.2,-227
"Hubbard County, MN",MN,2010,9759,8789,970,9.9,0
"Hudson County, NJ",NJ,2021,371044,345672,25372,6.8,-2013
"Hudson County, NJ",NJ,2020,373057,334859,38198,10.2,-3106
"Hudson County, NJ",NJ,2019,376163,364450,11713,3.1,5782
"Hudson County, NJ",NJ,2018,370381,356625,13756,3.7,-3138
"Hudson County, NJ",NJ,2017,373519,357634,15885,4.3,12789
"Hudson County, NJ",NJ,2016,360730,344004,16726,4.6,1206
"Hudson County, NJ",NJ,2015,359524,340432,19092,5.3,1370
"Hudson County, NJ",NJ,2014,358154,335475,22679,6.3,-179
"Hudson County, NJ",NJ,2013,358333,329624,28709,8.0,-1954
"Hudson County, NJ",NJ,2012,360287,328173,32114,8.9,2619
"Hudson County, NJ",NJ,2011,357668,325055,32613,9.1,3645
"Hudson County, NJ",NJ,2010,354023,319751,34272,9.7,0
"Hudspeth County, TX",TX,2021,1849,1742,107,5.8,15
"Hudspeth County, TX",TX,2020,1834,1685,149,8.1,-6
"Hudspeth County, TX",TX,2019,1840,1760,80,4.3,55
"Hudspeth County, TX",TX,2018,1785,1703,82,4.6,133
"Hudspeth County, TX",TX,2017,1652,1556,96,5.8,110
"Hudspeth County, TX",TX,2016,1542,1450,92,6.0,260
"Hudspeth County, TX",TX,2015,1282,1209,73,5.7,32
"Hudspeth County, TX",TX,2014,1250,1170,80,6.4,-42
"Hudspeth County, TX",TX,2013,1292,1201,91,7.0,-31
"Hudspeth County, TX",TX,2012,1323,1225,98,7.4,-65
"Hudspeth County, TX",TX,2011,1388,1272,116,8.4,-27
"Hudspeth County, TX",TX,2010,1415,1302,113,8.0,0
"Huerfano County, CO",CO,2021,2645,2428,217,8.2,48
"Huerfano County, CO",CO,2020,2597,2362,235,9.0,91
"Huerfano County, CO",CO,2019,2506,2370,136,5.4,-48
"Huerfano County, CO",CO,2018,2554,2398,156,6.1,29
"Huerfano County, CO",CO,2017,2525,2390,135,5.3,28
"Huerfano County, CO",CO,2016,2497,2346,151,6.0,131
"Huerfano County, CO",CO,2015,2366,2190,176,7.4,-43
"Huerfano County, CO",CO,2014,2409,2169,240,10.0,-127
"Huerfano County, CO",CO,2013,2536,2194,342,13.5,-93
"Huerfano County, CO",CO,2012,2629,2250,379,14.4,-30
"Huerfano County, CO",CO,2011,2659,2285,374,14.1,-44
"Huerfano County, CO",CO,2010,2703,2309,394,14.6,0
"Hughes County, OK",OK,2021,5191,4923,268,5.2,-104
"Hughes County, OK",OK,2020,5295,4892,403,7.6,-8
"Hughes County, OK",OK,2019,5303,5060,243,4.6,-32
"Hughes County, OK",OK,2018,5335,5121,214,4.0,-48
"Hughes County, OK",OK,2017,5383,5098,285,5.3,-120
"Hughes County, OK",OK,2016,5503,5117,386,7.0,-222
"Hughes County, OK",OK,2015,5725,5307,418,7.3,90
"Hughes County, OK",OK,2014,5635,5253,382,6.8,-91
"Hughes County, OK",OK,2013,5726,5281,445,7.8,-17
"Hughes County, OK",OK,2012,5743,5296,447,7.8,296
"Hughes County, OK",OK,2011,5447,4961,486,8.9,-107
"Hughes County, OK",OK,2010,5554,4971,583,10.5,0
"Hughes County, SD",SD,2021,9881,9640,241,2.4,63
"Hughes County, SD",SD,2020,9818,9511,307,3.1,-104
"Hughes County, SD",SD,2019,9922,9696,226,2.3,69
"Hughes County, SD",SD,2018,9853,9621,232,2.4,-152
"Hughes County, SD",SD,2017,10005,9750,255,2.5,-108
"Hughes County, SD",SD,2016,10113,9872,241,2.4,155
"Hughes County, SD",SD,2015,9958,9723,235,2.4,-80
"Hughes County, SD",SD,2014,10038,9784,254,2.5,67
"Hughes County, SD",SD,2013,9971,9686,285,2.9,-53
"Hughes County, SD",SD,2012,10024,9711,313,3.1,-52
"Hughes County, SD",SD,2011,10076,9720,356,3.5,-28
"Hughes County, SD",SD,2010,10104,9758,346,3.4,0
"Humacao Municipio, PR",PR,2021,18437,16967,1470,8.0,
"Humacao Municipio, PR",PR,2020,N.A.,N.A.,N.A.,N.A.,
"Humacao Municipio, PR",PR,2019,17175,15444,1731,10.1,121
"Humacao Municipio, PR",PR,2018,17054,15084,1970,11.6,-320
"Humacao Municipio, PR",PR,2017,17374,14948,2426,14.0,-93
"Humacao Municipio, PR",PR,2016,17467,15004,2463,14.1,-179
"Humacao Municipio, PR",PR,2015,17646,15044,2602,14.7,-328
"Humacao Municipio, PR",PR,2014,17974,14868,3106,17.3,-565
"Humacao Municipio, PR",PR,2013,18539,15140,3399,18.3,-672
"Humacao Municipio, PR",PR,2012,19211,15422,3789,19.7,-418
"Humacao Municipio, PR",PR,2011,19629,15429,4200,21.4,-601
"Humacao Municipio, PR",PR,2010,20230,15958,4272,21.1,0
"Humboldt County, CA",CA,2021,58714,55053,3661,6.2,-939
"Humboldt County, CA",CA,2020,59653,54515,5138,8.6,-2561
"Humboldt County, CA",CA,2019,62214,59932,2282,3.7,-316
"Humboldt County, CA",CA,2018,62530,60251,2279,3.6,44
"Humboldt County, CA",CA,2017,62486,59842,2644,4.2,62
"Humboldt County, CA",CA,2016,62424,59338,3086,4.9,134
"Humboldt County, CA",CA,2015,62290,58782,3508,5.6,55
"Humboldt County, CA",CA,2014,62235,58036,4199,6.7,-595
"Humboldt County, CA",CA,2013,62830,57671,5159,8.2,-1298
"Humboldt County, CA",CA,2012,64128,57888,6240,9.7,-826
"Humboldt County, CA",CA,2011,64954,57998,6956,10.7,-1110
"Humboldt County, CA",CA,2010,66064,58933,7131,10.8,0
"Humboldt County, IA",IA,2021,4946,4775,171,3.5,-28
"Humboldt County, IA",IA,2020,4974,4769,205,4.1,-251
"Humboldt County, IA",IA,2019,5225,5093,132,2.5,-41
"Humboldt County, IA",IA,2018,5266,5134,132,2.5,-45
"Humboldt County, IA",IA,2017,5311,5152,159,3.0,-104
"Humboldt County, IA",IA,2016,5415,5260,155,2.9,72
"Humboldt County, IA",IA,2015,5343,5167,176,3.3,83
"Humboldt County, IA",IA,2014,5260,5061,199,3.8,37
"Humboldt County, IA",IA,2013,5223,5010,213,4.1,45
"Humboldt County, IA",IA,2012,5178,4958,220,4.2,-14
"Humboldt County, IA",IA,2011,5192,4926,266,5.1,-20
"Humboldt County, IA",IA,2010,5212,4938,274,5.3,0
"Humboldt County, NV",NV,2021,8158,7879,279,3.4,153
"Humboldt County, NV",NV,2020,8005,7603,402,5.0,-331
"Humboldt County, NV",NV,2019,8336,8089,247,3.0,331
"Humboldt County, NV",NV,2018,8005,7739,266,3.3,18
"Humboldt County, NV",NV,2017,7987,7648,339,4.2,-3
"Humboldt County, NV",NV,2016,7990,7545,445,5.6,-201
"Humboldt County, NV",NV,2015,8191,7694,497,6.1,-334
"Humboldt County, NV",NV,2014,8525,7953,572,6.7,-472
"Humboldt County, NV",NV,2013,8997,8400,597,6.6,-48
"Humboldt County, NV",NV,2012,9045,8426,619,6.8,402
"Humboldt County, NV",NV,2011,8643,7953,690,8.0,249
"Humboldt County, NV",NV,2010,8394,7658,736,8.8,0
"Humphreys County, MS",MS,2021,2068,1805,263,12.7,-113
"Humphreys County, MS",MS,2020,2181,1866,315,14.4,-5
"Humphreys County, MS",MS,2019,2186,1963,223,10.2,-7
"Humphreys County, MS",MS,2018,2193,1995,198,9.0,-7
"Humphreys County, MS",MS,2017,2200,1987,213,9.7,-166
"Humphreys County, MS",MS,2016,2366,2091,275,11.6,-96
"Humphreys County, MS",MS,2015,2462,2147,315,12.8,-95
"Humphreys County, MS",MS,2014,2557,2148,409,16.0,-495
"Humphreys County, MS",MS,2013,3052,2531,521,17.1,-146
"Humphreys County, MS",MS,2012,3198,2599,599,18.7,-226
"Humphreys County, MS",MS,2011,3424,2803,621,18.1,-57
"Humphreys County, MS",MS,2010,3481,2897,584,16.8,0
"Humphreys County, TN",TN,2021,8650,8316,334,3.9,-42
"Humphreys County, TN",TN,2020,8692,8160,532,6.1,-292
"Humphreys County, TN",TN,2019,8984,8641,343,3.8,136
"Humphreys County, TN",TN,2018,8848,8470,378,4.3,49
"Humphreys County, TN",TN,2017,8799,8417,382,4.3,152
"Humphreys County, TN",TN,2016,8647,8126,521,6.0,162
"Humphreys County, TN",TN,2015,8485,7916,569,6.7,81
"Humphreys County, TN",TN,2014,8404,7745,659,7.8,-272
"Humphreys County, TN",TN,2013,8676,7915,761,8.8,25
"Humphreys County, TN",TN,2012,8651,7815,836,9.7,-179
"Humphreys County, TN",TN,2011,8830,7892,938,10.6,-62
"Humphreys County, TN",TN,2010,8892,7881,1011,11.4,0
"Hunt County, TX",TX,2021,44928,42619,2309,5.1,1988
"Hunt County, TX",TX,2020,42940,40114,2826,6.6,-268
"Hunt County, TX",TX,2019,43208,41663,1545,3.6,1113
"Hunt County, TX",TX,2018,42095,40480,1615,3.8,1020
"Hunt County, TX",TX,2017,41075,39423,1652,4.0,543
"Hunt County, TX",TX,2016,40532,38793,1739,4.3,1605
"Hunt County, TX",TX,2015,38927,37071,1856,4.8,404
"Hunt County, TX",TX,2014,38523,36214,2309,6.0,414
"Hunt County, TX",TX,2013,38109,35251,2858,7.5,-218
"Hunt County, TX",TX,2012,38327,35173,3154,8.2,-111
"Hunt County, TX",TX,2011,38438,34930,3508,9.1,254
"Hunt County, TX",TX,2010,38184,34765,3419,9.0,0
"Hunterdon County, NJ",NJ,2021,66384,63356,3028,4.6,601
"Hunterdon County, NJ",NJ,2020,65783,61218,4565,6.9,-1600
"Hunterdon County, NJ",NJ,2019,67383,65629,1754,2.6,1149
"Hunterdon County, NJ",NJ,2018,66234,64187,2047,3.1,366
"Hunterdon County, NJ",NJ,2017,65868,63591,2277,3.5,1294
"Hunterdon County, NJ",NJ,2016,64574,62163,2411,3.7,-432
"Hunterdon County, NJ",NJ,2015,65006,62282,2724,4.2,-494
"Hunterdon County, NJ",NJ,2014,65500,62323,3177,4.9,-824
"Hunterdon County, NJ",NJ,2013,66324,62370,3954,6.0,-1090
"Hunterdon County, NJ",NJ,2012,67414,62776,4638,6.9,-327
"Hunterdon County, NJ",NJ,2011,67741,63055,4686,6.9,-634
"Hunterdon County, NJ",NJ,2010,68375,63243,5132,7.5,0
"Huntingdon County, PA",PA,2021,19181,17776,1405,7.3,-645
"Huntingdon County, PA",PA,2020,19826,17736,2090,10.5,-298
"Huntingdon County, PA",PA,2019,20124,18906,1218,6.1,98
"Huntingdon County, PA",PA,2018,20026,18923,1103,5.5,41
"Huntingdon County, PA",PA,2017,19985,18769,1216,6.1,298
"Huntingdon County, PA",PA,2016,19687,18326,1361,6.9,3
"Huntingdon County, PA",PA,2015,19684,18276,1408,7.2,-162
"Huntingdon County, PA",PA,2014,19846,18260,1586,8.0,-406
"Huntingdon County, PA",PA,2013,20252,18323,1929,9.5,-466
"Huntingdon County, PA",PA,2012,20718,18704,2014,9.7,-235
"Huntingdon County, PA",PA,2011,20953,18879,2074,9.9,-81
"Huntingdon County, PA",PA,2010,21034,18844,2190,10.4,0
"Huntington County, IN",IN,2021,18004,17472,532,3.0,-56
"Huntington County, IN",IN,2020,18060,16857,1203,6.7,-292
"Huntington County, IN",IN,2019,18352,17759,593,3.2,-49
"Huntington County, IN",IN,2018,18401,17757,644,3.5,-2
"Huntington County, IN",IN,2017,18403,17752,651,3.5,-304
"Huntington County, IN",IN,2016,18707,17958,749,4.0,68
"Huntington County, IN",IN,2015,18639,17828,811,4.4,80
"Huntington County, IN",IN,2014,18559,17486,1073,5.8,8
"Huntington County, IN",IN,2013,18551,17146,1405,7.6,-50
"Huntington County, IN",IN,2012,18601,16987,1614,8.7,-589
"Huntington County, IN",IN,2011,19190,17344,1846,9.6,155
"Huntington County, IN",IN,2010,19035,16828,2207,11.6,0
"Huron County, MI",MI,2021,14854,14058,796,5.4,-560
"Huron County, MI",MI,2020,15414,14048,1366,8.9,-22
"Huron County, MI",MI,2019,15436,14744,692,4.5,-32
"Huron County, MI",MI,2018,15468,14747,721,4.7,-141
"Huron County, MI",MI,2017,15609,14815,794,5.1,-433
"Huron County, MI",MI,2016,16042,15204,838,5.2,-402
"Huron County, MI",MI,2015,16444,15546,898,5.5,-136
"Huron County, MI",MI,2014,16580,15439,1141,6.9,192
"Huron County, MI",MI,2013,16388,15031,1357,8.3,-65
"Huron County, MI",MI,2012,16453,15146,1307,7.9,76
"Huron County, MI",MI,2011,16377,14849,1528,9.3,-104
"Huron County, MI",MI,2010,16481,14486,1995,12.1,0
"Huron County, OH",OH,2021,27725,26108,1617,5.8,230
"Huron County, OH",OH,2020,27495,24892,2603,9.5,-723
"Huron County, OH",OH,2019,28218,26582,1636,5.8,121
"Huron County, OH",OH,2018,28097,26449,1648,5.9,-213
"Huron County, OH",OH,2017,28310,26499,1811,6.4,79
"Huron County, OH",OH,2016,28231,26380,1851,6.6,518
"Huron County, OH",OH,2015,27713,25869,1844,6.7,-244
"Huron County, OH",OH,2014,27957,25723,2234,8.0,-683
"Huron County, OH",OH,2013,28640,25718,2922,10.2,-319
"Huron County, OH",OH,2012,28959,26096,2863,9.9,-662
"Huron County, OH",OH,2011,29621,26259,3362,11.4,-711
"Huron County, OH",OH,2010,30332,26322,4010,13.2,0
"Hutchinson County, SD",SD,2021,3604,3492,112,3.1,16
"Hutchinson County, SD",SD,2020,3588,3461,127,3.5,16
"Hutchinson County, SD",SD,2019,3572,3478,94,2.6,11
"Hutchinson County, SD",SD,2018,3561,3471,90,2.5,-44
"Hutchinson County, SD",SD,2017,3605,3503,102,2.8,-63
"Hutchinson County, SD",SD,2016,3668,3574,94,2.6,-29
"Hutchinson County, SD",SD,2015,3697,3607,90,2.4,13
"Hutchinson County, SD",SD,2014,3684,3581,103,2.8,-6
"Hutchinson County, SD",SD,2013,3690,3573,117,3.2,-63
"Hutchinson County, SD",SD,2012,3753,3630,123,3.3,-69
"Hutchinson County, SD",SD,2011,3822,3680,142,3.7,-2
"Hutchinson County, SD",SD,2010,3824,3673,151,3.9,0
"Hutchinson County, TX",TX,2021,8498,7987,511,6.0,62
"Hutchinson County, TX",TX,2020,8436,7832,604,7.2,-126
"Hutchinson County, TX",TX,2019,8562,8182,380,4.4,-348
"Hutchinson County, TX",TX,2018,8910,8463,447,5.0,-419
"Hutchinson County, TX",TX,2017,9329,8762,567,6.1,-310
"Hutchinson County, TX",TX,2016,9639,9095,544,5.6,-162
"Hutchinson County, TX",TX,2015,9801,9365,436,4.4,-702
"Hutchinson County, TX",TX,2014,10503,10038,465,4.4,746
"Hutchinson County, TX",TX,2013,9757,9149,608,6.2,-48
"Hutchinson County, TX",TX,2012,9805,9171,634,6.5,-110
"Hutchinson County, TX",TX,2011,9915,9104,811,8.2,192
"Hutchinson County, TX",TX,2010,9723,8895,828,8.5,0
"Hyde County, NC",NC,2021,1767,1652,115,6.5,19
"Hyde County, NC",NC,2020,1748,1572,176,10.1,-157
"Hyde County, NC",NC,2019,1905,1744,161,8.5,-81
"Hyde County, NC",NC,2018,1986,1822,164,8.3,-84
"Hyde County, NC",NC,2017,2070,1896,174,8.4,-33
"Hyde County, NC",NC,2016,2103,1904,199,9.5,-38
"Hyde County, NC",NC,2015,2141,1948,193,9.0,-56
"Hyde County, NC",NC,2014,2197,2001,196,8.9,33
"Hyde County, NC",NC,2013,2164,1919,245,11.3,12
"Hyde County, NC",NC,2012,2152,1856,296,13.8,25
"Hyde County, NC",NC,2011,2127,1841,286,13.4,-115
"Hyde County, NC",NC,2010,2242,1996,246,11.0,0
"Hyde County, SD",SD,2021,649,632,17,2.6,-17
"Hyde County, SD",SD,2020,666,646,20,3.0,-17
"Hyde County, SD",SD,2019,683,663,20,2.9,8
"Hyde County, SD",SD,2018,675,657,18,2.7,-8
"Hyde County, SD",SD,2017,683,663,20,2.9,-19
"Hyde County, SD",SD,2016,702,683,19,2.7,-10
"Hyde County, SD",SD,2015,712,692,20,2.8,-5
"Hyde County, SD",SD,2014,717,697,20,2.8,-6
"Hyde County, SD",SD,2013,723,699,24,3.3,-50
"Hyde County, SD",SD,2012,773,747,26,3.4,-20
"Hyde County, SD",SD,2011,793,765,28,3.5,-6
"Hyde County, SD",SD,2010,799,769,30,3.8,0
"Iberia Parish, LA",LA,2021,27669,25757,1912,6.9,176
"Iberia Parish, LA",LA,2020,27493,24724,2769,10.1,-390
"Iberia Parish, LA",LA,2019,27883,26421,1462,5.2,-491
"Iberia Parish, LA",LA,2018,28374,26728,1646,5.8,-613
"Iberia Parish, LA",LA,2017,28987,26871,2116,7.3,-1163
"Iberia Parish, LA",LA,2016,30150,27315,2835,9.4,-1543
"Iberia Parish, LA",LA,2015,31693,29138,2555,8.1,-736
"Iberia Parish, LA",LA,2014,32429,30419,2010,6.2,132
"Iberia Parish, LA",LA,2013,32297,30296,2001,6.2,-91
"Iberia Parish, LA",LA,2012,32388,30297,2091,6.5,395
"Iberia Parish, LA",LA,2011,31993,29588,2405,7.5,-218
"Iberia Parish, LA",LA,2010,32211,29584,2627,8.2,0
"Iberville Parish, LA",LA,2021,13659,12679,980,7.2,17
"Iberville Parish, LA",LA,2020,13642,12212,1430,10.5,-359
"Iberville Parish, LA",LA,2019,14001,13197,804,5.7,-189
"Iberville Parish, LA",LA,2018,14190,13322,868,6.1,11
"Iberville Parish, LA",LA,2017,14179,13306,873,6.2,53
"Iberville Parish, LA",LA,2016,14126,13157,969,6.9,-221
"Iberville Parish, LA",LA,2015,14347,13305,1042,7.3,44
"Iberville Parish, LA",LA,2014,14303,13205,1098,7.7,272
"Iberville Parish, LA",LA,2013,14031,12909,1122,8.0,93
"Iberville Parish, LA",LA,2012,13938,12690,1248,9.0,-70
"Iberville Parish, LA",LA,2011,14008,12627,1381,9.9,6
"Iberville Parish, LA",LA,2010,14002,12674,1328,9.5,0
"Ida County, IA",IA,2021,3978,3852,126,3.2,-30
"Ida County, IA",IA,2020,4008,3868,140,3.5,-203
"Ida County, IA",IA,2019,4211,4132,79,1.9,60
"Ida County, IA",IA,2018,4151,4070,81,2.0,88
"Ida County, IA",IA,2017,4063,3970,93,2.3,17
"Ida County, IA",IA,2016,4046,3944,102,2.5,85
"Ida County, IA",IA,2015,3961,3839,122,3.1,71
"Ida County, IA",IA,2014,3890,3751,139,3.6,72
"Ida County, IA",IA,2013,3818,3666,152,4.0,30
"Ida County, IA",IA,2012,3788,3635,153,4.0,-21
"Ida County, IA",IA,2011,3809,3621,188,4.9,-27
"Ida County, IA",IA,2010,3836,3637,199,5.2,0
"Idaho County, ID",ID,2021,6822,6487,335,4.9,84
"Idaho County, ID",ID,2020,6738,6279,459,6.8,105
"Idaho County, ID",ID,2019,6633,6331,302,4.6,160
"Idaho County, ID",ID,2018,6473,6166,307,4.7,120
"Idaho County, ID",ID,2017,6353,6038,315,5.0,19
"Idaho County, ID",ID,2016,6334,5986,348,5.5,-58
"Idaho County, ID",ID,2015,6392,6023,369,5.8,-55
"Idaho County, ID",ID,2014,6447,6004,443,6.9,-223
"Idaho County, ID",ID,2013,6670,5938,732,11.0,-9
"Idaho County, ID",ID,2012,6679,5932,747,11.2,9
"Idaho County, ID",ID,2011,6670,5863,807,12.1,10
"Idaho County, ID",ID,2010,6660,5845,815,12.2,0
"Imperial County, CA",CA,2021,69075,57094,11981,17.3,-2453
"Imperial County, CA",CA,2020,71528,55218,16310,22.8,-2227
"Imperial County, CA",CA,2019,73755,58358,15397,20.9,2592
"Imperial County, CA",CA,2018,71163,57736,13427,18.9,-886
"Imperial County, CA",CA,2017,72049,57886,14163,19.7,-3137
"Imperial County, CA",CA,2016,75186,56998,18188,24.2,-1564
"Imperial County, CA",CA,2015,76750,57864,18886,24.6,-1514
"Imperial County, CA",CA,2014,78264,59281,18983,24.3,99
"Imperial County, CA",CA,2013,78165,58391,19774,25.3,-1182
"Imperial County, CA",CA,2012,79347,57355,21992,27.7,-264
"Imperial County, CA",CA,2011,79611,56301,23310,29.3,513
"Imperial County, CA",CA,2010,79098,55836,23262,29.4,0
"Independence County, AR",AR,2021,16368,15734,634,3.9,-369
"Independence County, AR",AR,2020,16737,15770,967,5.8,151
"Independence County, AR",AR,2019,16586,15940,646,3.9,304
"Independence County, AR",AR,2018,16282,15632,650,4.0,142
"Independence County, AR",AR,2017,16140,15451,689,4.3,101
"Independence County, AR",AR,2016,16039,15243,796,5.0,306
"Independence County, AR",AR,2015,15733,14731,1002,6.4,143
"Independence County, AR",AR,2014,15590,14403,1187,7.6,-299
"Independence County, AR",AR,2013,15889,14492,1397,8.8,-244
"Independence County, AR",AR,2012,16133,14708,1425,8.8,-506
"Independence County, AR",AR,2011,16639,15154,1485,8.9,-403
"Independence County, AR",AR,2010,17042,15596,1446,8.5,0
"Indian River County, FL",FL,2021,65119,62043,3076,4.7,968
"Indian River County, FL",FL,2020,64151,59027,5124,8.0,-910
"Indian River County, FL",FL,2019,65061,62496,2565,3.9,609
"Indian River County, FL",FL,2018,64452,61580,2872,4.5,997
"Indian River County, FL",FL,2017,63455,60211,3244,5.1,1061
"Indian River County, FL",FL,2016,62394,58604,3790,6.1,934
"Indian River County, FL",FL,2015,61460,57212,4248,6.9,-220
"Indian River County, FL",FL,2014,61680,56676,5004,8.1,279
"Indian River County, FL",FL,2013,61401,55238,6163,10.0,-259
"Indian River County, FL",FL,2012,61660,54700,6960,11.3,87
"Indian River County, FL",FL,2011,61573,53791,7782,12.6,790
"Indian River County, FL",FL,2010,60783,52594,8189,13.5,0
"Indiana County, PA",PA,2021,37090,34461,2629,7.1,-1042
"Indiana County, PA",PA,2020,38132,34661,3471,9.1,-1359
"Indiana County, PA",PA,2019,39491,37451,2040,5.2,292
"Indiana County, PA",PA,2018,39199,37198,2001,5.1,-412
"Indiana County, PA",PA,2017,39611,37264,2347,5.9,-606
"Indiana County, PA",PA,2016,40217,37321,2896,7.2,-1560
"Indiana County, PA",PA,2015,41777,39092,2685,6.4,-1386
"Indiana County, PA",PA,2014,43163,40512,2651,6.1,-773
"Indiana County, PA",PA,2013,43936,40647,3289,7.5,-725
"Indiana County, PA",PA,2012,44661,41116,3545,7.9,721
"Indiana County, PA",PA,2011,43940,40556,3384,7.7,4
"Indiana County, PA",PA,2010,43936,40233,3703,8.4,0
"Ingham County, MI",MI,2021,141678,133763,7915,5.6,-4627
"Ingham County, MI",MI,2020,146305,134870,11435,7.8,-4927
"Ingham County, MI",MI,2019,151232,145801,5431,3.6,-148
"Ingham County, MI",MI,2018,151380,145837,5543,3.7,147
"Ingham County, MI",MI,2017,151233,144847,6386,4.2,1916
"Ingham County, MI",MI,2016,149317,142853,6464,4.3,2811
"Ingham County, MI",MI,2015,146506,139586,6920,4.7,779
"Ingham County, MI",MI,2014,145727,136700,9027,6.2,1031
"Ingham County, MI",MI,2013,144696,133742,10954,7.6,951
"Ingham County, MI",MI,2012,143745,132626,11119,7.7,-1143
"Ingham County, MI",MI,2011,144888,132587,12301,8.5,-2256
"Ingham County, MI",MI,2010,147144,132451,14693,10.0,0
"Inyo County, CA",CA,2021,8229,7745,484,5.9,-76
"Inyo County, CA",CA,2020,8305,7637,668,8.0,-462
"Inyo County, CA",CA,2019,8767,8452,315,3.6,63
"Inyo County, CA",CA,2018,8704,8361,343,3.9,100
"Inyo County, CA",CA,2017,8604,8226,378,4.4,-256
"Inyo County, CA",CA,2016,8860,8390,470,5.3,-221
"Inyo County, CA",CA,2015,9081,8552,529,5.8,-111
"Inyo County, CA",CA,2014,9192,8558,634,6.9,-164
"Inyo County, CA",CA,2013,9356,8613,743,7.9,-180
"Inyo County, CA",CA,2012,9536,8656,880,9.2,-127
"Inyo County, CA",CA,2011,9663,8707,956,9.9,-92
"Inyo County, CA",CA,2010,9755,8783,972,10.0,0
"Ionia County, MI",MI,2021,29513,28105,1408,4.8,-606
"Ionia County, MI",MI,2020,30119,27633,2486,8.3,-255
"Ionia County, MI",MI,2019,30374,29319,1055,3.5,413
"Ionia County, MI",MI,2018,29961,28917,1044,3.5,122
"Ionia County, MI",MI,2017,29839,28675,1164,3.9,104
"Ionia County, MI",MI,2016,29735,28468,1267,4.3,239
"Ionia County, MI",MI,2015,29496,28131,1365,4.6,191
"Ionia County, MI",MI,2014,29305,27486,1819,6.2,427
"Ionia County, MI",MI,2013,28878,26603,2275,7.9,147
"Ionia County, MI",MI,2012,28731,26325,2406,8.4,-314
"Ionia County, MI",MI,2011,29045,26321,2724,9.4,-599
"Ionia County, MI",MI,2010,29644,26215,3429,11.6,0
"Iosco County, MI",MI,2021,9819,9110,709,7.2,-288
"Iosco County, MI",MI,2020,10107,8999,1108,11.0,-88
"Iosco County, MI",MI,2019,10195,9576,619,6.1,110
"Iosco County, MI",MI,2018,10085,9439,646,6.4,-46
"Iosco County, MI",MI,2017,10131,9396,735,7.3,-10
"Iosco County, MI",MI,2016,10141,9395,746,7.4,-6
"Iosco County, MI",MI,2015,10147,9373,774,7.6,-177
"Iosco County, MI",MI,2014,10324,9317,1007,9.8,98
"Iosco County, MI",MI,2013,10226,9067,1159,11.3,39
"Iosco County, MI",MI,2012,10187,9057,1130,11.1,92
"Iosco County, MI",MI,2011,10095,8850,1245,12.3,-170
"Iosco County, MI",MI,2010,10265,8689,1576,15.4,0
"Iowa County, IA",IA,2021,9966,9590,376,3.8,-171
"Iowa County, IA",IA,2020,10137,9701,436,4.3,-608
"Iowa County, IA",IA,2019,10745,10519,226,2.1,167
"Iowa County, IA",IA,2018,10578,10360,218,2.1,44
"Iowa County, IA",IA,2017,10534,10263,271,2.6,-79
"Iowa County, IA",IA,2016,10613,10286,327,3.1,230
"Iowa County, IA",IA,2015,10383,10022,361,3.5,177
"Iowa County, IA",IA,2014,10206,9781,425,4.2,265
"Iowa County, IA",IA,2013,9941,9529,412,4.1,308
"Iowa County, IA",IA,2012,9633,9198,435,4.5,-15
"Iowa County, IA",IA,2011,9648,9158,490,5.1,14
"Iowa County, IA",IA,2010,9634,9096,538,5.6,0
"Iowa County, WI",WI,2021,13712,13249,463,3.4,144
"Iowa County, WI",WI,2020,13568,12733,835,6.2,-170
"Iowa County, WI",WI,2019,13738,13362,376,2.7,-101
"Iowa County, WI",WI,2018,13839,13481,358,2.6,-5
"Iowa County, WI",WI,2017,13844,13440,404,2.9,183
"Iowa County, WI",WI,2016,13661,13195,466,3.4,2
"Iowa County, WI",WI,2015,13659,13093,566,4.1,122
"Iowa County, WI",WI,2014,13537,12854,683,5.0,-4
"Iowa County, WI",WI,2013,13541,12670,871,6.4,7
"Iowa County, WI",WI,2012,13534,12646,888,6.6,-187
"Iowa County, WI",WI,2011,13721,12738,983,7.2,-58
"Iowa County, WI",WI,2010,13779,12665,1114,8.1,0
"Iredell County, NC",NC,2021,89608,85477,4131,4.6,1921
"Iredell County, NC",NC,2020,87687,81501,6186,7.1,-1321
"Iredell County, NC",NC,2019,89008,85823,3185,3.6,2386
"Iredell County, NC",NC,2018,86622,83431,3191,3.7,1350
"Iredell County, NC",NC,2017,85272,81647,3625,4.3,972
"Iredell County, NC",NC,2016,84300,80244,4056,4.8,2201
"Iredell County, NC",NC,2015,82099,77644,4455,5.4,2148
"Iredell County, NC",NC,2014,79951,75063,4888,6.1,395
"Iredell County, NC",NC,2013,79556,73084,6472,8.1,-394
"Iredell County, NC",NC,2012,79950,71826,8124,10.2,1003
"Iredell County, NC",NC,2011,78947,69966,8981,11.4,7
"Iredell County, NC",NC,2010,78940,68868,10072,12.8,0
"Irion County, TX",TX,2021,773,735,38,4.9,21
"Irion County, TX",TX,2020,752,707,45,6.0,-1
"Irion County, TX",TX,2019,753,735,18,2.4,-6
"Irion County, TX",TX,2018,759,736,23,3.0,9
"Irion County, TX",TX,2017,750,727,23,3.1,-30
"Irion County, TX",TX,2016,780,755,25,3.2,-19
"Irion County, TX",TX,2015,799,770,29,3.6,-32
"Irion County, TX",TX,2014,831,800,31,3.7,-18
"Irion County, TX",TX,2013,849,813,36,4.2,0
"Irion County, TX",TX,2012,849,811,38,4.5,-27
"Irion County, TX",TX,2011,876,827,49,5.6,2
"Irion County, TX",TX,2010,874,828,46,5.3,0
"Iron County, MI",MI,2021,4742,4454,288,6.1,-186
"Iron County, MI",MI,2020,4928,4505,423,8.6,-194
"Iron County, MI",MI,2019,5122,4834,288,5.6,-19
"Iron County, MI",MI,2018,5141,4852,289,5.6,-23
"Iron County, MI",MI,2017,5164,4838,326,6.3,-69
"Iron County, MI",MI,2016,5233,4891,342,6.5,0
"Iron County, MI",MI,2015,5233,4859,374,7.1,18
"Iron County, MI",MI,2014,5215,4761,454,8.7,128
"Iron County, MI",MI,2013,5087,4575,512,10.1,-12
"Iron County, MI",MI,2012,5099,4618,481,9.4,-59
"Iron County, MI",MI,2011,5158,4645,513,9.9,-87
"Iron County, MI",MI,2010,5245,4635,610,11.6,0
"Iron County, MO",MO,2021,3491,3289,202,5.8,6
"Iron County, MO",MO,2020,3485,3240,245,7.0,-15
"Iron County, MO",MO,2019,3500,3341,159,4.5,-29
"Iron County, MO",MO,2018,3529,3341,188,5.3,-49
"Iron County, MO",MO,2017,3578,3349,229,6.4,-132
"Iron County, MO",MO,2016,3710,3445,265,7.1,-120
"Iron County, MO",MO,2015,3830,3521,309,8.1,-81
"Iron County, MO",MO,2014,3911,3523,388,9.9,-10
"Iron County, MO",MO,2013,3921,3501,420,10.7,193
"Iron County, MO",MO,2012,3728,3290,438,11.7,171
"Iron County, MO",MO,2011,3557,3048,509,14.3,3
"Iron County, MO",MO,2010,3554,2966,588,16.5,0
"Iron County, UT",UT,2021,26265,25519,746,2.8,993
"Iron County, UT",UT,2020,25272,24126,1146,4.5,954
"Iron County, UT",UT,2019,24318,23606,712,2.9,1267
"Iron County, UT",UT,2018,23051,22281,770,3.3,714
"Iron County, UT",UT,2017,22337,21436,901,4.0,952
"Iron County, UT",UT,2016,21385,20480,905,4.2,1161
"Iron County, UT",UT,2015,20224,19343,881,4.4,478
"Iron County, UT",UT,2014,19746,18892,854,4.3,659
"Iron County, UT",UT,2013,19087,18115,972,5.1,-2
"Iron County, UT",UT,2012,19089,17936,1153,6.0,-653
"Iron County, UT",UT,2011,19742,18046,1696,8.6,-577
"Iron County, UT",UT,2010,20319,18355,1964,9.7,0
"Iron County, WI",WI,2021,2580,2415,165,6.4,2
"Iron County, WI",WI,2020,2578,2285,293,11.4,28
"Iron County, WI",WI,2019,2550,2403,147,5.8,-33
"Iron County, WI",WI,2018,2583,2434,149,5.8,-32
"Iron County, WI",WI,2017,2615,2455,160,6.1,-14
"Iron County, WI",WI,2016,2629,2438,191,7.3,17
"Iron County, WI",WI,2015,2612,2388,224,8.6,-63
"Iron County, WI",WI,2014,2675,2425,250,9.3,-51
"Iron County, WI",WI,2013,2726,2436,290,10.6,-52
"Iron County, WI",WI,2012,2778,2492,286,10.3,32
"Iron County, WI",WI,2011,2746,2459,287,10.5,-136
"Iron County, WI",WI,2010,2882,2560,322,11.2,0
"Iroquois County, IL",IL,2021,13086,12470,616,4.7,-455
"Iroquois County, IL",IL,2020,13541,12684,857,6.3,-826
"Iroquois County, IL",IL,2019,14367,13789,578,4.0,-140
"Iroquois County, IL",IL,2018,14507,13867,640,4.4,-114
"Iroquois County, IL",IL,2017,14621,13949,672,4.6,-239
"Iroquois County, IL",IL,2016,14860,14040,820,5.5,82
"Iroquois County, IL",IL,2015,14778,13936,842,5.7,-149
"Iroquois County, IL",IL,2014,14927,13962,965,6.5,-5
"Iroquois County, IL",IL,2013,14932,13670,1262,8.5,-236
"Iroquois County, IL",IL,2012,15168,13860,1308,8.6,-476
"Iroquois County, IL",IL,2011,15644,14192,1452,9.3,-324
"Iroquois County, IL",IL,2010,15968,14337,1631,10.2,0
"Irwin County, GA",GA,2021,3568,3407,161,4.5,84
"Irwin County, GA",GA,2020,3484,3289,195,5.6,77
"Irwin County, GA",GA,2019,3407,3244,163,4.8,76
"Irwin County, GA",GA,2018,3331,3141,190,5.7,17
"Irwin County, GA",GA,2017,3314,3080,234,7.1,95
"Irwin County, GA",GA,2016,3219,2964,255,7.9,119
"Irwin County, GA",GA,2015,3100,2836,264,8.5,-38
"Irwin County, GA",GA,2014,3138,2838,300,9.6,-228
"Irwin County, GA",GA,2013,3366,3011,355,10.5,-163
"Irwin County, GA",GA,2012,3529,3121,408,11.6,-3
"Irwin County, GA",GA,2011,3532,3051,481,13.6,-155
"Irwin County, GA",GA,2010,3687,3139,548,14.9,0
"Isabela Municipio, PR",PR,2021,12774,11742,1032,8.1,
"Isabela Municipio, PR",PR,2020,N.A.,N.A.,N.A.,N.A.,
"Isabela Municipio, PR",PR,2019,12453,11331,1122,9.0,74
"Isabela Municipio, PR",PR,2018,12379,11067,1312,10.6,-220
"Isabela Municipio, PR",PR,2017,12599,10912,1687,13.4,-14
"Isabela Municipio, PR",PR,2016,12613,10835,1778,14.1,300
"Isabela Municipio, PR",PR,2015,12313,10760,1553,12.6,-110
"Isabela Municipio, PR",PR,2014,12423,10543,1880,15.1,307
"Isabela Municipio, PR",PR,2013,12116,10012,2104,17.4,-481
"Isabela Municipio, PR",PR,2012,12597,10302,2295,18.2,-346
"Isabela Municipio, PR",PR,2011,12943,10411,2532,19.6,-461
"Isabela Municipio, PR",PR,2010,13404,10725,2679,20.0,0
"Isabella County, MI",MI,2021,31774,30098,1676,5.3,-1183
"Isabella County, MI",MI,2020,32957,30089,2868,8.7,-1770
"Isabella County, MI",MI,2019,34727,33383,1344,3.9,-178
"Isabella County, MI",MI,2018,34905,33546,1359,3.9,-265
"Isabella County, MI",MI,2017,35170,33620,1550,4.4,-278
"Isabella County, MI",MI,2016,35448,33768,1680,4.7,-24
"Isabella County, MI",MI,2015,35472,33747,1725,4.9,-90
"Isabella County, MI",MI,2014,35562,33453,2109,5.9,557
"Isabella County, MI",MI,2013,35005,32502,2503,7.2,162
"Isabella County, MI",MI,2012,34843,32301,2542,7.3,-22
"Isabella County, MI",MI,2011,34865,32059,2806,8.0,-354
"Isabella County, MI",MI,2010,35219,31867,3352,9.5,0
"Isanti County, MN",MN,2021,21344,20476,868,4.1,-643
"Isanti County, MN",MN,2020,21987,20462,1525,6.9,144
"Isanti County, MN",MN,2019,21843,20908,935,4.3,534
"Isanti County, MN",MN,2018,21309,20460,849,4.0,212
"Isanti County, MN",MN,2017,21097,20179,918,4.4,436
"Isanti County, MN",MN,2016,20661,19697,964,4.7,413
"Isanti County, MN",MN,2015,20248,19358,890,4.4,-39
"Isanti County, MN",MN,2014,20287,19238,1049,5.2,61
"Isanti County, MN",MN,2013,20226,18994,1232,6.1,-150
"Isanti County, MN",MN,2012,20376,18942,1434,7.0,-255
"Isanti County, MN",MN,2011,20631,18910,1721,8.3,54
"Isanti County, MN",MN,2010,20577,18592,1985,9.6,0
"Island County, WA",WA,2021,36507,34466,2041,5.6,268
"Island County, WA",WA,2020,36239,33268,2971,8.2,-90
"Island County, WA",WA,2019,36329,34454,1875,5.2,1460
"Island County, WA",WA,2018,34869,33058,1811,5.2,767
"Island County, WA",WA,2017,34102,32360,1742,5.1,1338
"Island County, WA",WA,2016,32764,30860,1904,5.8,998
"Island County, WA",WA,2015,31766,29885,1881,5.9,86
"Island County, WA",WA,2014,31680,29643,2037,6.4,-69
"Island County, WA",WA,2013,31749,29438,2311,7.3,-667
"Island County, WA",WA,2012,32416,29998,2418,7.5,80
"Island County, WA",WA,2011,32336,29702,2634,8.1,-822
"Island County, WA",WA,2010,33158,30364,2794,8.4,0
"Isle of Wight County, VA",VA,2021,19026,18366,660,3.5,-365
"Isle of Wight County, VA",VA,2020,19391,18417,974,5.0,-443
"Isle of Wight County, VA",VA,2019,19834,19287,547,2.8,293
"Isle of Wight County, VA",VA,2018,19541,18969,572,2.9,273
"Isle of Wight County, VA",VA,2017,19268,18536,732,3.8,313
"Isle of Wight County, VA",VA,2016,18955,18151,804,4.2,79
"Isle of Wight County, VA",VA,2015,18876,18026,850,4.5,-162
"Isle of Wight County, VA",VA,2014,19038,18058,980,5.1,177
"Isle of Wight County, VA",VA,2013,18861,17803,1058,5.6,123
"Isle of Wight County, VA",VA,2012,18738,17575,1163,6.2,-112
"Isle of Wight County, VA",VA,2011,18850,17546,1304,6.9,24
"Isle of Wight County, VA",VA,2010,18826,17449,1377,7.3,0
"Issaquena County, MS",MS,2021,322,292,30,9.3,-4
"Issaquena County, MS",MS,2020,326,298,28,8.6,-35
"Issaquena County, MS",MS,2019,361,318,43,11.9,-9
"Issaquena County, MS",MS,2018,370,336,34,9.2,-22
"Issaquena County, MS",MS,2017,392,344,48,12.2,-8
"Issaquena County, MS",MS,2016,400,343,57,14.3,-18
"Issaquena County, MS",MS,2015,418,346,72,17.2,-8
"Issaquena County, MS",MS,2014,426,351,75,17.6,-20
"Issaquena County, MS",MS,2013,446,355,91,20.4,-29
"Issaquena County, MS",MS,2012,475,393,82,17.3,-41
"Issaquena County, MS",MS,2011,516,414,102,19.8,-8
"Issaquena County, MS",MS,2010,524,442,82,15.6,0
"Itasca County, MN",MN,2021,21147,20154,993,4.7,-1148
"Itasca County, MN",MN,2020,22295,20337,1958,8.8,72
"Itasca County, MN",MN,2019,22223,20823,1400,6.3,302
"Itasca County, MN",MN,2018,21921,20653,1268,5.8,71
"Itasca County, MN",MN,2017,21850,20312,1538,7.0,-164
"Itasca County, MN",MN,2016,22014,20132,1882,8.5,-353
"Itasca County, MN",MN,2015,22367,20884,1483,6.6,352
"Itasca County, MN",MN,2014,22015,20526,1489,6.8,61
"Itasca County, MN",MN,2013,21954,20243,1711,7.8,-325
"Itasca County, MN",MN,2012,22279,20517,1762,7.9,-294
"Itasca County, MN",MN,2011,22573,20516,2057,9.1,59
"Itasca County, MN",MN,2010,22514,20225,2289,10.2,0
"Itawamba County, MS",MS,2021,10326,9883,443,4.3,172
"Itawamba County, MS",MS,2020,10154,9461,693,6.8,-353
"Itawamba County, MS",MS,2019,10507,10009,498,4.7,137
"Itawamba County, MS",MS,2018,10370,9939,431,4.2,-121
"Itawamba County, MS",MS,2017,10491,10038,453,4.3,137
"Itawamba County, MS",MS,2016,10354,9818,536,5.2,177
"Itawamba County, MS",MS,2015,10177,9587,590,5.8,310
"Itawamba County, MS",MS,2014,9867,9153,714,7.2,-166
"Itawamba County, MS",MS,2013,10033,9232,801,8.0,-493
"Itawamba County, MS",MS,2012,10526,9660,866,8.2,-71
"Itawamba County, MS",MS,2011,10597,9563,1034,9.8,224
"Itawamba County, MS",MS,2010,10373,9236,1137,11.0,0
"Izard County, AR",AR,2021,4382,4146,236,5.4,-273
"Izard County, AR",AR,2020,4655,4261,394,8.5,-252
"Izard County, AR",AR,2019,4907,4645,262,5.3,39
"Izard County, AR",AR,2018,4868,4605,263,5.4,-12
"Izard County, AR",AR,2017,4880,4609,271,5.6,-96
"Izard County, AR",AR,2016,4976,4696,280,5.6,-23
"Izard County, AR",AR,2015,4999,4673,326,6.5,47
"Izard County, AR",AR,2014,4952,4587,365,7.4,-77
"Izard County, AR",AR,2013,5029,4606,423,8.4,-157
"Izard County, AR",AR,2012,5186,4748,438,8.4,-17
"Izard County, AR",AR,2011,5203,4710,493,9.5,71
"Izard County, AR",AR,2010,5132,4634,498,9.7,0
"Jack County, TX",TX,2021,3398,3212,186,5.5,28
"Jack County, TX",TX,2020,3370,3134,236,7.0,-58
"Jack County, TX",TX,2019,3428,3320,108,3.2,-907
"Jack County, TX",TX,2018,4335,4226,109,2.5,411
"Jack County, TX",TX,2017,3924,3776,148,3.8,67
"Jack County, TX",TX,2016,3857,3666,191,5.0,-222
"Jack County, TX",TX,2015,4079,3906,173,4.2,-221
"Jack County, TX",TX,2014,4300,4137,163,3.8,300
"Jack County, TX",TX,2013,4000,3786,214,5.4,205
"Jack County, TX",TX,2012,3795,3578,217,5.7,83
"Jack County, TX",TX,2011,3712,3446,266,7.2,43
"Jack County, TX",TX,2010,3669,3380,289,7.9,0
"Jackson County, AL",AL,2021,22975,22316,659,2.9,-116
"Jackson County, AL",AL,2020,23091,21727,1364,5.9,-600
"Jackson County, AL",AL,2019,23691,22867,824,3.5,26
"Jackson County, AL",AL,2018,23665,22702,963,4.1,288
"Jackson County, AL",AL,2017,23377,22231,1146,4.9,-13
"Jackson County, AL",AL,2016,23390,21911,1479,6.3,-17
"Jackson County, AL",AL,2015,23407,21840,1567,6.7,-82
"Jackson County, AL",AL,2014,23489,21792,1697,7.2,-180
"Jackson County, AL",AL,2013,23669,21776,1893,8.0,-91
"Jackson County, AL",AL,2012,23760,21669,2091,8.8,-400
"Jackson County, AL",AL,2011,24160,21692,2468,10.2,-187
"Jackson County, AL",AL,2010,24347,21514,2833,11.6,0
"Jackson County, AR",AR,2021,5637,5343,294,5.2,-215
"Jackson County, AR",AR,2020,5852,5428,424,7.2,38
"Jackson County, AR",AR,2019,5814,5443,371,6.4,38
"Jackson County, AR",AR,2018,5776,5431,345,6.0,-104
"Jackson County, AR",AR,2017,5880,5533,347,5.9,-188
"Jackson County, AR",AR,2016,6068,5689,379,6.2,-144
"Jackson County, AR",AR,2015,6212,5750,462,7.4,-19
"Jackson County, AR",AR,2014,6231,5669,562,9.0,-78
"Jackson County, AR",AR,2013,6309,5638,671,10.6,-183
"Jackson County, AR",AR,2012,6492,5819,673,10.4,-182
"Jackson County, AR",AR,2011,6674,5931,743,11.1,-45
"Jackson County, AR",AR,2010,6719,5950,769,11.4,0
"Jackson County, CO",CO,2021,988,955,33,3.3,53
"Jackson County, CO",CO,2020,935,898,37,4.0,-37
"Jackson County, CO",CO,2019,972,951,21,2.2,-7
"Jackson County, CO",CO,2018,979,955,24,2.5,26
"Jackson County, CO",CO,2017,953,937,16,1.7,61
"Jackson County, CO",CO,2016,892,869,23,2.6,58
"Jackson County, CO",CO,2015,834,804,30,3.6,0
"Jackson County, CO",CO,2014,834,804,30,3.6,42
"Jackson County, CO",CO,2013,792,755,37,4.7,-32
"Jackson County, CO",CO,2012,824,780,44,5.3,-67
"Jackson County, CO",CO,2011,891,834,57,6.4,-26
"Jackson County, CO",CO,2010,917,832,85,9.3,0
"Jackson County, FL",FL,2021,17202,16413,789,4.6,78
"Jackson County, FL",FL,2020,17124,16107,1017,5.9,165
"Jackson County, FL",FL,2019,16959,16349,610,3.6,-149
"Jackson County, FL",FL,2018,17108,16401,707,4.1,-61
"Jackson County, FL",FL,2017,17169,16382,787,4.6,-227
"Jackson County, FL",FL,2016,17396,16480,916,5.3,17
"Jackson County, FL",FL,2015,17379,16345,1034,5.9,-79
"Jackson County, FL",FL,2014,17458,16256,1202,6.9,-277
"Jackson County, FL",FL,2013,17735,16340,1395,7.9,-214
"Jackson County, FL",FL,2012,17949,16348,1601,8.9,-202
"Jackson County, FL",FL,2011,18151,16438,1713,9.4,-631
"Jackson County, FL",FL,2010,18782,17131,1651,8.8,0
"Jackson County, GA",GA,2021,42806,41787,1019,2.4,2745
"Jackson County, GA",GA,2020,40061,38323,1738,4.3,2263
"Jackson County, GA",GA,2019,37798,36743,1055,2.8,1336
"Jackson County, GA",GA,2018,36462,35325,1137,3.1,827
"Jackson County, GA",GA,2017,35635,34315,1320,3.7,2346
"Jackson County, GA",GA,2016,33289,31852,1437,4.3,2903
"Jackson County, GA",GA,2015,30386,28890,1496,4.9,619
"Jackson County, GA",GA,2014,29767,28017,1750,5.9,202
"Jackson County, GA",GA,2013,29565,27538,2027,6.9,252
"Jackson County, GA",GA,2012,29313,26941,2372,8.1,465
"Jackson County, GA",GA,2011,28848,26108,2740,9.5,116
"Jackson County, GA",GA,2010,28732,25692,3040,10.6,0
"Jackson County, IA",IA,2021,10589,10059,530,5.0,-81
"Jackson County, IA",IA,2020,10670,10035,635,6.0,-556
"Jackson County, IA",IA,2019,11226,10890,336,3.0,123
"Jackson County, IA",IA,2018,11103,10796,307,2.8,116
"Jackson County, IA",IA,2017,10987,10621,366,3.3,-132
"Jackson County, IA",IA,2016,11119,10658,461,4.1,-46
"Jackson County, IA",IA,2015,11165,10700,465,4.2,146
"Jackson County, IA",IA,2014,11019,10463,556,5.0,160
"Jackson County, IA",IA,2013,10859,10275,584,5.4,-4
"Jackson County, IA",IA,2012,10863,10266,597,5.5,-181
"Jackson County, IA",IA,2011,11044,10311,733,6.6,-46
"Jackson County, IA",IA,2010,11090,10274,816,7.4,0
"Jackson County, IL",IL,2021,27201,25730,1471,5.4,65
"Jackson County, IL",IL,2020,27136,25004,2132,7.9,-861
"Jackson County, IL",IL,2019,27997,26985,1012,3.6,-117
"Jackson County, IL",IL,2018,28114,26853,1261,4.5,11
"Jackson County, IL",IL,2017,28103,26842,1261,4.5,-699
"Jackson County, IL",IL,2016,28802,27249,1553,5.4,122
"Jackson County, IL",IL,2015,28680,27083,1597,5.6,216
"Jackson County, IL",IL,2014,28464,26622,1842,6.5,-43
"Jackson County, IL",IL,2013,28507,26251,2256,7.9,-563
"Jackson County, IL",IL,2012,29070,26781,2289,7.9,-559
"Jackson County, IL",IL,2011,29629,27260,2369,8.0,-169
"Jackson County, IL",IL,2010,29798,27328,2470,8.3,0
"Jackson County, IN",IN,2021,23214,22522,692,3.0,111
"Jackson County, IN",IN,2020,23103,21431,1672,7.2,83
"Jackson County, IN",IN,2019,23020,22418,602,2.6,170
"Jackson County, IN",IN,2018,22850,22206,644,2.8,399
"Jackson County, IN",IN,2017,22451,21787,664,3.0,81
"Jackson County, IN",IN,2016,22370,21563,807,3.6,586
"Jackson County, IN",IN,2015,21784,20922,862,4.0,455
"Jackson County, IN",IN,2014,21329,20268,1061,5.0,442
"Jackson County, IN",IN,2013,20887,19556,1331,6.4,381
"Jackson County, IN",IN,2012,20506,18998,1508,7.4,-95
"Jackson County, IN",IN,2011,20601,18833,1768,8.6,117
"Jackson County, IN",IN,2010,20484,18383,2101,10.3,0
"Jackson County, KS",KS,2021,7236,7048,188,2.6,2
"Jackson County, KS",KS,2020,7234,6857,377,5.2,66
"Jackson County, KS",KS,2019,7168,6963,205,2.9,-60
"Jackson County, KS",KS,2018,7228,7015,213,2.9,-27
"Jackson County, KS",KS,2017,7255,7029,226,3.1,-38
"Jackson County, KS",KS,2016,7293,7041,252,3.5,34
"Jackson County, KS",KS,2015,7259,6990,269,3.7,-140
"Jackson County, KS",KS,2014,7399,7095,304,4.1,96
"Jackson County, KS",KS,2013,7303,6932,371,5.1,-70
"Jackson County, KS",KS,2012,7373,6959,414,5.6,-82
"Jackson County, KS",KS,2011,7455,7014,441,5.9,-54
"Jackson County, KS",KS,2010,7509,7052,457,6.1,0
"Jackson County, KY",KY,2021,4097,3840,257,6.3,59
"Jackson County, KY",KY,2020,4038,3701,337,8.3,-87
"Jackson County, KY",KY,2019,4125,3875,250,6.1,38
"Jackson County, KY",KY,2018,4087,3808,279,6.8,-14
"Jackson County, KY",KY,2017,4101,3760,341,8.3,-65
"Jackson County, KY",KY,2016,4166,3841,325,7.8,-22
"Jackson County, KY",KY,2015,4188,3818,370,8.8,-394
"Jackson County, KY",KY,2014,4582,4059,523,11.4,-251
"Jackson County, KY",KY,2013,4833,4278,555,11.5,-348
"Jackson County, KY",KY,2012,5181,4568,613,11.8,-125
"Jackson County, KY",KY,2011,5306,4589,717,13.5,136
"Jackson County, KY",KY,2010,5170,4437,733,14.2,0
"Jackson County, MI",MI,2021,71993,67863,4130,5.7,-2339
"Jackson County, MI",MI,2020,74332,67413,6919,9.3,-298
"Jackson County, MI",MI,2019,74630,71790,2840,3.8,51
"Jackson County, MI",MI,2018,74579,71622,2957,4.0,213
"Jackson County, MI",MI,2017,74366,70984,3382,4.5,-246
"Jackson County, MI",MI,2016,74612,70963,3649,4.9,1227
"Jackson County, MI",MI,2015,73385,69458,3927,5.4,218
"Jackson County, MI",MI,2014,73167,68293,4874,6.7,799
"Jackson County, MI",MI,2013,72368,66462,5906,8.2,535
"Jackson County, MI",MI,2012,71833,65789,6044,8.4,-623
"Jackson County, MI",MI,2011,72456,65573,6883,9.5,-1498
"Jackson County, MI",MI,2010,73954,65197,8757,11.8,0
"Jackson County, MN",MN,2021,5402,5232,170,3.1,-430
"Jackson County, MN",MN,2020,5832,5519,313,5.4,58
"Jackson County, MN",MN,2019,5774,5563,211,3.7,35
"Jackson County, MN",MN,2018,5739,5560,179,3.1,-43
"Jackson County, MN",MN,2017,5782,5570,212,3.7,-312
"Jackson County, MN",MN,2016,6094,5819,275,4.5,-209
"Jackson County, MN",MN,2015,6303,6043,260,4.1,-14
"Jackson County, MN",MN,2014,6317,6046,271,4.3,83
"Jackson County, MN",MN,2013,6234,5972,262,4.2,22
"Jackson County, MN",MN,2012,6212,5928,284,4.6,109
"Jackson County, MN",MN,2011,6103,5771,332,5.4,72
"Jackson County, MN",MN,2010,6031,5677,354,5.9,0
"Jackson County, MO",MO,2021,359763,340103,19660,5.5,3063
"Jackson County, MO",MO,2020,356700,331092,25608,7.2,-3705
"Jackson County, MO",MO,2019,360405,347620,12785,3.5,2211
"Jackson County, MO",MO,2018,358194,344820,13374,3.7,-3662
"Jackson County, MO",MO,2017,361856,345971,15885,4.4,-1938
"Jackson County, MO",MO,2016,363794,345196,18598,5.1,2884
"Jackson County, MO",MO,2015,360910,339191,21719,6.0,4766
"Jackson County, MO",MO,2014,356144,330689,25455,7.1,4028
"Jackson County, MO",MO,2013,352116,324929,27187,7.7,-1386
"Jackson County, MO",MO,2012,353502,325131,28371,8.0,-3080
"Jackson County, MO",MO,2011,356582,322012,34570,9.7,-2871
"Jackson County, MO",MO,2010,359453,321363,38090,10.6,0
"Jackson County, MS",MS,2021,58667,55139,3528,6.0,974
"Jackson County, MS",MS,2020,57693,52314,5379,9.3,-866
"Jackson County, MS",MS,2019,58559,54983,3576,6.1,338
"Jackson County, MS",MS,2018,58221,54849,3372,5.8,-172
"Jackson County, MS",MS,2017,58393,54842,3551,6.1,-457
"Jackson County, MS",MS,2016,58850,54898,3952,6.7,50
"Jackson County, MS",MS,2015,58800,54606,4194,7.1,-107
"Jackson County, MS",MS,2014,58907,54152,4755,8.1,-2063
"Jackson County, MS",MS,2013,60970,55587,5383,8.8,-2923
"Jackson County, MS",MS,2012,63893,57974,5919,9.3,-1816
"Jackson County, MS",MS,2011,65709,59024,6685,10.2,1145
"Jackson County, MS",MS,2010,64564,58594,5970,9.2,0
"Jackson County, NC",NC,2021,19488,18611,877,4.5,326
"Jackson County, NC",NC,2020,19162,17750,1412,7.4,-616
"Jackson County, NC",NC,2019,19778,18968,810,4.1,500
"Jackson County, NC",NC,2018,19278,18460,818,4.2,483
"Jackson County, NC",NC,2017,18795,17897,898,4.8,22
"Jackson County, NC",NC,2016,18773,17751,1022,5.4,328
"Jackson County, NC",NC,2015,18445,17335,1110,6.0,81
"Jackson County, NC",NC,2014,18364,17172,1192,6.5,-92
"Jackson County, NC",NC,2013,18456,16875,1581,8.6,222
"Jackson County, NC",NC,2012,18234,16258,1976,10.8,58
"Jackson County, NC",NC,2011,18176,16147,2029,11.2,-327
"Jackson County, NC",NC,2010,18503,16502,2001,10.8,0
"Jackson County, OH",OH,2021,12672,11894,778,6.1,-451
"Jackson County, OH",OH,2020,13123,11975,1148,8.7,265
"Jackson County, OH",OH,2019,12858,12056,802,6.2,5
"Jackson County, OH",OH,2018,12853,12017,836,6.5,-110
"Jackson County, OH",OH,2017,12963,12041,922,7.1,110
"Jackson County, OH",OH,2016,12853,11837,1016,7.9,-242
"Jackson County, OH",OH,2015,13095,12100,995,7.6,-162
"Jackson County, OH",OH,2014,13257,12090,1167,8.8,-337
"Jackson County, OH",OH,2013,13594,12168,1426,10.5,-130
"Jackson County, OH",OH,2012,13724,12308,1416,10.3,-203
"Jackson County, OH",OH,2011,13927,12280,1647,11.8,-397
"Jackson County, OH",OH,2010,14324,12529,1795,12.5,0
"Jackson County, OK",OK,2021,10785,10481,304,2.8,218
"Jackson County, OK",OK,2020,10567,10131,436,4.1,-46
"Jackson County, OK",OK,2019,10613,10319,294,2.8,-102
"Jackson County, OK",OK,2018,10715,10403,312,2.9,-90
"Jackson County, OK",OK,2017,10805,10418,387,3.6,-186
"Jackson County, OK",OK,2016,10991,10526,465,4.2,124
"Jackson County, OK",OK,2015,10867,10436,431,4.0,212
"Jackson County, OK",OK,2014,10655,10212,443,4.2,-159
"Jackson County, OK",OK,2013,10814,10249,565,5.2,-216
"Jackson County, OK",OK,2012,11030,10482,548,5.0,-286
"Jackson County, OK",OK,2011,11316,10726,590,5.2,-137
"Jackson County, OK",OK,2010,11453,10802,651,5.7,0
"Jackson County, OR",OR,2021,107706,101863,5843,5.4,2588
"Jackson County, OR",OR,2020,105118,96906,8212,7.8,1706
"Jackson County, OR",OR,2019,103412,98989,4423,4.3,-10
"Jackson County, OR",OR,2018,103422,98641,4781,4.6,840
"Jackson County, OR",OR,2017,102582,97799,4783,4.7,1442
"Jackson County, OR",OR,2016,101140,95428,5712,5.6,3070
"Jackson County, OR",OR,2015,98070,91580,6490,6.6,850
"Jackson County, OR",OR,2014,97220,89199,8021,8.3,597
"Jackson County, OR",OR,2013,96623,87325,9298,9.6,-2322
"Jackson County, OR",OR,2012,98945,87981,10964,11.1,-1654
"Jackson County, OR",OR,2011,100599,88691,11908,11.8,-769
"Jackson County, OR",OR,2010,101368,88638,12730,12.6,0
"Jackson County, SD",SD,2021,1215,1161,54,4.4,14
"Jackson County, SD",SD,2020,1201,1153,48,4.0,-62
"Jackson County, SD",SD,2019,1263,1203,60,4.8,-12
"Jackson County, SD",SD,2018,1275,1217,58,4.5,-45
"Jackson County, SD",SD,2017,1320,1251,69,5.2,9
"Jackson County, SD",SD,2016,1311,1256,55,4.2,-23
"Jackson County, SD",SD,2015,1334,1278,56,4.2,-11
"Jackson County, SD",SD,2014,1345,1274,71,5.3,27
"Jackson County, SD",SD,2013,1318,1238,80,6.1,-34
"Jackson County, SD",SD,2012,1352,1262,90,6.7,-46
"Jackson County, SD",SD,2011,1398,1296,102,7.3,-1
"Jackson County, SD",SD,2010,1399,1305,94,6.7,0
"Jackson County, TN",TN,2021,4773,4566,207,4.3,57
"Jackson County, TN",TN,2020,4716,4345,371,7.9,31
"Jackson County, TN",TN,2019,4685,4469,216,4.6,78
"Jackson County, TN",TN,2018,4607,4391,216,4.7,5
"Jackson County, TN",TN,2017,4602,4355,247,5.4,107
"Jackson County, TN",TN,2016,4495,4180,315,7.0,23
"Jackson County, TN",TN,2015,4472,4124,348,7.8,-9
"Jackson County, TN",TN,2014,4481,4086,395,8.8,-105
"Jackson County, TN",TN,2013,4586,4115,471,10.3,3
"Jackson County, TN",TN,2012,4583,4096,487,10.6,-156
"Jackson County, TN",TN,2011,4739,4177,562,11.9,-56
"Jackson County, TN",TN,2010,4795,4180,615,12.8,0
"Jackson County, TX",TX,2021,7108,6752,356,5.0,-120
"Jackson County, TX",TX,2020,7228,6810,418,5.8,-212
"Jackson County, TX",TX,2019,7440,7217,223,3.0,144
"Jackson County, TX",TX,2018,7296,7056,240,3.3,-23
"Jackson County, TX",TX,2017,7319,7024,295,4.0,42
"Jackson County, TX",TX,2016,7277,6936,341,4.7,-94
"Jackson County, TX",TX,2015,7371,7092,279,3.8,-249
"Jackson County, TX",TX,2014,7620,7317,303,4.0,194
"Jackson County, TX",TX,2013,7426,7052,374,5.0,5
"Jackson County, TX",TX,2012,7421,7044,377,5.1,73
"Jackson County, TX",TX,2011,7348,6875,473,6.4,207
"Jackson County, TX",TX,2010,7141,6635,506,7.1,0
"Jackson County, WI",WI,2021,9616,9120,496,5.2,-404
"Jackson County, WI",WI,2020,10020,9085,935,9.3,-268
"Jackson County, WI",WI,2019,10288,9910,378,3.7,-313
"Jackson County, WI",WI,2018,10601,10275,326,3.1,145
"Jackson County, WI",WI,2017,10456,10109,347,3.3,158
"Jackson County, WI",WI,2016,10298,9859,439,4.3,-23
"Jackson County, WI",WI,2015,10321,9840,481,4.7,129
"Jackson County, WI",WI,2014,10192,9604,588,5.8,47
"Jackson County, WI",WI,2013,10145,9434,711,7.0,-157
"Jackson County, WI",WI,2012,10302,9562,740,7.2,102
"Jackson County, WI",WI,2011,10200,9405,795,7.8,72
"Jackson County, WI",WI,2010,10128,9259,869,8.6,0
"Jackson County, WV",WV,2021,12040,11356,684,5.7,-462
"Jackson County, WV",WV,2020,12502,11444,1058,8.5,-863
"Jackson County, WV",WV,2019,13365,12689,676,5.1,-2986
"Jackson County, WV",WV,2018,16351,15706,645,3.9,4264
"Jackson County, WV",WV,2017,12087,11398,689,5.7,42
"Jackson County, WV",WV,2016,12045,11263,782,6.5,-5
"Jackson County, WV",WV,2015,12050,11202,848,7.0,106
"Jackson County, WV",WV,2014,11944,11163,781,6.5,-92
"Jackson County, WV",WV,2013,12036,11219,817,6.8,25
"Jackson County, WV",WV,2012,12011,11020,991,8.3,7
"Jackson County, WV",WV,2011,12004,10803,1201,10.0,-294
"Jackson County, WV",WV,2010,12298,10896,1402,11.4,0
"Jackson Parish, LA",LA,2021,6745,6492,253,3.8,25
"Jackson Parish, LA",LA,2020,6720,6333,387,5.8,-120
"Jackson Parish, LA",LA,2019,6840,6527,313,4.6,-60
"Jackson Parish, LA",LA,2018,6900,6585,315,4.6,-95
"Jackson Parish, LA",LA,2017,6995,6679,316,4.5,-97
"Jackson Parish, LA",LA,2016,7092,6696,396,5.6,-134
"Jackson Parish, LA",LA,2015,7226,6796,430,6.0,17
"Jackson Parish, LA",LA,2014,7209,6794,415,5.8,182
"Jackson Parish, LA",LA,2013,7027,6588,439,6.2,164
"Jackson Parish, LA",LA,2012,6863,6417,446,6.5,-109
"Jackson Parish, LA",LA,2011,6972,6482,490,7.0,-110
"Jackson Parish, LA",LA,2010,7082,6595,487,6.9,0
"James City County, VA",VA,2021,35844,34422,1422,4.0,-1206
"James City County, VA",VA,2020,37050,34511,2539,6.9,-206
"James City County, VA",VA,2019,37256,36277,979,2.6,395
"James City County, VA",VA,2018,36861,35805,1056,2.9,625
"James City County, VA",VA,2017,36236,34977,1259,3.5,1326
"James City County, VA",VA,2016,34910,33580,1330,3.8,480
"James City County, VA",VA,2015,34430,32960,1470,4.3,-305
"James City County, VA",VA,2014,34735,33060,1675,4.8,1027
"James City County, VA",VA,2013,33708,31951,1757,5.2,766
"James City County, VA",VA,2012,32942,31095,1847,5.6,388
"James City County, VA",VA,2011,32554,30577,1977,6.1,272
"James City County, VA",VA,2010,32282,30190,2092,6.5,0
"Jasper County, GA",GA,2021,7065,6838,227,3.2,247
"Jasper County, GA",GA,2020,6818,6487,331,4.9,-169
"Jasper County, GA",GA,2019,6987,6759,228,3.3,75
"Jasper County, GA",GA,2018,6912,6666,246,3.6,-10
"Jasper County, GA",GA,2017,6922,6621,301,4.3,341
"Jasper County, GA",GA,2016,6581,6262,319,4.8,214
"Jasper County, GA",GA,2015,6367,6010,357,5.6,26
"Jasper County, GA",GA,2014,6341,5918,423,6.7,-165
"Jasper County, GA",GA,2013,6506,5971,535,8.2,-135
"Jasper County, GA",GA,2012,6641,6001,640,9.6,-140
"Jasper County, GA",GA,2011,6781,6041,740,10.9,-112
"Jasper County, GA",GA,2010,6893,6077,816,11.8,0
"Jasper County, IA",IA,2021,19128,18299,829,4.3,-199
"Jasper County, IA",IA,2020,19327,18323,1004,5.2,-844
"Jasper County, IA",IA,2019,20171,19607,564,2.8,538
"Jasper County, IA",IA,2018,19633,19116,517,2.6,157
"Jasper County, IA",IA,2017,19476,18877,599,3.1,131
"Jasper County, IA",IA,2016,19345,18665,680,3.5,240
"Jasper County, IA",IA,2015,19105,18371,734,3.8,-222
"Jasper County, IA",IA,2014,19327,18475,852,4.4,248
"Jasper County, IA",IA,2013,19079,18110,969,5.1,459
"Jasper County, IA",IA,2012,18620,17507,1113,6.0,-73
"Jasper County, IA",IA,2011,18693,17416,1277,6.8,-299
"Jasper County, IA",IA,2010,18992,17572,1420,7.5,0
"Jasper County, IL",IL,2021,4723,4522,201,4.3,151
"Jasper County, IL",IL,2020,4572,4290,282,6.2,-84
"Jasper County, IL",IL,2019,4656,4467,189,4.1,33
"Jasper County, IL",IL,2018,4623,4394,229,5.0,130
"Jasper County, IL",IL,2017,4493,4269,224,5.0,-172
"Jasper County, IL",IL,2016,4665,4373,292,6.3,18
"Jasper County, IL",IL,2015,4647,4357,290,6.2,2
"Jasper County, IL",IL,2014,4645,4345,300,6.5,-78
"Jasper County, IL",IL,2013,4723,4351,372,7.9,-195
"Jasper County, IL",IL,2012,4918,4540,378,7.7,-79
"Jasper County, IL",IL,2011,4997,4607,390,7.8,-92
"Jasper County, IL",IL,2010,5089,4633,456,9.0,0
"Jasper County, IN",IN,2021,15355,14814,541,3.5,-180
"Jasper County, IN",IN,2020,15535,14428,1107,7.1,-746
"Jasper County, IN",IN,2019,16281,15683,598,3.7,-207
"Jasper County, IN",IN,2018,16488,15849,639,3.9,93
"Jasper County, IN",IN,2017,16395,15695,700,4.3,-190
"Jasper County, IN",IN,2016,16585,15714,871,5.3,228
"Jasper County, IN",IN,2015,16357,15411,946,5.8,208
"Jasper County, IN",IN,2014,16149,15075,1074,6.7,184
"Jasper County, IN",IN,2013,15965,14752,1213,7.6,-20
"Jasper County, IN",IN,2012,15985,14706,1279,8.0,-146
"Jasper County, IN",IN,2011,16131,14698,1433,8.9,-13
"Jasper County, IN",IN,2010,16144,14503,1641,10.2,0
"Jasper County, MO",MO,2021,56953,54820,2133,3.7,1165
"Jasper County, MO",MO,2020,55788,52632,3156,5.7,-1146
"Jasper County, MO",MO,2019,56934,55322,1612,2.8,530
"Jasper County, MO",MO,2018,56404,54869,1535,2.7,-326
"Jasper County, MO",MO,2017,56730,54827,1903,3.4,-938
"Jasper County, MO",MO,2016,57668,55277,2391,4.1,-37
"Jasper County, MO",MO,2015,57705,55185,2520,4.4,176
"Jasper County, MO",MO,2014,57529,54472,3057,5.3,-273
"Jasper County, MO",MO,2013,57802,54396,3406,5.9,-30
"Jasper County, MO",MO,2012,57832,54307,3525,6.1,-716
"Jasper County, MO",MO,2011,58548,54024,4524,7.7,-223
"Jasper County, MO",MO,2010,58771,53830,4941,8.4,0
"Jasper County, MS",MS,2021,5817,5395,422,7.3,-155
"Jasper County, MS",MS,2020,5972,5449,523,8.8,-268
"Jasper County, MS",MS,2019,6240,5814,426,6.8,253
"Jasper County, MS",MS,2018,5987,5624,363,6.1,-85
"Jasper County, MS",MS,2017,6072,5664,408,6.7,-94
"Jasper County, MS",MS,2016,6166,5684,482,7.8,-179
"Jasper County, MS",MS,2015,6345,5843,502,7.9,-68
"Jasper County, MS",MS,2014,6413,5862,551,8.6,-103
"Jasper County, MS",MS,2013,6516,5872,644,9.9,-448
"Jasper County, MS",MS,2012,6964,6270,694,10.0,-235
"Jasper County, MS",MS,2011,7199,6390,809,11.2,175
"Jasper County, MS",MS,2010,7024,6186,838,11.9,0
"Jasper County, SC",SC,2021,13121,12675,446,3.4,341
"Jasper County, SC",SC,2020,12780,12147,633,5.0,191
"Jasper County, SC",SC,2019,12589,12275,314,2.5,493
"Jasper County, SC",SC,2018,12096,11738,358,3.0,323
"Jasper County, SC",SC,2017,11773,11345,428,3.6,-191
"Jasper County, SC",SC,2016,11964,11454,510,4.3,151
"Jasper County, SC",SC,2015,11813,11215,598,5.1,383
"Jasper County, SC",SC,2014,11430,10797,633,5.5,216
"Jasper County, SC",SC,2013,11214,10460,754,6.7,235
"Jasper County, SC",SC,2012,10979,10070,909,8.3,-62
"Jasper County, SC",SC,2011,11041,9962,1079,9.8,51
"Jasper County, SC",SC,2010,10990,9892,1098,10.0,0
"Jasper County, TX",TX,2021,12832,11585,1247,9.7,81
"Jasper County, TX",TX,2020,12751,11320,1431,11.2,75
"Jasper County, TX",TX,2019,12676,11900,776,6.1,-434
"Jasper County, TX",TX,2018,13110,12249,861,6.6,-242
"Jasper County, TX",TX,2017,13352,12349,1003,7.5,-120
"Jasper County, TX",TX,2016,13472,12437,1035,7.7,-415
"Jasper County, TX",TX,2015,13887,12841,1046,7.5,-545
"Jasper County, TX",TX,2014,14432,13240,1192,8.3,-67
"Jasper County, TX",TX,2013,14499,12970,1529,10.5,-378
"Jasper County, TX",TX,2012,14877,13302,1575,10.6,-179
"Jasper County, TX",TX,2011,15056,13139,1917,12.7,192
"Jasper County, TX",TX,2010,14864,13017,1847,12.4,0
"Jay County, IN",IN,2021,8746,8512,234,2.7,-69
"Jay County, IN",IN,2020,8815,8231,584,6.6,-641
"Jay County, IN",IN,2019,9456,9176,280,3.0,-334
"Jay County, IN",IN,2018,9790,9470,320,3.3,3
"Jay County, IN",IN,2017,9787,9445,342,3.5,-168
"Jay County, IN",IN,2016,9955,9510,445,4.5,10
"Jay County, IN",IN,2015,9945,9451,494,5.0,-161
"Jay County, IN",IN,2014,10106,9521,585,5.8,43
"Jay County, IN",IN,2013,10063,9300,763,7.6,-31
"Jay County, IN",IN,2012,10094,9306,788,7.8,-461
"Jay County, IN",IN,2011,10555,9624,931,8.8,-72
"Jay County, IN",IN,2010,10627,9525,1102,10.4,0
"Jayuya Municipio, PR",PR,2021,4565,3990,575,12.6,
"Jayuya Municipio, PR",PR,2020,N.A.,N.A.,N.A.,N.A.,
"Jayuya Municipio, PR",PR,2019,4243,3645,598,14.1,124
"Jayuya Municipio, PR",PR,2018,4119,3681,438,10.6,-130
"Jayuya Municipio, PR",PR,2017,4249,3697,552,13.0,28
"Jayuya Municipio, PR",PR,2016,4221,3675,546,12.9,63
"Jayuya Municipio, PR",PR,2015,4158,3543,615,14.8,-44
"Jayuya Municipio, PR",PR,2014,4202,3467,735,17.5,-172
"Jayuya Municipio, PR",PR,2013,4374,3574,800,18.3,-195
"Jayuya Municipio, PR",PR,2012,4569,3799,770,16.9,-164
"Jayuya Municipio, PR",PR,2011,4733,3820,913,19.3,-366
"Jayuya Municipio, PR",PR,2010,5099,4103,996,19.5,0
"Jeff Davis County, GA",GA,2021,6100,5858,242,4.0,-33
"Jeff Davis County, GA",GA,2020,6133,5820,313,5.1,-62
"Jeff Davis County, GA",GA,2019,6195,5902,293,4.7,100
"Jeff Davis County, GA",GA,2018,6095,5796,299,4.9,-95
"Jeff Davis County, GA",GA,2017,6190,5813,377,6.1,-36
"Jeff Davis County, GA",GA,2016,6226,5825,401,6.4,-46
"Jeff Davis County, GA",GA,2015,6272,5847,425,6.8,-115
"Jeff Davis County, GA",GA,2014,6387,5863,524,8.2,13
"Jeff Davis County, GA",GA,2013,6374,5745,629,9.9,17
"Jeff Davis County, GA",GA,2012,6357,5634,723,11.4,-139
"Jeff Davis County, GA",GA,2011,6496,5686,810,12.5,106
"Jeff Davis County, GA",GA,2010,6390,5564,826,12.9,0
"Jeff Davis County, TX",TX,2021,1023,979,44,4.3,70
"Jeff Davis County, TX",TX,2020,953,904,49,5.1,-81
"Jeff Davis County, TX",TX,2019,1034,1004,30,2.9,-24
"Jeff Davis County, TX",TX,2018,1058,1027,31,2.9,-1
"Jeff Davis County, TX",TX,2017,1059,1025,34,3.2,-15
"Jeff Davis County, TX",TX,2016,1074,1042,32,3.0,-7
"Jeff Davis County, TX",TX,2015,1081,1045,36,3.3,-65
"Jeff Davis County, TX",TX,2014,1146,1104,42,3.7,-13
"Jeff Davis County, TX",TX,2013,1159,1111,48,4.1,-54
"Jeff Davis County, TX",TX,2012,1213,1154,59,4.9,-36
"Jeff Davis County, TX",TX,2011,1249,1185,64,5.1,-25
"Jeff Davis County, TX",TX,2010,1274,1211,63,4.9,0
"Jefferson County, AL",AL,2021,317359,305782,11577,3.6,-3035
"Jefferson County, AL",AL,2020,320394,298447,21947,6.9,-1297
"Jefferson County, AL",AL,2019,321691,311970,9721,3.0,2472
"Jefferson County, AL",AL,2018,319219,307423,11796,3.7,5391
"Jefferson County, AL",AL,2017,313828,300153,13675,4.4,5196
"Jefferson County, AL",AL,2016,308632,290887,17745,5.7,-1526
"Jefferson County, AL",AL,2015,310158,292165,17993,5.8,-2548
"Jefferson County, AL",AL,2014,312706,293144,19562,6.3,-2396
"Jefferson County, AL",AL,2013,315102,293809,21293,6.8,-1669
"Jefferson County, AL",AL,2012,316771,292662,24109,7.6,-2815
"Jefferson County, AL",AL,2011,319586,290057,29529,9.2,935
"Jefferson County, AL",AL,2010,318651,286248,32403,10.2,0
"Jefferson County, AR",AR,2021,26128,24413,1715,6.6,-1159
"Jefferson County, AR",AR,2020,27287,25079,2208,8.1,-378
"Jefferson County, AR",AR,2019,27665,26188,1477,5.3,-346
"Jefferson County, AR",AR,2018,28011,26567,1444,5.2,16
"Jefferson County, AR",AR,2017,27995,26535,1460,5.2,-378
"Jefferson County, AR",AR,2016,28373,26779,1594,5.6,-509
"Jefferson County, AR",AR,2015,28882,26872,2010,7.0,-831
"Jefferson County, AR",AR,2014,29713,27170,2543,8.6,-1470
"Jefferson County, AR",AR,2013,31183,28041,3142,10.1,-1393
"Jefferson County, AR",AR,2012,32576,29435,3141,9.6,-962
"Jefferson County, AR",AR,2011,33538,29954,3584,10.7,-386
"Jefferson County, AR",AR,2010,33924,30505,3419,10.1,0
"Jefferson County, CO",CO,2021,334051,317284,16767,5.0,6501
"Jefferson County, CO",CO,2020,327550,305440,22110,6.8,-3846
"Jefferson County, CO",CO,2019,331396,323425,7971,2.4,3698
"Jefferson County, CO",CO,2018,327698,318566,9132,2.8,7320
"Jefferson County, CO",CO,2017,320378,312568,7810,2.4,4972
"Jefferson County, CO",CO,2016,315406,306493,8913,2.8,6507
"Jefferson County, CO",CO,2015,308899,298400,10499,3.4,1380
"Jefferson County, CO",CO,2014,307519,293571,13948,4.5,2355
"Jefferson County, CO",CO,2013,305164,286333,18831,6.2,1742
"Jefferson County, CO",CO,2012,303422,280682,22740,7.5,1655
"Jefferson County, CO",CO,2011,301767,276822,24945,8.3,-1441
"Jefferson County, CO",CO,2010,303208,276614,26594,8.8,0
"Jefferson County, FL",FL,2021,5580,5345,235,4.2,167
"Jefferson County, FL",FL,2020,5413,5085,328,6.1,-81
"Jefferson County, FL",FL,2019,5494,5306,188,3.4,-34
"Jefferson County, FL",FL,2018,5528,5312,216,3.9,73
"Jefferson County, FL",FL,2017,5455,5213,242,4.4,51
"Jefferson County, FL",FL,2016,5404,5117,287,5.3,9
"Jefferson County, FL",FL,2015,5395,5071,324,6.0,-94
"Jefferson County, FL",FL,2014,5489,5116,373,6.8,33
"Jefferson County, FL",FL,2013,5456,5015,441,8.1,-16
"Jefferson County, FL",FL,2012,5472,4950,522,9.5,-412
"Jefferson County, FL",FL,2011,5884,5293,591,10.0,-108
"Jefferson County, FL",FL,2010,5992,5417,575,9.6,0
"Jefferson County, GA",GA,2021,6979,6652,327,4.7,305
"Jefferson County, GA",GA,2020,6674,6227,447,6.7,30
"Jefferson County, GA",GA,2019,6644,6316,328,4.9,-86
"Jefferson County, GA",GA,2018,6730,6368,362,5.4,-83
"Jefferson County, GA",GA,2017,6813,6389,424,6.2,214
"Jefferson County, GA",GA,2016,6599,6106,493,7.5,301
"Jefferson County, GA",GA,2015,6298,5719,579,9.2,-346
"Jefferson County, GA",GA,2014,6644,5893,751,11.3,-186
"Jefferson County, GA",GA,2013,6830,5881,949,13.9,-225
"Jefferson County, GA",GA,2012,7055,6136,919,13.0,-49
"Jefferson County, GA",GA,2011,7104,6171,933,13.1,-77
"Jefferson County, GA",GA,2010,7181,6159,1022,14.2,0
"Jefferson County, IA",IA,2021,9849,9435,414,4.2,-19
"Jefferson County, IA",IA,2020,9868,9337,531,5.4,-381
"Jefferson County, IA",IA,2019,10249,10011,238,2.3,385
"Jefferson County, IA",IA,2018,9864,9643,221,2.2,631
"Jefferson County, IA",IA,2017,9233,8953,280,3.0,0
"Jefferson County, IA",IA,2016,9233,8897,336,3.6,82
"Jefferson County, IA",IA,2015,9151,8803,348,3.8,71
"Jefferson County, IA",IA,2014,9080,8685,395,4.4,144
"Jefferson County, IA",IA,2013,8936,8493,443,5.0,139
"Jefferson County, IA",IA,2012,8797,8333,464,5.3,-59
"Jefferson County, IA",IA,2011,8856,8316,540,6.1,-82
"Jefferson County, IA",IA,2010,8938,8290,648,7.2,0
"Jefferson County, ID",ID,2021,14673,14274,399,2.7,472
"Jefferson County, ID",ID,2020,14201,13703,498,3.5,94
"Jefferson County, ID",ID,2019,14107,13774,333,2.4,412
"Jefferson County, ID",ID,2018,13695,13380,315,2.3,526
"Jefferson County, ID",ID,2017,13169,12833,336,2.6,346
"Jefferson County, ID",ID,2016,12823,12439,384,3.0,339
"Jefferson County, ID",ID,2015,12484,12089,395,3.2,274
"Jefferson County, ID",ID,2014,12210,11765,445,3.6,-23
"Jefferson County, ID",ID,2013,12233,11536,697,5.7,-5
"Jefferson County, ID",ID,2012,12238,11468,770,6.3,-256
"Jefferson County, ID",ID,2011,12494,11648,846,6.8,-131
"Jefferson County, ID",ID,2010,12625,11762,863,6.8,0
"Jefferson County, IL",IL,2021,16498,15476,1022,6.2,-443
"Jefferson County, IL",IL,2020,16941,15220,1721,10.2,-488
"Jefferson County, IL",IL,2019,17429,16663,766,4.4,-377
"Jefferson County, IL",IL,2018,17806,16877,929,5.2,296
"Jefferson County, IL",IL,2017,17510,16556,954,5.4,-132
"Jefferson County, IL",IL,2016,17642,16512,1130,6.4,439
"Jefferson County, IL",IL,2015,17203,16040,1163,6.8,-413
"Jefferson County, IL",IL,2014,17616,16289,1327,7.5,-199
"Jefferson County, IL",IL,2013,17815,16125,1690,9.5,-1
"Jefferson County, IL",IL,2012,17816,16167,1649,9.3,-356
"Jefferson County, IL",IL,2011,18172,16473,1699,9.3,-25
"Jefferson County, IL",IL,2010,18197,16328,1869,10.3,0
"Jefferson County, IN",IN,2021,14891,14422,469,3.1,-64
"Jefferson County, IN",IN,2020,14955,13834,1121,7.5,-203
"Jefferson County, IN",IN,2019,15158,14654,504,3.3,32
"Jefferson County, IN",IN,2018,15126,14616,510,3.4,51
"Jefferson County, IN",IN,2017,15075,14521,554,3.7,-225
"Jefferson County, IN",IN,2016,15300,14597,703,4.6,-24
"Jefferson County, IN",IN,2015,15324,14586,738,4.8,255
"Jefferson County, IN",IN,2014,15069,14156,913,6.1,-266
"Jefferson County, IN",IN,2013,15335,14146,1189,7.8,98
"Jefferson County, IN",IN,2012,15237,13960,1277,8.4,27
"Jefferson County, IN",IN,2011,15210,13746,1464,9.6,-257
"Jefferson County, IN",IN,2010,15467,13753,1714,11.1,0
"Jefferson County, KS",KS,2021,10332,10025,307,3.0,98
"Jefferson County, KS",KS,2020,10234,9755,479,4.7,14
"Jefferson County, KS",KS,2019,10220,9912,308,3.0,27
"Jefferson County, KS",KS,2018,10193,9872,321,3.1,-45
"Jefferson County, KS",KS,2017,10238,9877,361,3.5,-24
"Jefferson County, KS",KS,2016,10262,9864,398,3.9,48
"Jefferson County, KS",KS,2015,10214,9787,427,4.2,-17
"Jefferson County, KS",KS,2014,10231,9741,490,4.8,20
"Jefferson County, KS",KS,2013,10211,9626,585,5.7,-68
"Jefferson County, KS",KS,2012,10279,9658,621,6.0,-219
"Jefferson County, KS",KS,2011,10498,9763,735,7.0,-172
"Jefferson County, KS",KS,2010,10670,9880,790,7.4,0
"Jefferson County, KY",KY,2021,394151,375210,18941,4.8,4681
"Jefferson County, KY",KY,2020,389470,363625,25845,6.6,-10184
"Jefferson County, KY",KY,2019,399654,384392,15262,3.8,-259
"Jefferson County, KY",KY,2018,399913,384200,15713,3.9,3321
"Jefferson County, KY",KY,2017,396592,379470,17122,4.3,9823
"Jefferson County, KY",KY,2016,386769,369938,16831,4.4,9308
"Jefferson County, KY",KY,2015,377461,359625,17836,4.7,-86
"Jefferson County, KY",KY,2014,377547,354906,22641,6.0,-7852
"Jefferson County, KY",KY,2013,385399,356840,28559,7.4,2616
"Jefferson County, KY",KY,2012,382783,352232,30551,8.0,3084
"Jefferson County, KY",KY,2011,379699,343900,35799,9.4,-942
"Jefferson County, KY",KY,2010,380641,342218,38423,10.1,0
"Jefferson County, MO",MO,2021,117556,112790,4766,4.1,859
"Jefferson County, MO",MO,2020,116697,109659,7038,6.0,-1908
"Jefferson County, MO",MO,2019,118605,115151,3454,2.9,2108
"Jefferson County, MO",MO,2018,116497,112936,3561,3.1,317
"Jefferson County, MO",MO,2017,116180,112044,4136,3.6,-1322
"Jefferson County, MO",MO,2016,117502,112461,5041,4.3,564
"Jefferson County, MO",MO,2015,116938,111148,5790,5.0,1005
"Jefferson County, MO",MO,2014,115933,108688,7245,6.2,1427
"Jefferson County, MO",MO,2013,114506,106651,7855,6.9,13
"Jefferson County, MO",MO,2012,114493,106005,8488,7.4,-1870
"Jefferson County, MO",MO,2011,116363,105956,10407,8.9,-646
"Jefferson County, MO",MO,2010,117009,104981,12028,10.3,0
"Jefferson County, MS",MS,2021,1919,1601,318,16.6,-38
"Jefferson County, MS",MS,2020,1957,1605,352,18.0,-54
"Jefferson County, MS",MS,2019,2011,1695,316,15.7,-13
"Jefferson County, MS",MS,2018,2024,1752,272,13.4,-96
"Jefferson County, MS",MS,2017,2120,1802,318,15.0,-101
"Jefferson County, MS",MS,2016,2221,1884,337,15.2,-52
"Jefferson County, MS",MS,2015,2273,1930,343,15.1,-126
"Jefferson County, MS",MS,2014,2399,2009,390,16.3,-81
"Jefferson County, MS",MS,2013,2480,2005,475,19.2,-59
"Jefferson County, MS",MS,2012,2539,2106,433,17.1,-1
"Jefferson County, MS",MS,2011,2540,2077,463,18.2,70
"Jefferson County, MS",MS,2010,2470,2017,453,18.3,0
"Jefferson County, MT",MT,2021,5906,5715,191,3.2,76
"Jefferson County, MT",MT,2020,5830,5538,292,5.0,26
"Jefferson County, MT",MT,2019,5804,5606,198,3.4,113
"Jefferson County, MT",MT,2018,5691,5472,219,3.8,27
"Jefferson County, MT",MT,2017,5664,5416,248,4.4,-5
"Jefferson County, MT",MT,2016,5669,5399,270,4.8,84
"Jefferson County, MT",MT,2015,5585,5351,234,4.2,-47
"Jefferson County, MT",MT,2014,5632,5373,259,4.6,19
"Jefferson County, MT",MT,2013,5613,5341,272,4.8,12
"Jefferson County, MT",MT,2012,5601,5301,300,5.4,-18
"Jefferson County, MT",MT,2011,5619,5283,336,6.0,-12
"Jefferson County, MT",MT,2010,5631,5283,348,6.2,0
"Jefferson County, NE",NE,2021,4230,4155,75,1.8,-6
"Jefferson County, NE",NE,2020,4236,4123,113,2.7,42
"Jefferson County, NE",NE,2019,4194,4080,114,2.7,-3
"Jefferson County, NE",NE,2018,4197,4090,107,2.5,-38
"Jefferson County, NE",NE,2017,4235,4131,104,2.5,-10
"Jefferson County, NE",NE,2016,4245,4143,102,2.4,-46
"Jefferson County, NE",NE,2015,4291,4175,116,2.7,-11
"Jefferson County, NE",NE,2014,4302,4172,130,3.0,-30
"Jefferson County, NE",NE,2013,4332,4175,157,3.6,19
"Jefferson County, NE",NE,2012,4313,4154,159,3.7,-64
"Jefferson County, NE",NE,2011,4377,4187,190,4.3,132
"Jefferson County, NE",NE,2010,4245,4041,204,4.8,0
"Jefferson County, NY",NY,2021,43765,41564,2201,5.0,-325
"Jefferson County, NY",NY,2020,44090,40387,3703,8.4,-812
"Jefferson County, NY",NY,2019,44902,42496,2406,5.4,-537
"Jefferson County, NY",NY,2018,45439,42923,2516,5.5,-381
"Jefferson County, NY",NY,2017,45820,42859,2961,6.5,129
"Jefferson County, NY",NY,2016,45691,42795,2896,6.3,-760
"Jefferson County, NY",NY,2015,46451,43366,3085,6.6,-103
"Jefferson County, NY",NY,2014,46554,42979,3575,7.7,-1744
"Jefferson County, NY",NY,2013,48298,43729,4569,9.5,-61
"Jefferson County, NY",NY,2012,48359,43529,4830,10.0,-635
"Jefferson County, NY",NY,2011,48994,44189,4805,9.8,-1341
"Jefferson County, NY",NY,2010,50335,45598,4737,9.4,0
"Jefferson County, OH",OH,2021,27241,25475,1766,6.5,-179
"Jefferson County, OH",OH,2020,27420,24650,2770,10.1,-630
"Jefferson County, OH",OH,2019,28050,26401,1649,5.9,237
"Jefferson County, OH",OH,2018,27813,26070,1743,6.3,-161
"Jefferson County, OH",OH,2017,27974,25922,2052,7.3,-1050
"Jefferson County, OH",OH,2016,29024,26583,2441,8.4,-468
"Jefferson County, OH",OH,2015,29492,27280,2212,7.5,-374
"Jefferson County, OH",OH,2014,29866,27438,2428,8.1,-711
"Jefferson County, OH",OH,2013,30577,27255,3322,10.9,-694
"Jefferson County, OH",OH,2012,31271,27881,3390,10.8,-636
"Jefferson County, OH",OH,2011,31907,28081,3826,12.0,-1478
"Jefferson County, OH",OH,2010,33385,28551,4834,14.5,0
"Jefferson County, OK",OK,2021,2471,2373,98,4.0,-83
"Jefferson County, OK",OK,2020,2554,2384,170,6.7,71
"Jefferson County, OK",OK,2019,2483,2407,76,3.1,-92
"Jefferson County, OK",OK,2018,2575,2491,84,3.3,90
"Jefferson County, OK",OK,2017,2485,2354,131,5.3,-220
"Jefferson County, OK",OK,2016,2705,2518,187,6.9,28
"Jefferson County, OK",OK,2015,2677,2527,150,5.6,95
"Jefferson County, OK",OK,2014,2582,2466,116,4.5,4
"Jefferson County, OK",OK,2013,2578,2446,132,5.1,-15
"Jefferson County, OK",OK,2012,2593,2469,124,4.8,-57
"Jefferson County, OK",OK,2011,2650,2496,154,5.8,-27
"Jefferson County, OK",OK,2010,2677,2483,194,7.2,0
"Jefferson County, OR",OR,2021,10459,9782,677,6.5,138
"Jefferson County, OR",OR,2020,10321,9470,851,8.2,204
"Jefferson County, OR",OR,2019,10117,9612,505,5.0,23
"Jefferson County, OR",OR,2018,10094,9561,533,5.3,186
"Jefferson County, OR",OR,2017,9908,9362,546,5.5,75
"Jefferson County, OR",OR,2016,9833,9195,638,6.5,187
"Jefferson County, OR",OR,2015,9646,8957,689,7.1,206
"Jefferson County, OR",OR,2014,9440,8615,825,8.7,161
"Jefferson County, OR",OR,2013,9279,8322,957,10.3,-363
"Jefferson County, OR",OR,2012,9642,8506,1136,11.8,30
"Jefferson County, OR",OR,2011,9612,8375,1237,12.9,-56
"Jefferson County, OR",OR,2010,9668,8337,1331,13.8,0
"Jefferson County, PA",PA,2021,19626,18346,1280,6.5,-725
"Jefferson County, PA",PA,2020,20351,18565,1786,8.8,-431
"Jefferson County, PA",PA,2019,20782,19774,1008,4.9,44
"Jefferson County, PA",PA,2018,20738,19737,1001,4.8,-22
"Jefferson County, PA",PA,2017,20760,19585,1175,5.7,30
"Jefferson County, PA",PA,2016,20730,19326,1404,6.8,-253
"Jefferson County, PA",PA,2015,20983,19678,1305,6.2,148
"Jefferson County, PA",PA,2014,20835,19484,1351,6.5,-182
"Jefferson County, PA",PA,2013,21017,19347,1670,7.9,-690
"Jefferson County, PA",PA,2012,21707,19939,1768,8.1,-36
"Jefferson County, PA",PA,2011,21743,19882,1861,8.6,217
"Jefferson County, PA",PA,2010,21526,19421,2105,9.8,0
"Jefferson County, TN",TN,2021,24817,23796,1021,4.1,-129
"Jefferson County, TN",TN,2020,24946,23080,1866,7.5,175
"Jefferson County, TN",TN,2019,24771,23852,919,3.7,629
"Jefferson County, TN",TN,2018,24142,23229,913,3.8,220
"Jefferson County, TN",TN,2017,23922,22954,968,4.0,293
"Jefferson County, TN",TN,2016,23629,22377,1252,5.3,287
"Jefferson County, TN",TN,2015,23342,21860,1482,6.3,251
"Jefferson County, TN",TN,2014,23091,21374,1717,7.4,-291
"Jefferson County, TN",TN,2013,23382,21271,2111,9.0,-590
"Jefferson County, TN",TN,2012,23972,21689,2283,9.5,-287
"Jefferson County, TN",TN,2011,24259,21678,2581,10.6,-183
"Jefferson County, TN",TN,2010,24442,21589,2853,11.7,0
"Jefferson County, TX",TX,2021,101725,91528,10197,10.0,-2300
"Jefferson County, TX",TX,2020,104025,91569,12456,12.0,-628
"Jefferson County, TX",TX,2019,104653,98531,6122,5.8,-1552
"Jefferson County, TX",TX,2018,106205,99407,6798,6.4,-628
"Jefferson County, TX",TX,2017,106833,98895,7938,7.4,-713
"Jefferson County, TX",TX,2016,107546,99999,7547,7.0,-485
"Jefferson County, TX",TX,2015,108031,100448,7583,7.0,-2003
"Jefferson County, TX",TX,2014,110034,100799,9235,8.4,-1051
"Jefferson County, TX",TX,2013,111085,98920,12165,11.0,-2212
"Jefferson County, TX",TX,2012,113297,100854,12443,11.0,-2250
"Jefferson County, TX",TX,2011,115547,101984,13563,11.7,2182
"Jefferson County, TX",TX,2010,113365,100468,12897,11.4,0
"Jefferson County, WA",WA,2021,12802,12008,794,6.2,-106
"Jefferson County, WA",WA,2020,12908,11686,1222,9.5,-92
"Jefferson County, WA",WA,2019,13000,12249,751,5.8,663
"Jefferson County, WA",WA,2018,12337,11628,709,5.7,369
"Jefferson County, WA",WA,2017,11968,11249,719,6.0,452
"Jefferson County, WA",WA,2016,11516,10714,802,7.0,320
"Jefferson County, WA",WA,2015,11196,10422,774,6.9,21
"Jefferson County, WA",WA,2014,11175,10304,871,7.8,-232
"Jefferson County, WA",WA,2013,11407,10360,1047,9.2,-460
"Jefferson County, WA",WA,2012,11867,10783,1084,9.1,-78
"Jefferson County, WA",WA,2011,11945,10819,1126,9.4,-547
"Jefferson County, WA",WA,2010,12492,11324,1168,9.3,0
"Jefferson County, WI",WI,2021,46726,45172,1554,3.3,1104
"Jefferson County, WI",WI,2020,45622,43114,2508,5.5,-429
"Jefferson County, WI",WI,2019,46051,44685,1366,3.0,-163
"Jefferson County, WI",WI,2018,46214,44900,1314,2.8,458
"Jefferson County, WI",WI,2017,45756,44308,1448,3.2,171
"Jefferson County, WI",WI,2016,45585,43852,1733,3.8,44
"Jefferson County, WI",WI,2015,45541,43657,1884,4.1,-220
"Jefferson County, WI",WI,2014,45761,43512,2249,4.9,-138
"Jefferson County, WI",WI,2013,45899,43042,2857,6.2,-263
"Jefferson County, WI",WI,2012,46162,43132,3030,6.6,-164
"Jefferson County, WI",WI,2011,46326,42905,3421,7.4,-166
"Jefferson County, WI",WI,2010,46492,42510,3982,8.6,0
"Jefferson County, WV",WV,2021,30391,29451,940,3.1,717
"Jefferson County, WV",WV,2020,29674,27945,1729,5.8,-896
"Jefferson County, WV",WV,2019,30570,29615,955,3.1,588
"Jefferson County, WV",WV,2018,29982,28991,991,3.3,512
"Jefferson County, WV",WV,2017,29470,28556,914,3.1,822
"Jefferson County, WV",WV,2016,28648,27683,965,3.4,548
"Jefferson County, WV",WV,2015,28100,26973,1127,4.0,938
"Jefferson County, WV",WV,2014,27162,25920,1242,4.6,-281
"Jefferson County, WV",WV,2013,27443,26142,1301,4.7,-88
"Jefferson County, WV",WV,2012,27531,26095,1436,5.2,312
"Jefferson County, WV",WV,2011,27219,25570,1649,6.1,387
"Jefferson County, WV",WV,2010,26832,25043,1789,6.7,0
"Jefferson Davis County, MS",MS,2021,3897,3596,301,7.7,-47
"Jefferson Davis County, MS",MS,2020,3944,3573,371,9.4,-158
"Jefferson Davis County, MS",MS,2019,4102,3817,285,6.9,7
"Jefferson Davis County, MS",MS,2018,4095,3814,281,6.9,-134
"Jefferson Davis County, MS",MS,2017,4229,3933,296,7.0,64
"Jefferson Davis County, MS",MS,2016,4165,3814,351,8.4,48
"Jefferson Davis County, MS",MS,2015,4117,3753,364,8.8,10
"Jefferson Davis County, MS",MS,2014,4107,3682,425,10.3,-113
"Jefferson Davis County, MS",MS,2013,4220,3690,530,12.6,-282
"Jefferson Davis County, MS",MS,2012,4502,3931,571,12.7,-142
"Jefferson Davis County, MS",MS,2011,4644,4011,633,13.6,31
"Jefferson Davis County, MS",MS,2010,4613,3982,631,13.7,0
"Jefferson Davis Parish, LA",LA,2021,12658,12057,601,4.7,-70
"Jefferson Davis Parish, LA",LA,2020,12728,11702,1026,8.1,-615
"Jefferson Davis Parish, LA",LA,2019,13343,12739,604,4.5,-208
"Jefferson Davis Parish, LA",LA,2018,13551,12916,635,4.7,-92
"Jefferson Davis Parish, LA",LA,2017,13643,12979,664,4.9,51
"Jefferson Davis Parish, LA",LA,2016,13592,12773,819,6.0,49
"Jefferson Davis Parish, LA",LA,2015,13543,12709,834,6.2,29
"Jefferson Davis Parish, LA",LA,2014,13514,12735,779,5.8,345
"Jefferson Davis Parish, LA",LA,2013,13169,12385,784,6.0,132
"Jefferson Davis Parish, LA",LA,2012,13037,12228,809,6.2,80
"Jefferson Davis Parish, LA",LA,2011,12957,12070,887,6.8,-149
"Jefferson Davis Parish, LA",LA,2010,13106,12173,933,7.1,0
"Jefferson Parish, LA",LA,2021,208446,196000,12446,6.0,-1017
"Jefferson Parish, LA",LA,2020,209463,189241,20222,9.7,-5103
"Jefferson Parish, LA",LA,2019,214566,205922,8644,4.0,463
"Jefferson Parish, LA",LA,2018,214103,204826,9277,4.3,-1238
"Jefferson Parish, LA",LA,2017,215341,205590,9751,4.5,-1407
"Jefferson Parish, LA",LA,2016,216748,205292,11456,5.3,-1826
"Jefferson Parish, LA",LA,2015,218574,206102,12472,5.7,1404
"Jefferson Parish, LA",LA,2014,217170,204407,12763,5.9,3432
"Jefferson Parish, LA",LA,2013,213738,200869,12869,6.0,525
"Jefferson Parish, LA",LA,2012,213213,199607,13606,6.4,-621
"Jefferson Parish, LA",LA,2011,213834,199220,14614,6.8,-2326
"Jefferson Parish, LA",LA,2010,216160,201126,15034,7.0,0
"Jenkins County, GA",GA,2021,3217,3066,151,4.7,28
"Jenkins County, GA",GA,2020,3189,2988,201,6.3,-24
"Jenkins County, GA",GA,2019,3213,3044,169,5.3,23
"Jenkins County, GA",GA,2018,3190,3017,173,5.4,-6
"Jenkins County, GA",GA,2017,3196,2979,217,6.8,33
"Jenkins County, GA",GA,2016,3163,2921,242,7.7,92
"Jenkins County, GA",GA,2015,3071,2811,260,8.5,-185
"Jenkins County, GA",GA,2014,3256,2930,326,10.0,-62
"Jenkins County, GA",GA,2013,3318,2911,407,12.3,-32
"Jenkins County, GA",GA,2012,3350,2896,454,13.6,152
"Jenkins County, GA",GA,2011,3198,2743,455,14.2,-41
"Jenkins County, GA",GA,2010,3239,2741,498,15.4,0
"Jennings County, IN",IN,2021,13342,12852,490,3.7,-217
"Jennings County, IN",IN,2020,13559,12508,1051,7.8,-96
"Jennings County, IN",IN,2019,13655,13216,439,3.2,40
"Jennings County, IN",IN,2018,13615,13127,488,3.6,372
"Jennings County, IN",IN,2017,13243,12744,499,3.8,-35
"Jennings County, IN",IN,2016,13278,12656,622,4.7,112
"Jennings County, IN",IN,2015,13166,12494,672,5.1,71
"Jennings County, IN",IN,2014,13095,12221,874,6.7,47
"Jennings County, IN",IN,2013,13048,11872,1176,9.0,-70
"Jennings County, IN",IN,2012,13118,11786,1332,10.2,-244
"Jennings County, IN",IN,2011,13362,11854,1508,11.3,64
"Jennings County, IN",IN,2010,13298,11619,1679,12.6,0
"Jerauld County, SD",SD,2021,1331,1302,29,2.2,141
"Jerauld County, SD",SD,2020,1190,1163,27,2.3,76
"Jerauld County, SD",SD,2019,1114,1087,27,2.4,2
"Jerauld County, SD",SD,2018,1112,1087,25,2.2,-26
"Jerauld County, SD",SD,2017,1138,1113,25,2.2,61
"Jerauld County, SD",SD,2016,1077,1050,27,2.5,-56
"Jerauld County, SD",SD,2015,1133,1108,25,2.2,-74
"Jerauld County, SD",SD,2014,1207,1178,29,2.4,4
"Jerauld County, SD",SD,2013,1203,1167,36,3.0,-26
"Jerauld County, SD",SD,2012,1229,1193,36,2.9,-15
"Jerauld County, SD",SD,2011,1244,1201,43,3.5,40
"Jerauld County, SD",SD,2010,1204,1161,43,3.6,0
"Jerome County, ID",ID,2021,12348,11936,412,3.3,174
"Jerome County, ID",ID,2020,12174,11674,500,4.1,-174
"Jerome County, ID",ID,2019,12348,12023,325,2.6,297
"Jerome County, ID",ID,2018,12051,11740,311,2.6,332
"Jerome County, ID",ID,2017,11719,11388,331,2.8,375
"Jerome County, ID",ID,2016,11344,10998,346,3.1,-3
"Jerome County, ID",ID,2015,11347,10999,348,3.1,208
"Jerome County, ID",ID,2014,11139,10738,401,3.6,226
"Jerome County, ID",ID,2013,10913,10263,650,6.0,-1
"Jerome County, ID",ID,2012,10914,10191,723,6.6,-98
"Jerome County, ID",ID,2011,11012,10200,812,7.4,-4
"Jerome County, ID",ID,2010,11016,10155,861,7.8,0
"Jersey County, IL",IL,2021,10545,10083,462,4.4,-35
"Jersey County, IL",IL,2020,10580,9770,810,7.7,-485
"Jersey County, IL",IL,2019,11065,10601,464,4.2,56
"Jersey County, IL",IL,2018,11009,10482,527,4.8,44
"Jersey County, IL",IL,2017,10965,10436,529,4.8,-137
"Jersey County, IL",IL,2016,11102,10455,647,5.8,6
"Jersey County, IL",IL,2015,11096,10392,704,6.3,20
"Jersey County, IL",IL,2014,11076,10276,800,7.2,-66
"Jersey County, IL",IL,2013,11142,10147,995,8.9,-208
"Jersey County, IL",IL,2012,11350,10320,1030,9.1,-232
"Jersey County, IL",IL,2011,11582,10544,1038,9.0,-8
"Jersey County, IL",IL,2010,11590,10521,1069,9.2,0
"Jessamine County, KY",KY,2021,26219,25165,1054,4.0,285
"Jessamine County, KY",KY,2020,25934,24522,1412,5.4,-860
"Jessamine County, KY",KY,2019,26794,25870,924,3.4,351
"Jessamine County, KY",KY,2018,26443,25507,936,3.5,10
"Jessamine County, KY",KY,2017,26433,25450,983,3.7,766
"Jessamine County, KY",KY,2016,25667,24677,990,3.9,404
"Jessamine County, KY",KY,2015,25263,24218,1045,4.1,342
"Jessamine County, KY",KY,2014,24921,23619,1302,5.2,-173
"Jessamine County, KY",KY,2013,25094,23479,1615,6.4,272
"Jessamine County, KY",KY,2012,24822,23151,1671,6.7,110
"Jessamine County, KY",KY,2011,24712,22796,1916,7.8,-121
"Jessamine County, KY",KY,2010,24833,22709,2124,8.6,0
"Jewell County, KS",KS,2021,1235,1208,27,2.2,-14
"Jewell County, KS",KS,2020,1249,1213,36,2.9,-58
"Jewell County, KS",KS,2019,1307,1271,36,2.8,16
"Jewell County, KS",KS,2018,1291,1257,34,2.6,-17
"Jewell County, KS",KS,2017,1308,1263,45,3.4,-28
"Jewell County, KS",KS,2016,1336,1279,57,4.3,-42
"Jewell County, KS",KS,2015,1378,1318,60,4.4,-4
"Jewell County, KS",KS,2014,1382,1329,53,3.8,-43
"Jewell County, KS",KS,2013,1425,1373,52,3.6,-30
"Jewell County, KS",KS,2012,1455,1393,62,4.3,-80
"Jewell County, KS",KS,2011,1535,1464,71,4.6,-23
"Jewell County, KS",KS,2010,1558,1474,84,5.4,0
"Jim Hogg County, TX",TX,2021,1859,1695,164,8.8,-4
"Jim Hogg County, TX",TX,2020,1863,1685,178,9.6,4
"Jim Hogg County, TX",TX,2019,1859,1770,89,4.8,-2
"Jim Hogg County, TX",TX,2018,1861,1754,107,5.7,-31
"Jim Hogg County, TX",TX,2017,1892,1753,139,7.3,-53
"Jim Hogg County, TX",TX,2016,1945,1759,186,9.6,-84
"Jim Hogg County, TX",TX,2015,2029,1882,147,7.2,-167
"Jim Hogg County, TX",TX,2014,2196,2061,135,6.1,-125
"Jim Hogg County, TX",TX,2013,2321,2155,166,7.2,-23
"Jim Hogg County, TX",TX,2012,2344,2191,153,6.5,14
"Jim Hogg County, TX",TX,2011,2330,2122,208,8.9,-2
"Jim Hogg County, TX",TX,2010,2332,2091,241,10.3,0
"Jim Wells County, TX",TX,2021,15607,14019,1588,10.2,-390
"Jim Wells County, TX",TX,2020,15997,13919,2078,13.0,-659
"Jim Wells County, TX",TX,2019,16656,15872,784,4.7,-171
"Jim Wells County, TX",TX,2018,16827,15907,920,5.5,291
"Jim Wells County, TX",TX,2017,16536,15271,1265,7.6,-934
"Jim Wells County, TX",TX,2016,17470,15625,1845,10.6,-1760
"Jim Wells County, TX",TX,2015,19230,17702,1528,7.9,-847
"Jim Wells County, TX",TX,2014,20077,19015,1062,5.3,-25
"Jim Wells County, TX",TX,2013,20102,18861,1241,6.2,-504
"Jim Wells County, TX",TX,2012,20606,19339,1267,6.1,839
"Jim Wells County, TX",TX,2011,19767,18144,1623,8.2,1475
"Jim Wells County, TX",TX,2010,18292,16453,1839,10.1,0
"Jo Daviess County, IL",IL,2021,10552,10087,465,4.4,117
"Jo Daviess County, IL",IL,2020,10435,9559,876,8.4,-392
"Jo Daviess County, IL",IL,2019,10827,10407,420,3.9,-243
"Jo Daviess County, IL",IL,2018,11070,10594,476,4.3,-4
"Jo Daviess County, IL",IL,2017,11074,10580,494,4.5,-351
"Jo Daviess County, IL",IL,2016,11425,10810,615,5.4,-46
"Jo Daviess County, IL",IL,2015,11471,10842,629,5.5,-89
"Jo Daviess County, IL",IL,2014,11560,10843,717,6.2,-24
"Jo Daviess County, IL",IL,2013,11584,10703,881,7.6,-247
"Jo Daviess County, IL",IL,2012,11831,10930,901,7.6,-299
"Jo Daviess County, IL",IL,2011,12130,11166,964,7.9,-294
"Jo Daviess County, IL",IL,2010,12424,11312,1112,9.0,0
"Johnson County, AR",AR,2021,9835,9373,462,4.7,-305
"Johnson County, AR",AR,2020,10140,9498,642,6.3,-139
"Johnson County, AR",AR,2019,10279,9820,459,4.5,-110
"Johnson County, AR",AR,2018,10389,9922,467,4.5,-186
"Johnson County, AR",AR,2017,10575,10120,455,4.3,24
"Johnson County, AR",AR,2016,10551,10049,502,4.8,105
"Johnson County, AR",AR,2015,10446,9854,592,5.7,66
"Johnson County, AR",AR,2014,10380,9716,664,6.4,-251
"Johnson County, AR",AR,2013,10631,9839,792,7.4,-248
"Johnson County, AR",AR,2012,10879,10111,768,7.1,-228
"Johnson County, AR",AR,2011,11107,10274,833,7.5,135
"Johnson County, AR",AR,2010,10972,10103,869,7.9,0
"Johnson County, GA",GA,2021,4150,4003,147,3.5,149
"Johnson County, GA",GA,2020,4001,3805,196,4.9,-79
"Johnson County, GA",GA,2019,4080,3925,155,3.8,-27
"Johnson County, GA",GA,2018,4107,3944,163,4.0,-33
"Johnson County, GA",GA,2017,4140,3929,211,5.1,215
"Johnson County, GA",GA,2016,3925,3683,242,6.2,96
"Johnson County, GA",GA,2015,3829,3556,273,7.1,-101
"Johnson County, GA",GA,2014,3930,3591,339,8.6,-64
"Johnson County, GA",GA,2013,3994,3604,390,9.8,-56
"Johnson County, GA",GA,2012,4050,3652,398,9.8,-103
"Johnson County, GA",GA,2011,4153,3699,454,10.9,-98
"Johnson County, GA",GA,2010,4251,3786,465,10.9,0
"Johnson County, IA",IA,2021,84310,81160,3150,3.7,-894
"Johnson County, IA",IA,2020,85204,81202,4002,4.7,-3376
"Johnson County, IA",IA,2019,88580,86888,1692,1.9,1645
"Johnson County, IA",IA,2018,86935,85260,1675,1.9,709
"Johnson County, IA",IA,2017,86226,84122,2104,2.4,1467
"Johnson County, IA",IA,2016,84759,82580,2179,2.6,861
"Johnson County, IA",IA,2015,83898,81684,2214,2.6,-136
"Johnson County, IA",IA,2014,84034,81448,2586,3.1,1182
"Johnson County, IA",IA,2013,82852,80025,2827,3.4,2234
"Johnson County, IA",IA,2012,80618,77638,2980,3.7,617
"Johnson County, IA",IA,2011,80001,76712,3289,4.1,961
"Johnson County, IA",IA,2010,79040,75638,3402,4.3,0
"Johnson County, IL",IL,2021,4088,3843,245,6.0,5
"Johnson County, IL",IL,2020,4083,3712,371,9.1,-59
"Johnson County, IL",IL,2019,4142,3902,240,5.8,15
"Johnson County, IL",IL,2018,4127,3817,310,7.5,5
"Johnson County, IL",IL,2017,4122,3813,309,7.5,-105
"Johnson County, IL",IL,2016,4227,3858,369,8.7,85
"Johnson County, IL",IL,2015,4142,3788,354,8.5,-18
"Johnson County, IL",IL,2014,4160,3761,399,9.6,-122
"Johnson County, IL",IL,2013,4282,3762,520,12.1,-5
"Johnson County, IL",IL,2012,4287,3788,499,11.6,-106
"Johnson County, IL",IL,2011,4393,3877,516,11.7,-54
"Johnson County, IL",IL,2010,4447,3887,560,12.6,0
"Johnson County, IN",IN,2021,84093,81932,2161,2.6,1100
"Johnson County, IN",IN,2020,82993,78282,4711,5.7,-1062
"Johnson County, IN",IN,2019,84055,81817,2238,2.7,1283
"Johnson County, IN",IN,2018,82772,80411,2361,2.9,1831
"Johnson County, IN",IN,2017,80941,78569,2372,2.9,601
"Johnson County, IN",IN,2016,80340,77460,2880,3.6,2760
"Johnson County, IN",IN,2015,77580,74437,3143,4.1,2026
"Johnson County, IN",IN,2014,75554,71807,3747,5.0,1748
"Johnson County, IN",IN,2013,73806,69288,4518,6.1,1190
"Johnson County, IN",IN,2012,72616,67639,4977,6.9,401
"Johnson County, IN",IN,2011,72215,66756,5459,7.6,589
"Johnson County, IN",IN,2010,71626,65495,6131,8.6,0
"Johnson County, KS",KS,2021,343991,334751,9240,2.7,2468
"Johnson County, KS",KS,2020,341523,324768,16755,4.9,-228
"Johnson County, KS",KS,2019,341751,332426,9325,2.7,3810
"Johnson County, KS",KS,2018,337941,328372,9569,2.8,2475
"Johnson County, KS",KS,2017,335466,325342,10124,3.0,5640
"Johnson County, KS",KS,2016,329826,319111,10715,3.2,4261
"Johnson County, KS",KS,2015,325565,314557,11008,3.4,4265
"Johnson County, KS",KS,2014,321300,309249,12051,3.8,6388
"Johnson County, KS",KS,2013,314912,301328,13584,4.3,3459
"Johnson County, KS",KS,2012,311453,297179,14274,4.6,1631
"Johnson County, KS",KS,2011,309822,293473,16349,5.3,2614
"Johnson County, KS",KS,2010,307208,288721,18487,6.0,0
"Johnson County, KY",KY,2021,6659,6170,489,7.3,75
"Johnson County, KY",KY,2020,6584,6036,548,8.3,-166
"Johnson County, KY",KY,2019,6750,6328,422,6.3,-5
"Johnson County, KY",KY,2018,6755,6307,448,6.6,-161
"Johnson County, KY",KY,2017,6916,6331,585,8.5,-94
"Johnson County, KY",KY,2016,7010,6297,713,10.2,-148
"Johnson County, KY",KY,2015,7158,6531,627,8.8,-896
"Johnson County, KY",KY,2014,8054,7315,739,9.2,-308
"Johnson County, KY",KY,2013,8362,7448,914,10.9,-240
"Johnson County, KY",KY,2012,8602,7724,878,10.2,-109
"Johnson County, KY",KY,2011,8711,7769,942,10.8,-262
"Johnson County, KY",KY,2010,8973,7836,1137,12.7,0
"Johnson County, MO",MO,2021,23074,22060,1014,4.4,16
"Johnson County, MO",MO,2020,23058,21757,1301,5.6,70
"Johnson County, MO",MO,2019,22988,22183,805,3.5,272
"Johnson County, MO",MO,2018,22716,21890,826,3.6,-536
"Johnson County, MO",MO,2017,23252,22237,1015,4.4,96
"Johnson County, MO",MO,2016,23156,22024,1132,4.9,184
"Johnson County, MO",MO,2015,22972,21711,1261,5.5,245
"Johnson County, MO",MO,2014,22727,21255,1472,6.5,-149
"Johnson County, MO",MO,2013,22876,21203,1673,7.3,-49
"Johnson County, MO",MO,2012,22925,21112,1813,7.9,-469
"Johnson County, MO",MO,2011,23394,21214,2180,9.3,1
"Johnson County, MO",MO,2010,23393,21084,2309,9.9,0
"Johnson County, NE",NE,2021,2014,1956,58,2.9,-64
"Johnson County, NE",NE,2020,2078,1998,80,3.8,-7
"Johnson County, NE",NE,2019,2085,2014,71,3.4,-10
"Johnson County, NE",NE,2018,2095,2019,76,3.6,0
"Johnson County, NE",NE,2017,2095,2023,72,3.4,-8
"Johnson County, NE",NE,2016,2103,2037,66,3.1,-29
"Johnson County, NE",NE,2015,2132,2062,70,3.3,-37
"Johnson County, NE",NE,2014,2169,2087,82,3.8,-9
"Johnson County, NE",NE,2013,2178,2086,92,4.2,-10
"Johnson County, NE",NE,2012,2188,2096,92,4.2,-28
"Johnson County, NE",NE,2011,2216,2109,107,4.8,-124
"Johnson County, NE",NE,2010,2340,2229,111,4.7,0
"Johnson County, TN",TN,2021,7761,7488,273,3.5,79
"Johnson County, TN",TN,2020,7682,7202,480,6.2,-72
"Johnson County, TN",TN,2019,7754,7484,270,3.5,169
"Johnson County, TN",TN,2018,7585,7322,263,3.5,-17
"Johnson County, TN",TN,2017,7602,7303,299,3.9,56
"Johnson County, TN",TN,2016,7546,7182,364,4.8,222
"Johnson County, TN",TN,2015,7324,6915,409,5.6,172
"Johnson County, TN",TN,2014,7152,6660,492,6.9,-205
"Johnson County, TN",TN,2013,7357,6696,661,9.0,12
"Johnson County, TN",TN,2012,7345,6639,706,9.6,-168
"Johnson County, TN",TN,2011,7513,6634,879,11.7,57
"Johnson County, TN",TN,2010,7456,6484,972,13.0,0
"Johnson County, TX",TX,2021,85557,81406,4151,4.9,2724
"Johnson County, TX",TX,2020,82833,77464,5369,6.5,469
"Johnson County, TX",TX,2019,82364,79720,2644,3.2,2676
"Johnson County, TX",TX,2018,79688,76929,2759,3.5,2184
"Johnson County, TX",TX,2017,77504,74540,2964,3.8,1432
"Johnson County, TX",TX,2016,76072,72753,3319,4.4,1751
"Johnson County, TX",TX,2015,74321,71032,3289,4.4,58
"Johnson County, TX",TX,2014,74263,70470,3793,5.1,722
"Johnson County, TX",TX,2013,73541,69006,4535,6.2,555
"Johnson County, TX",TX,2012,72986,68168,4818,6.6,248
"Johnson County, TX",TX,2011,72738,66895,5843,8.0,687
"Johnson County, TX",TX,2010,72051,65766,6285,8.7,0
"Johnson County, WY",WY,2021,4242,4068,174,4.1,69
"Johnson County, WY",WY,2020,4173,3944,229,5.5,4
"Johnson County, WY",WY,2019,4169,4012,157,3.8,-86
"Johnson County, WY",WY,2018,4255,4085,170,4.0,47
"Johnson County, WY",WY,2017,4208,4027,181,4.3,1
"Johnson County, WY",WY,2016,4207,3981,226,5.4,40
"Johnson County, WY",WY,2015,4167,3966,201,4.8,-263
"Johnson County, WY",WY,2014,4430,4221,209,4.7,17
"Johnson County, WY",WY,2013,4413,4187,226,5.1,-7
"Johnson County, WY",WY,2012,4420,4178,242,5.5,-38
"Johnson County, WY",WY,2011,4458,4163,295,6.6,-58
"Johnson County, WY",WY,2010,4516,4184,332,7.4,0
"Johnston County, NC",NC,2021,101800,97527,4273,4.2,4170
"Johnston County, NC",NC,2020,97630,91691,5939,6.1,-1532
"Johnston County, NC",NC,2019,99162,95569,3593,3.6,3131
"Johnston County, NC",NC,2018,96031,92477,3554,3.7,2964
"Johnston County, NC",NC,2017,93067,89198,3869,4.2,1761
"Johnston County, NC",NC,2016,91306,87026,4280,4.7,3232
"Johnston County, NC",NC,2015,88074,83524,4550,5.2,2184
"Johnston County, NC",NC,2014,85890,81147,4743,5.5,1275
"Johnston County, NC",NC,2013,84615,78785,5830,6.9,393
"Johnston County, NC",NC,2012,84222,76949,7273,8.6,1332
"Johnston County, NC",NC,2011,82890,75033,7857,9.5,884
"Johnston County, NC",NC,2010,82006,73951,8055,9.8,0
"Johnston County, OK",OK,2021,3684,3516,168,4.6,-59
"Johnston County, OK",OK,2020,3743,3454,289,7.7,-1
"Johnston County, OK",OK,2019,3744,3590,154,4.1,-1436
"Johnston County, OK",OK,2018,5180,5033,147,2.8,159
"Johnston County, OK",OK,2017,5021,4832,189,3.8,653
"Johnston County, OK",OK,2016,4368,4120,248,5.7,403
"Johnston County, OK",OK,2015,3965,3713,252,6.4,339
"Johnston County, OK",OK,2014,3626,3381,245,6.8,48
"Johnston County, OK",OK,2013,3578,3295,283,7.9,-54
"Johnston County, OK",OK,2012,3632,3357,275,7.6,-67
"Johnston County, OK",OK,2011,3699,3397,302,8.2,-37
"Johnston County, OK",OK,2010,3736,3364,372,10.0,0
"Jones County, GA",GA,2021,13642,13224,418,3.1,277
"Jones County, GA",GA,2020,13365,12761,604,4.5,-403
"Jones County, GA",GA,2019,13768,13311,457,3.3,-178
"Jones County, GA",GA,2018,13946,13430,516,3.7,-125
"Jones County, GA",GA,2017,14071,13457,614,4.4,279
"Jones County, GA",GA,2016,13792,13121,671,4.9,470
"Jones County, GA",GA,2015,13322,12574,748,5.6,-349
"Jones County, GA",GA,2014,13671,12804,867,6.3,79
"Jones County, GA",GA,2013,13592,12610,982,7.2,-238
"Jones County, GA",GA,2012,13830,12674,1156,8.4,43
"Jones County, GA",GA,2011,13787,12530,1257,9.1,55
"Jones County, GA",GA,2010,13732,12381,1351,9.8,0
"Jones County, IA",IA,2021,10185,9728,457,4.5,-118
"Jones County, IA",IA,2020,10303,9730,573,5.6,-587
"Jones County, IA",IA,2019,10890,10561,329,3.0,164
"Jones County, IA",IA,2018,10726,10407,319,3.0,107
"Jones County, IA",IA,2017,10619,10237,382,3.6,-124
"Jones County, IA",IA,2016,10743,10287,456,4.2,-38
"Jones County, IA",IA,2015,10781,10335,446,4.1,-12
"Jones County, IA",IA,2014,10793,10263,530,4.9,47
"Jones County, IA",IA,2013,10746,10176,570,5.3,27
"Jones County, IA",IA,2012,10719,10153,566,5.3,-244
"Jones County, IA",IA,2011,10963,10315,648,5.9,-116
"Jones County, IA",IA,2010,11079,10363,716,6.5,0
"Jones County, MS",MS,2021,24598,23206,1392,5.7,-562
"Jones County, MS",MS,2020,25160,23412,1748,6.9,-1242
"Jones County, MS",MS,2019,26402,24996,1406,5.3,852
"Jones County, MS",MS,2018,25550,24270,1280,5.0,198
"Jones County, MS",MS,2017,25352,24004,1348,5.3,-328
"Jones County, MS",MS,2016,25680,24075,1605,6.3,-790
"Jones County, MS",MS,2015,26470,24860,1610,6.1,-112
"Jones County, MS",MS,2014,26582,24921,1661,6.2,-780
"Jones County, MS",MS,2013,27362,25441,1921,7.0,-1685
"Jones County, MS",MS,2012,29047,26893,2154,7.4,-157
"Jones County, MS",MS,2011,29204,26760,2444,8.4,1208
"Jones County, MS",MS,2010,27996,25515,2481,8.9,0
"Jones County, NC",NC,2021,4155,3979,176,4.2,104
"Jones County, NC",NC,2020,4051,3827,224,5.5,-227
"Jones County, NC",NC,2019,4278,4114,164,3.8,-42
"Jones County, NC",NC,2018,4320,4136,184,4.3,-25
"Jones County, NC",NC,2017,4345,4152,193,4.4,-156
"Jones County, NC",NC,2016,4501,4263,238,5.3,-42
"Jones County, NC",NC,2015,4543,4284,259,5.7,54
"Jones County, NC",NC,2014,4489,4199,290,6.5,-58
"Jones County, NC",NC,2013,4547,4174,373,8.2,-82
"Jones County, NC",NC,2012,4629,4159,470,10.2,22
"Jones County, NC",NC,2011,4607,4118,489,10.6,-8
"Jones County, NC",NC,2010,4615,4103,512,11.1,0
"Jones County, SD",SD,2021,522,504,18,3.4,3
"Jones County, SD",SD,2020,519,501,18,3.5,-17
"Jones County, SD",SD,2019,536,522,14,2.6,-15
"Jones County, SD",SD,2018,551,538,13,2.4,-9
"Jones County, SD",SD,2017,560,545,15,2.7,-12
"Jones County, SD",SD,2016,572,558,14,2.4,-16
"Jones County, SD",SD,2015,588,571,17,2.9,-24
"Jones County, SD",SD,2014,612,590,22,3.6,-12
"Jones County, SD",SD,2013,624,602,22,3.5,-9
"Jones County, SD",SD,2012,633,610,23,3.6,-45
"Jones County, SD",SD,2011,678,657,21,3.1,-3
"Jones County, SD",SD,2010,681,661,20,2.9,0
"Jones County, TX",TX,2021,5730,5377,353,6.2,145
"Jones County, TX",TX,2020,5585,5190,395,7.1,-132
"Jones County, TX",TX,2019,5717,5474,243,4.3,150
"Jones County, TX",TX,2018,5567,5298,269,4.8,-41
"Jones County, TX",TX,2017,5608,5307,301,5.4,-19
"Jones County, TX",TX,2016,5627,5300,327,5.8,-44
"Jones County, TX",TX,2015,5671,5357,314,5.5,-126
"Jones County, TX",TX,2014,5797,5474,323,5.6,-41
"Jones County, TX",TX,2013,5838,5442,396,6.8,-53
"Jones County, TX",TX,2012,5891,5469,422,7.2,-246
"Jones County, TX",TX,2011,6137,5613,524,8.5,-32
"Jones County, TX",TX,2010,6169,5626,543,8.8,0
"Josephine County, OR",OR,2021,36990,34710,2280,6.2,873
"Josephine County, OR",OR,2020,36117,33262,2855,7.9,445
"Josephine County, OR",OR,2019,35672,33926,1746,4.9,337
"Josephine County, OR",OR,2018,35335,33435,1900,5.4,392
"Josephine County, OR",OR,2017,34943,33100,1843,5.3,748
"Josephine County, OR",OR,2016,34195,32019,2176,6.4,920
"Josephine County, OR",OR,2015,33275,30766,2509,7.5,322
"Josephine County, OR",OR,2014,32953,29919,3034,9.2,530
"Josephine County, OR",OR,2013,32423,28878,3545,10.9,-1122
"Josephine County, OR",OR,2012,33545,29471,4074,12.1,-992
"Josephine County, OR",OR,2011,34537,30132,4405,12.8,-96
"Josephine County, OR",OR,2010,34633,29735,4898,14.1,0
"Juab County, UT",UT,2021,6159,6036,123,2.0,312
"Juab County, UT",UT,2020,5847,5671,176,3.0,-11
"Juab County, UT",UT,2019,5858,5713,145,2.5,244
"Juab County, UT",UT,2018,5614,5455,159,2.8,168
"Juab County, UT",UT,2017,5446,5268,178,3.3,246
"Juab County, UT",UT,2016,5200,5016,184,3.5,288
"Juab County, UT",UT,2015,4912,4721,191,3.9,156
"Juab County, UT",UT,2014,4756,4571,185,3.9,127
"Juab County, UT",UT,2013,4629,4415,214,4.6,92
"Juab County, UT",UT,2012,4537,4293,244,5.4,-31
"Juab County, UT",UT,2011,4568,4177,391,8.6,-24
"Juab County, UT",UT,2010,4592,4167,425,9.3,0
"Juana Diaz Municipio, PR",PR,2021,16686,15444,1242,7.4,
"Juana Diaz Municipio, PR",PR,2020,N.A.,N.A.,N.A.,N.A.,
"Juana Diaz Municipio, PR",PR,2019,15147,13643,1504,9.9,324
"Juana Diaz Municipio, PR",PR,2018,14823,13270,1553,10.5,-206
"Juana Diaz Municipio, PR",PR,2017,15029,13090,1939,12.9,-568
"Juana Diaz Municipio, PR",PR,2016,15597,13338,2259,14.5,-161
"Juana Diaz Municipio, PR",PR,2015,15758,13369,2389,15.2,19
"Juana Diaz Municipio, PR",PR,2014,15739,13175,2564,16.3,-339
"Juana Diaz Municipio, PR",PR,2013,16078,13566,2512,15.6,-360
"Juana Diaz Municipio, PR",PR,2012,16438,13747,2691,16.4,-347
"Juana Diaz Municipio, PR",PR,2011,16785,13807,2978,17.7,-414
"Juana Diaz Municipio, PR",PR,2010,17199,14100,3099,18.0,0
"Judith Basin County, MT",MT,2021,951,925,26,2.7,-33
"Judith Basin County, MT",MT,2020,984,938,46,4.7,-9
"Judith Basin County, MT",MT,2019,993,962,31,3.1,73
"Judith Basin County, MT",MT,2018,920,889,31,3.4,-9
"Judith Basin County, MT",MT,2017,929,894,35,3.8,-3
"Judith Basin County, MT",MT,2016,932,899,33,3.5,-62
"Judith Basin County, MT",MT,2015,994,959,35,3.5,27
"Judith Basin County, MT",MT,2014,967,926,41,4.2,-11
"Judith Basin County, MT",MT,2013,978,931,47,4.8,-13
"Judith Basin County, MT",MT,2012,991,941,50,5.0,23
"Judith Basin County, MT",MT,2011,968,911,57,5.9,-42
"Judith Basin County, MT",MT,2010,1010,946,64,6.3,0
"Juncos Municipio, PR",PR,2021,13318,12218,1100,8.3,
"Juncos Municipio, PR",PR,2020,N.A.,N.A.,N.A.,N.A.,
"Juncos Municipio, PR",PR,2019,12367,11338,1029,8.3,183
"Juncos Municipio, PR",PR,2018,12184,11028,1156,9.5,-137
"Juncos Municipio, PR",PR,2017,12321,10898,1423,11.5,-141
"Juncos Municipio, PR",PR,2016,12462,10817,1645,13.2,-16
"Juncos Municipio, PR",PR,2015,12478,10743,1735,13.9,16
"Juncos Municipio, PR",PR,2014,12462,10543,1919,15.4,-241
"Juncos Municipio, PR",PR,2013,12703,10729,1974,15.5,-185
"Juncos Municipio, PR",PR,2012,12888,10785,2103,16.3,-167
"Juncos Municipio, PR",PR,2011,13055,10653,2402,18.4,-335
"Juncos Municipio, PR",PR,2010,13390,10882,2508,18.7,0
"Juneau Borough/city, AK",AK,2021,16734,15940,794,4.7,428
"Juneau Borough/city, AK",AK,2020,16306,15168,1138,7.0,-943
"Juneau Borough/city, AK",AK,2019,17249,16565,684,4.0,41
"Juneau Borough/city, AK",AK,2018,17208,16520,688,4.0,-84
"Juneau Borough/city, AK",AK,2017,17292,16547,745,4.3,-51
"Juneau Borough/city, AK",AK,2016,17343,16599,744,4.3,283
"Juneau Borough/city, AK",AK,2015,17060,16283,777,4.6,-352
"Juneau Borough/city, AK",AK,2014,17412,16548,864,5.0,-92
"Juneau Borough/city, AK",AK,2013,17504,16619,885,5.1,-327
"Juneau Borough/city, AK",AK,2012,17831,16909,922,5.2,-2
"Juneau Borough/city, AK",AK,2011,17833,16821,1012,5.7,-47
"Juneau Borough/city, AK",AK,2010,17880,16787,1093,6.1,0
"Juneau County, WI",WI,2021,13532,12951,581,4.3,73
"Juneau County, WI",WI,2020,13459,12485,974,7.2,-55
"Juneau County, WI",WI,2019,13514,13088,426,3.2,-38
"Juneau County, WI",WI,2018,13552,13142,410,3.0,-79
"Juneau County, WI",WI,2017,13631,13181,450,3.3,133
"Juneau County, WI",WI,2016,13498,12916,582,4.3,23
"Juneau County, WI",WI,2015,13475,12799,676,5.0,109
"Juneau County, WI",WI,2014,13366,12515,851,6.4,-108
"Juneau County, WI",WI,2013,13474,12387,1087,8.1,-90
"Juneau County, WI",WI,2012,13564,12444,1120,8.3,-107
"Juneau County, WI",WI,2011,13671,12446,1225,9.0,-26
"Juneau County, WI",WI,2010,13697,12359,1338,9.8,0
"Juniata County, PA",PA,2021,12501,11877,624,5.0,-244
"Juniata County, PA",PA,2020,12745,11830,915,7.2,0
"Juniata County, PA",PA,2019,12745,12166,579,4.5,152
"Juniata County, PA",PA,2018,12593,12066,527,4.2,102
"Juniata County, PA",PA,2017,12491,11909,582,4.7,274
"Juniata County, PA",PA,2016,12217,11570,647,5.3,223
"Juniata County, PA",PA,2015,11994,11389,605,5.0,151
"Juniata County, PA",PA,2014,11843,11166,677,5.7,-148
"Juniata County, PA",PA,2013,11991,11164,827,6.9,-33
"Juniata County, PA",PA,2012,12024,11170,854,7.1,37
"Juniata County, PA",PA,2011,11987,11122,865,7.2,-63
"Juniata County, PA",PA,2010,12050,11121,929,7.7,0
"Kalamazoo County, MI",MI,2021,128630,122189,6441,5.0,-3055
"Kalamazoo County, MI",MI,2020,131685,121713,9972,7.6,-2435
"Kalamazoo County, MI",MI,2019,134120,129625,4495,3.4,293
"Kalamazoo County, MI",MI,2018,133827,129212,4615,3.4,995
"Kalamazoo County, MI",MI,2017,132832,127572,5260,4.0,467
"Kalamazoo County, MI",MI,2016,132365,126947,5418,4.1,2609
"Kalamazoo County, MI",MI,2015,129756,124041,5715,4.4,1394
"Kalamazoo County, MI",MI,2014,128362,121148,7214,5.6,2948
"Kalamazoo County, MI",MI,2013,125414,116902,8512,6.8,310
"Kalamazoo County, MI",MI,2012,125104,116156,8948,7.2,-897
"Kalamazoo County, MI",MI,2011,126001,115812,10189,8.1,-2518
"Kalamazoo County, MI",MI,2010,128519,116004,12515,9.7,0
"Kalkaska County, MI",MI,2021,7632,7078,554,7.3,-233
"Kalkaska County, MI",MI,2020,7865,6955,910,11.6,-118
"Kalkaska County, MI",MI,2019,7983,7525,458,5.7,142
"Kalkaska County, MI",MI,2018,7841,7376,465,5.9,-42
"Kalkaska County, MI",MI,2017,7883,7345,538,6.8,140
"Kalkaska County, MI",MI,2016,7743,7182,561,7.2,77
"Kalkaska County, MI",MI,2015,7666,7070,596,7.8,-66
"Kalkaska County, MI",MI,2014,7732,7001,731,9.5,146
"Kalkaska County, MI",MI,2013,7586,6746,840,11.1,130
"Kalkaska County, MI",MI,2012,7456,6622,834,11.2,-112
"Kalkaska County, MI",MI,2011,7568,6621,947,12.5,-265
"Kalkaska County, MI",MI,2010,7833,6643,1190,15.2,0
"Kanabec County, MN",MN,2021,8885,8415,470,5.3,-293
"Kanabec County, MN",MN,2020,9178,8412,766,8.3,-7
"Kanabec County, MN",MN,2019,9185,8613,572,6.2,189
"Kanabec County, MN",MN,2018,8996,8471,525,5.8,-81
"Kanabec County, MN",MN,2017,9077,8519,558,6.1,90
"Kanabec County, MN",MN,2016,8987,8402,585,6.5,126
"Kanabec County, MN",MN,2015,8861,8266,595,6.7,-16
"Kanabec County, MN",MN,2014,8877,8202,675,7.6,70
"Kanabec County, MN",MN,2013,8807,8079,728,8.3,63
"Kanabec County, MN",MN,2012,8744,7952,792,9.1,14
"Kanabec County, MN",MN,2011,8730,7849,881,10.1,-63
"Kanabec County, MN",MN,2010,8793,7804,989,11.2,0
"Kanawha County, WV",WV,2021,81818,77575,4243,5.2,-447
"Kanawha County, WV",WV,2020,82265,75166,7099,8.6,-342
"Kanawha County, WV",WV,2019,82607,78800,3807,4.6,-640
"Kanawha County, WV",WV,2018,83247,79012,4235,5.1,-335
"Kanawha County, WV",WV,2017,83582,79331,4251,5.1,-1993
"Kanawha County, WV",WV,2016,85575,80899,4676,5.5,-1675
"Kanawha County, WV",WV,2015,87250,82145,5105,5.9,-2267
"Kanawha County, WV",WV,2014,89517,84347,5170,5.8,4
"Kanawha County, WV",WV,2013,89513,84281,5232,5.8,-1870
"Kanawha County, WV",WV,2012,91383,85560,5823,6.4,-265
"Kanawha County, WV",WV,2011,91648,85319,6329,6.9,-828
"Kanawha County, WV",WV,2010,92476,85647,6829,7.4,0
"Kandiyohi County, MN",MN,2021,22957,22142,815,3.6,-1822
"Kandiyohi County, MN",MN,2020,24779,23547,1232,5.0,199
"Kandiyohi County, MN",MN,2019,24580,23661,919,3.7,-262
"Kandiyohi County, MN",MN,2018,24842,24060,782,3.1,-104
"Kandiyohi County, MN",MN,2017,24946,24126,820,3.3,771
"Kandiyohi County, MN",MN,2016,24175,23256,919,3.8,57
"Kandiyohi County, MN",MN,2015,24118,23198,920,3.8,391
"Kandiyohi County, MN",MN,2014,23727,22697,1030,4.3,232
"Kandiyohi County, MN",MN,2013,23495,22362,1133,4.8,-25
"Kandiyohi County, MN",MN,2012,23520,22283,1237,5.3,-174
"Kandiyohi County, MN",MN,2011,23694,22270,1424,6.0,106
"Kandiyohi County, MN",MN,2010,23588,22009,1579,6.7,0
"Kane County, IL",IL,2021,259900,244555,15345,5.9,-1249
"Kane County, IL",IL,2020,261149,236858,24291,9.3,-11732
"Kane County, IL",IL,2019,272881,261268,11613,4.3,-1642
"Kane County, IL",IL,2018,274523,261185,13338,4.9,4659
"Kane County, IL",IL,2017,269864,256822,13042,4.8,-1458
"Kane County, IL",IL,2016,271322,256305,15017,5.5,2680
"Kane County, IL",IL,2015,268642,253171,15471,5.8,2947
"Kane County, IL",IL,2014,265695,247318,18377,6.9,443
"Kane County, IL",IL,2013,265252,242313,22939,8.6,-1660
"Kane County, IL",IL,2012,266912,243009,23903,9.0,-793
"Kane County, IL",IL,2011,267705,241479,26226,9.8,797
"Kane County, IL",IL,2010,266908,237132,29776,11.2,0
"Kane County, UT",UT,2021,4002,3887,115,2.9,126
"Kane County, UT",UT,2020,3876,3669,207,5.3,26
"Kane County, UT",UT,2019,3850,3740,110,2.9,31
"Kane County, UT",UT,2018,3819,3703,116,3.0,58
"Kane County, UT",UT,2017,3761,3636,125,3.3,82
"Kane County, UT",UT,2016,3679,3543,136,3.7,73
"Kane County, UT",UT,2015,3606,3450,156,4.3,73
"Kane County, UT",UT,2014,3533,3372,161,4.6,110
"Kane County, UT",UT,2013,3423,3255,168,4.9,28
"Kane County, UT",UT,2012,3395,3196,199,5.9,-74
"Kane County, UT",UT,2011,3469,3199,270,7.8,-76
"Kane County, UT",UT,2010,3545,3259,286,8.1,0
"Kankakee County, IL",IL,2021,52515,49100,3415,6.5,-1348
"Kankakee County, IL",IL,2020,53863,49036,4827,9.0,-2074
"Kankakee County, IL",IL,2019,55937,53259,2678,4.8,281
"Kankakee County, IL",IL,2018,55656,52619,3037,5.5,766
"Kankakee County, IL",IL,2017,54890,51879,3011,5.5,-45
"Kankakee County, IL",IL,2016,54935,51381,3554,6.5,593
"Kankakee County, IL",IL,2015,54342,50609,3733,6.9,-510
"Kankakee County, IL",IL,2014,54852,50378,4474,8.2,-266
"Kankakee County, IL",IL,2013,55118,49328,5790,10.5,-260
"Kankakee County, IL",IL,2012,55378,49470,5908,10.7,-468
"Kankakee County, IL",IL,2011,55846,49322,6524,11.7,-497
"Kankakee County, IL",IL,2010,56343,49205,7138,12.7,0
"Karnes County, TX",TX,2021,6843,6487,356,5.2,-101
"Karnes County, TX",TX,2020,6944,6508,436,6.3,-128
"Karnes County, TX",TX,2019,7072,6894,178,2.5,277
"Karnes County, TX",TX,2018,6795,6600,195,2.9,397
"Karnes County, TX",TX,2017,6398,6174,224,3.5,119
"Karnes County, TX",TX,2016,6279,5972,307,4.9,-150
"Karnes County, TX",TX,2015,6429,6155,274,4.3,164
"Karnes County, TX",TX,2014,6265,6033,232,3.7,653
"Karnes County, TX",TX,2013,5612,5309,303,5.4,337
"Karnes County, TX",TX,2012,5275,4956,319,6.0,388
"Karnes County, TX",TX,2011,4887,4494,393,8.0,9
"Karnes County, TX",TX,2010,4878,4431,447,9.2,0
"Kauai County, HI",HI,2021,35949,33153,2796,7.8,-381
"Kauai County, HI",HI,2020,36330,30307,6023,16.6,-1352
"Kauai County, HI",HI,2019,37682,36770,912,2.4,174
"Kauai County, HI",HI,2018,37508,36616,892,2.4,-323
"Kauai County, HI",HI,2017,37831,37008,823,2.2,1244
"Kauai County, HI",HI,2016,36587,35468,1119,3.1,751
"Kauai County, HI",HI,2015,35836,34485,1351,3.8,493
"Kauai County, HI",HI,2014,35343,33718,1625,4.6,668
"Kauai County, HI",HI,2013,34675,32813,1862,5.4,-52
"Kauai County, HI",HI,2012,34727,32275,2452,7.1,-861
"Kauai County, HI",HI,2011,35588,32535,3053,8.6,618
"Kauai County, HI",HI,2010,34970,31983,2987,8.5,0
"Kaufman County, TX",TX,2021,71942,68423,3519,4.9,3083
"Kaufman County, TX",TX,2020,68859,64465,4394,6.4,2301
"Kaufman County, TX",TX,2019,66558,64407,2151,3.2,4028
"Kaufman County, TX",TX,2018,62530,60348,2182,3.5,2649
"Kaufman County, TX",TX,2017,59881,57740,2141,3.6,1941
"Kaufman County, TX",TX,2016,57940,55742,2198,3.8,2856
"Kaufman County, TX",TX,2015,55084,52824,2260,4.1,1552
"Kaufman County, TX",TX,2014,53532,50740,2792,5.2,1187
"Kaufman County, TX",TX,2013,52345,48995,3350,6.4,848
"Kaufman County, TX",TX,2012,51497,47941,3556,6.9,-11
"Kaufman County, TX",TX,2011,51508,47242,4266,8.3,631
"Kaufman County, TX",TX,2010,50877,46540,4337,8.5,0
"Kay County, OK",OK,2021,18421,17622,799,4.3,176
"Kay County, OK",OK,2020,18245,17017,1228,6.7,29
"Kay County, OK",OK,2019,18216,17480,736,4.0,-626
"Kay County, OK",OK,2018,18842,17999,843,4.5,-288
"Kay County, OK",OK,2017,19130,18151,979,5.1,217
"Kay County, OK",OK,2016,18913,17761,1152,6.1,-262
"Kay County, OK",OK,2015,19175,18113,1062,5.5,-88
"Kay County, OK",OK,2014,19263,18201,1062,5.5,-685
"Kay County, OK",OK,2013,19948,18611,1337,6.7,-254
"Kay County, OK",OK,2012,20202,18811,1391,6.9,-357
"Kay County, OK",OK,2011,20559,19040,1519,7.4,-328
"Kay County, OK",OK,2010,20887,19034,1853,8.9,0
"Kearney County, NE",NE,2021,3843,3775,68,1.8,1
"Kearney County, NE",NE,2020,3842,3721,121,3.1,10
"Kearney County, NE",NE,2019,3832,3746,86,2.2,37
"Kearney County, NE",NE,2018,3795,3715,80,2.1,4
"Kearney County, NE",NE,2017,3791,3706,85,2.2,30
"Kearney County, NE",NE,2016,3761,3673,88,2.3,-46
"Kearney County, NE",NE,2015,3807,3723,84,2.2,-44
"Kearney County, NE",NE,2014,3851,3757,94,2.4,-42
"Kearney County, NE",NE,2013,3893,3786,107,2.7,-34
"Kearney County, NE",NE,2012,3927,3817,110,2.8,21
"Kearney County, NE",NE,2011,3906,3779,127,3.3,116
"Kearney County, NE",NE,2010,3790,3655,135,3.6,0
"Kearny County, KS",KS,2021,2048,2015,33,1.6,23
"Kearny County, KS",KS,2020,2025,1975,50,2.5,-20
"Kearny County, KS",KS,2019,2045,1998,47,2.3,-48
"Kearny County, KS",KS,2018,2093,2046,47,2.2,22
"Kearny County, KS",KS,2017,2071,2020,51,2.5,4
"Kearny County, KS",KS,2016,2067,2002,65,3.1,-87
"Kearny County, KS",KS,2015,2154,2086,68,3.2,33
"Kearny County, KS",KS,2014,2121,2056,65,3.1,18
"Kearny County, KS",KS,2013,2103,2027,76,3.6,-75
"Kearny County, KS",KS,2012,2178,2092,86,3.9,-12
"Kearny County, KS",KS,2011,2190,2095,95,4.3,35
"Kearny County, KS",KS,2010,2155,2060,95,4.4,0
"Keith County, NE",NE,2021,4685,4590,95,2.0,18
"Keith County, NE",NE,2020,4667,4521,146,3.1,3
"Keith County, NE",NE,2019,4664,4513,151,3.2,70
"Keith County, NE",NE,2018,4594,4453,141,3.1,-39
"Keith County, NE",NE,2017,4633,4491,142,3.1,-10
"Keith County, NE",NE,2016,4643,4509,134,2.9,-59
"Keith County, NE",NE,2015,4702,4577,125,2.7,34
"Keith County, NE",NE,2014,4668,4535,133,2.8,-29
"Keith County, NE",NE,2013,4697,4532,165,3.5,42
"Keith County, NE",NE,2012,4655,4487,168,3.6,-1
"Keith County, NE",NE,2011,4656,4466,190,4.1,78
"Keith County, NE",NE,2010,4578,4380,198,4.3,0
"Kemper County, MS",MS,2021,3282,3038,244,7.4,-29
"Kemper County, MS",MS,2020,3311,3000,311,9.4,-170
"Kemper County, MS",MS,2019,3481,3208,273,7.8,-84
"Kemper County, MS",MS,2018,3565,3293,272,7.6,-23
"Kemper County, MS",MS,2017,3588,3302,286,8.0,48
"Kemper County, MS",MS,2016,3540,3225,315,8.9,-28
"Kemper County, MS",MS,2015,3568,3194,374,10.5,-173
"Kemper County, MS",MS,2014,3741,3259,482,12.9,-216
"Kemper County, MS",MS,2013,3957,3450,507,12.8,-54
"Kemper County, MS",MS,2012,4011,3494,517,12.9,89
"Kemper County, MS",MS,2011,3922,3374,548,14.0,13
"Kemper County, MS",MS,2010,3909,3348,561,14.4,0
"Kenai Peninsula Borough, AK",AK,2021,27945,25911,2034,7.3,1320
"Kenai Peninsula Borough, AK",AK,2020,26625,24098,2527,9.5,142
"Kenai Peninsula Borough, AK",AK,2019,26483,24857,1626,6.1,-74
"Kenai Peninsula Borough, AK",AK,2018,26557,24703,1854,7.0,-266
"Kenai Peninsula Borough, AK",AK,2017,26823,24745,2078,7.7,-300
"Kenai Peninsula Borough, AK",AK,2016,27123,24906,2217,8.2,-434
"Kenai Peninsula Borough, AK",AK,2015,27557,25470,2087,7.6,-310
"Kenai Peninsula Borough, AK",AK,2014,27867,25712,2155,7.7,168
"Kenai Peninsula Borough, AK",AK,2013,27699,25463,2236,8.1,429
"Kenai Peninsula Borough, AK",AK,2012,27270,24881,2389,8.8,86
"Kenai Peninsula Borough, AK",AK,2011,27184,24538,2646,9.7,175
"Kenai Peninsula Borough, AK",AK,2010,27009,24220,2789,10.3,0
"Kendall County, IL",IL,2021,69542,66284,3258,4.7,-682
"Kendall County, IL",IL,2020,70224,64661,5563,7.9,-1777
"Kendall County, IL",IL,2019,72001,69530,2471,3.4,1440
"Kendall County, IL",IL,2018,70561,68014,2547,3.6,1045
"Kendall County, IL",IL,2017,69516,66478,3038,4.4,1554
"Kendall County, IL",IL,2016,67962,64414,3548,5.2,1715
"Kendall County, IL",IL,2015,66247,62762,3485,5.3,977
"Kendall County, IL",IL,2014,65270,61014,4256,6.5,679
"Kendall County, IL",IL,2013,64591,59137,5454,8.4,860
"Kendall County, IL",IL,2012,63731,58382,5349,8.4,1457
"Kendall County, IL",IL,2011,62274,56414,5860,9.4,-35
"Kendall County, IL",IL,2010,62309,55943,6366,10.2,0
"Kendall County, TX",TX,2021,22781,21908,873,3.8,765
"Kendall County, TX",TX,2020,22016,20900,1116,5.1,-374
"Kendall County, TX",TX,2019,22390,21781,609,2.7,744
"Kendall County, TX",TX,2018,21646,21011,635,2.9,711
"Kendall County, TX",TX,2017,20935,20286,649,3.1,582
"Kendall County, TX",TX,2016,20353,19702,651,3.2,1186
"Kendall County, TX",TX,2015,19167,18533,634,3.3,516
"Kendall County, TX",TX,2014,18651,17886,765,4.1,444
"Kendall County, TX",TX,2013,18207,17277,930,5.1,772
"Kendall County, TX",TX,2012,17435,16498,937,5.4,530
"Kendall County, TX",TX,2011,16905,15845,1060,6.3,472
"Kendall County, TX",TX,2010,16433,15406,1027,6.2,0
"Kenedy County, TX",TX,2021,183,172,11,6.0,4
"Kenedy County, TX",TX,2020,179,169,10,5.6,-49
"Kenedy County, TX",TX,2019,228,220,8,3.5,-16
"Kenedy County, TX",TX,2018,244,235,9,3.7,4
"Kenedy County, TX",TX,2017,240,232,8,3.3,23
"Kenedy County, TX",TX,2016,217,207,10,4.6,-65
"Kenedy County, TX",TX,2015,282,273,9,3.2,-56
"Kenedy County, TX",TX,2014,338,328,10,3.0,42
"Kenedy County, TX",TX,2013,296,284,12,4.1,43
"Kenedy County, TX",TX,2012,253,240,13,5.1,14
"Kenedy County, TX",TX,2011,239,223,16,6.7,19
"Kenedy County, TX",TX,2010,220,205,15,6.8,0
"Kennebec County, ME",ME,2021,61360,58722,2638,4.3,6
"Kennebec County, ME",ME,2020,61354,58547,2807,4.6,-1404
"Kennebec County, ME",ME,2019,62758,61082,1676,2.7,-93
"Kennebec County, ME",ME,2018,62851,60969,1882,3.0,-373
"Kennebec County, ME",ME,2017,63224,61129,2095,3.3,765
"Kennebec County, ME",ME,2016,62459,60193,2266,3.6,424
"Kennebec County, ME",ME,2015,62035,59397,2638,4.3,-1429
"Kennebec County, ME",ME,2014,63464,60073,3391,5.3,-297
"Kennebec County, ME",ME,2013,63761,59751,4010,6.3,759
"Kennebec County, ME",ME,2012,63002,58655,4347,6.9,-257
"Kennebec County, ME",ME,2011,63259,58620,4639,7.3,109
"Kennebec County, ME",ME,2010,63150,58167,4983,7.9,0
"Kenosha County, WI",WI,2021,91211,87289,3922,4.3,1196
"Kenosha County, WI",WI,2020,90015,83601,6414,7.1,-395
"Kenosha County, WI",WI,2019,90410,87016,3394,3.8,616
"Kenosha County, WI",WI,2018,89794,86650,3144,3.5,108
"Kenosha County, WI",WI,2017,89686,86235,3451,3.8,1605
"Kenosha County, WI",WI,2016,88081,84061,4020,4.6,957
"Kenosha County, WI",WI,2015,87124,82773,4351,5.0,458
"Kenosha County, WI",WI,2014,86666,81481,5185,6.0,-243
"Kenosha County, WI",WI,2013,86909,80302,6607,7.6,196
"Kenosha County, WI",WI,2012,86713,79739,6974,8.0,755
"Kenosha County, WI",WI,2011,85958,78378,7580,8.8,243
"Kenosha County, WI",WI,2010,85715,77060,8655,10.1,0
"Kent County, DE",DE,2021,81389,76320,5069,6.2,1563
"Kent County, DE",DE,2020,79826,73170,6656,8.3,1217
"Kent County, DE",DE,2019,78609,75360,3249,4.1,807
"Kent County, DE",DE,2018,77802,74578,3224,4.1,525
"Kent County, DE",DE,2017,77277,73509,3768,4.9,578
"Kent County, DE",DE,2016,76699,72935,3764,4.9,900
"Kent County, DE",DE,2015,75799,71772,4027,5.3,697
"Kent County, DE",DE,2014,75102,70391,4711,6.3,1147
"Kent County, DE",DE,2013,73955,68587,5368,7.3,-391
"Kent County, DE",DE,2012,74346,68567,5779,7.8,150
"Kent County, DE",DE,2011,74196,68023,6173,8.3,1170
"Kent County, DE",DE,2010,73026,66336,6690,9.2,0
"Kent County, MD",MD,2021,9609,9085,524,5.5,-227
"Kent County, MD",MD,2020,9836,9186,650,6.6,-612
"Kent County, MD",MD,2019,10448,10049,399,3.8,-29
"Kent County, MD",MD,2018,10477,10057,420,4.0,113
"Kent County, MD",MD,2017,10364,9922,442,4.3,134
"Kent County, MD",MD,2016,10230,9750,480,4.7,-338
"Kent County, MD",MD,2015,10568,10015,553,5.2,224
"Kent County, MD",MD,2014,10344,9688,656,6.3,-2
"Kent County, MD",MD,2013,10346,9609,737,7.1,-288
"Kent County, MD",MD,2012,10634,9833,801,7.5,-141
"Kent County, MD",MD,2011,10775,9895,880,8.2,122
"Kent County, MD",MD,2010,10653,9688,965,9.1,0
"Kent County, MI",MI,2021,349167,332738,16429,4.7,-6559
"Kent County, MI",MI,2020,355726,327484,28242,7.9,-5979
"Kent County, MI",MI,2019,361705,351070,10635,2.9,1492
"Kent County, MI",MI,2018,360213,349395,10818,3.0,4528
"Kent County, MI",MI,2017,355685,343580,12105,3.4,4428
"Kent County, MI",MI,2016,351257,338786,12471,3.6,7185
"Kent County, MI",MI,2015,344072,330959,13113,3.8,7124
"Kent County, MI",MI,2014,336948,320264,16684,5.0,8964
"Kent County, MI",MI,2013,327984,307705,20279,6.2,6942
"Kent County, MI",MI,2012,321042,299448,21594,6.7,6340
"Kent County, MI",MI,2011,314702,289956,24746,7.9,1163
"Kent County, MI",MI,2010,313539,282588,30951,9.9,0
"Kent County, RI",RI,2021,93708,88828,4880,5.2,894
"Kent County, RI",RI,2020,92814,84857,7957,8.6,-704
"Kent County, RI",RI,2019,93518,90524,2994,3.2,306
"Kent County, RI",RI,2018,93212,89785,3427,3.7,736
"Kent County, RI",RI,2017,92476,88649,3827,4.1,1757
"Kent County, RI",RI,2016,90719,86415,4304,4.7,-431
"Kent County, RI",RI,2015,91150,86087,5063,5.6,-427
"Kent County, RI",RI,2014,91577,84952,6625,7.2,-569
"Kent County, RI",RI,2013,92146,83894,8252,9.0,-351
"Kent County, RI",RI,2012,92497,83445,9052,9.8,-560
"Kent County, RI",RI,2011,93057,83176,9881,10.6,-1992
"Kent County, RI",RI,2010,95049,84080,10969,11.5,0
"Kent County, TX",TX,2021,447,434,13,2.9,-12
"Kent County, TX",TX,2020,459,441,18,3.9,-8
"Kent County, TX",TX,2019,467,456,11,2.4,20
"Kent County, TX",TX,2018,447,436,11,2.5,-3
"Kent County, TX",TX,2017,450,438,12,2.7,-20
"Kent County, TX",TX,2016,470,456,14,3.0,-27
"Kent County, TX",TX,2015,497,484,13,2.6,-15
"Kent County, TX",TX,2014,512,494,18,3.5,-18
"Kent County, TX",TX,2013,530,509,21,4.0,-20
"Kent County, TX",TX,2012,550,529,21,3.8,-4
"Kent County, TX",TX,2011,554,527,27,4.9,-5
"Kent County, TX",TX,2010,559,532,27,4.8,0
"Kenton County, KY",KY,2021,87115,83479,3636,4.2,1137
"Kenton County, KY",KY,2020,85978,81166,4812,5.6,-2768
"Kenton County, KY",KY,2019,88746,85773,2973,3.4,1428
"Kenton County, KY",KY,2018,87318,84399,2919,3.3,697
"Kenton County, KY",KY,2017,86621,83259,3362,3.9,1881
"Kenton County, KY",KY,2016,84740,81306,3434,4.1,1478
"Kenton County, KY",KY,2015,83262,79629,3633,4.4,102
"Kenton County, KY",KY,2014,83160,78569,4591,5.5,-1936
"Kenton County, KY",KY,2013,85096,79184,5912,6.9,677
"Kenton County, KY",KY,2012,84419,78148,6271,7.4,428
"Kenton County, KY",KY,2011,83991,76588,7403,8.8,-243
"Kenton County, KY",KY,2010,84234,75923,8311,9.9,0
"Keokuk County, IA",IA,2021,5181,4953,228,4.4,-2
"Keokuk County, IA",IA,2020,5183,4933,250,4.8,-166
"Keokuk County, IA",IA,2019,5349,5184,165,3.1,126
"Keokuk County, IA",IA,2018,5223,5073,150,2.9,-20
"Keokuk County, IA",IA,2017,5243,5059,184,3.5,-106
"Keokuk County, IA",IA,2016,5349,5121,228,4.3,-75
"Keokuk County, IA",IA,2015,5424,5195,229,4.2,-92
"Keokuk County, IA",IA,2014,5516,5273,243,4.4,32
"Keokuk County, IA",IA,2013,5484,5206,278,5.1,38
"Keokuk County, IA",IA,2012,5446,5146,300,5.5,-50
"Keokuk County, IA",IA,2011,5496,5154,342,6.2,-38
"Keokuk County, IA",IA,2010,5534,5166,368,6.6,0
"Kern County, CA",CA,2021,383987,345432,38555,10.0,-1873
"Kern County, CA",CA,2020,385860,335929,49931,12.9,-2956
"Kern County, CA",CA,2019,388816,358105,30711,7.9,3027
"Kern County, CA",CA,2018,385789,354428,31361,8.1,1716
"Kern County, CA",CA,2017,384073,348493,35580,9.3,-4036
"Kern County, CA",CA,2016,388109,347692,40417,10.4,-2029
"Kern County, CA",CA,2015,390138,350050,40088,10.3,-1758
"Kern County, CA",CA,2014,391896,350628,41268,10.5,-309
"Kern County, CA",CA,2013,392205,345564,46641,11.9,936
"Kern County, CA",CA,2012,391269,338995,52274,13.4,9256
"Kern County, CA",CA,2011,382013,324431,57582,15.1,9784
"Kern County, CA",CA,2010,372229,312566,59663,16.0,0
"Kerr County, TX",TX,2021,22061,21071,990,4.5,526
"Kerr County, TX",TX,2020,21535,20277,1258,5.8,-445
"Kerr County, TX",TX,2019,21980,21331,649,3.0,391
"Kerr County, TX",TX,2018,21589,20886,703,3.3,413
"Kerr County, TX",TX,2017,21176,20448,728,3.4,-190
"Kerr County, TX",TX,2016,21366,20597,769,3.6,178
"Kerr County, TX",TX,2015,21188,20403,785,3.7,-211
"Kerr County, TX",TX,2014,21399,20448,951,4.4,-40
"Kerr County, TX",TX,2013,21439,20248,1191,5.6,-208
"Kerr County, TX",TX,2012,21647,20392,1255,5.8,-165
"Kerr County, TX",TX,2011,21812,20311,1501,6.9,-136
"Kerr County, TX",TX,2010,21948,20477,1471,6.7,0
"Kershaw County, SC",SC,2021,29168,28084,1084,3.7,338
"Kershaw County, SC",SC,2020,28830,27342,1488,5.2,69
"Kershaw County, SC",SC,2019,28761,27934,827,2.9,524
"Kershaw County, SC",SC,2018,28237,27249,988,3.5,-403
"Kershaw County, SC",SC,2017,28640,27375,1265,4.4,-517
"Kershaw County, SC",SC,2016,29157,27668,1489,5.1,233
"Kershaw County, SC",SC,2015,28924,27215,1709,5.9,500
"Kershaw County, SC",SC,2014,28424,26644,1780,6.3,403
"Kershaw County, SC",SC,2013,28021,25889,2132,7.6,-147
"Kershaw County, SC",SC,2012,28168,25542,2626,9.3,-145
"Kershaw County, SC",SC,2011,28313,25224,3089,10.9,-71
"Kershaw County, SC",SC,2010,28384,25072,3312,11.7,0
"Ketchikan Gateway Borough, AK",AK,2021,6604,6118,486,7.4,123
"Ketchikan Gateway Borough, AK",AK,2020,6481,5823,658,10.2,-523
"Ketchikan Gateway Borough, AK",AK,2019,7004,6614,390,5.6,-23
"Ketchikan Gateway Borough, AK",AK,2018,7027,6641,386,5.5,-67
"Ketchikan Gateway Borough, AK",AK,2017,7094,6686,408,5.8,75
"Ketchikan Gateway Borough, AK",AK,2016,7019,6581,438,6.2,75
"Ketchikan Gateway Borough, AK",AK,2015,6944,6482,462,6.7,-139
"Ketchikan Gateway Borough, AK",AK,2014,7083,6535,548,7.7,-49
"Ketchikan Gateway Borough, AK",AK,2013,7132,6572,560,7.9,-19
"Ketchikan Gateway Borough, AK",AK,2012,7151,6561,590,8.3,-4
"Ketchikan Gateway Borough, AK",AK,2011,7155,6523,632,8.8,33
"Ketchikan Gateway Borough, AK",AK,2010,7122,6477,645,9.1,0
"Kewaunee County, WI",WI,2021,10882,10572,310,2.8,138
"Kewaunee County, WI",WI,2020,10744,10247,497,4.6,-306
"Kewaunee County, WI",WI,2019,11050,10712,338,3.1,-189
"Kewaunee County, WI",WI,2018,11239,10918,321,2.9,17
"Kewaunee County, WI",WI,2017,11222,10878,344,3.1,217
"Kewaunee County, WI",WI,2016,11005,10611,394,3.6,138
"Kewaunee County, WI",WI,2015,10867,10433,434,4.0,40
"Kewaunee County, WI",WI,2014,10827,10289,538,5.0,-105
"Kewaunee County, WI",WI,2013,10932,10239,693,6.3,-73
"Kewaunee County, WI",WI,2012,11005,10296,709,6.4,-147
"Kewaunee County, WI",WI,2011,11152,10347,805,7.2,-31
"Kewaunee County, WI",WI,2010,11183,10285,898,8.0,0
"Keweenaw County, MI",MI,2021,883,824,59,6.7,-12
"Keweenaw County, MI",MI,2020,895,812,83,9.3,-7
"Keweenaw County, MI",MI,2019,902,840,62,6.9,20
"Keweenaw County, MI",MI,2018,882,820,62,7.0,-19
"Keweenaw County, MI",MI,2017,901,823,78,8.7,-43
"Keweenaw County, MI",MI,2016,944,862,82,8.7,0
"Keweenaw County, MI",MI,2015,944,856,88,9.3,-42
"Keweenaw County, MI",MI,2014,986,876,110,11.2,-3
"Keweenaw County, MI",MI,2013,989,856,133,13.4,1
"Keweenaw County, MI",MI,2012,988,863,125,12.7,-25
"Keweenaw County, MI",MI,2011,1013,879,134,13.2,10
"Keweenaw County, MI",MI,2010,1003,857,146,14.6,0
"Keya Paha County, NE",NE,2021,590,580,10,1.7,5
"Keya Paha County, NE",NE,2020,585,572,13,2.2,-8
"Keya Paha County, NE",NE,2019,593,578,15,2.5,-7
"Keya Paha County, NE",NE,2018,600,587,13,2.2,-12
"Keya Paha County, NE",NE,2017,612,597,15,2.5,-11
"Keya Paha County, NE",NE,2016,623,610,13,2.1,-40
"Keya Paha County, NE",NE,2015,663,649,14,2.1,43
"Keya Paha County, NE",NE,2014,620,603,17,2.7,11
"Keya Paha County, NE",NE,2013,609,589,20,3.3,4
"Keya Paha County, NE",NE,2012,605,587,18,3.0,3
"Keya Paha County, NE",NE,2011,602,584,18,3.0,34
"Keya Paha County, NE",NE,2010,568,547,21,3.7,0
"Kidder County, ND",ND,2021,1319,1251,68,5.2,18
"Kidder County, ND",ND,2020,1301,1235,66,5.1,15
"Kidder County, ND",ND,2019,1286,1240,46,3.6,-32
"Kidder County, ND",ND,2018,1318,1265,53,4.0,-62
"Kidder County, ND",ND,2017,1380,1331,49,3.6,7
"Kidder County, ND",ND,2016,1373,1321,52,3.8,41
"Kidder County, ND",ND,2015,1332,1283,49,3.7,68
"Kidder County, ND",ND,2014,1264,1216,48,3.8,23
"Kidder County, ND",ND,2013,1241,1183,58,4.7,-14
"Kidder County, ND",ND,2012,1255,1194,61,4.9,-96
"Kidder County, ND",ND,2011,1351,1283,68,5.0,-59
"Kidder County, ND",ND,2010,1410,1337,73,5.2,0
"Kimball County, NE",NE,2021,1960,1916,44,2.2,-26
"Kimball County, NE",NE,2020,1986,1917,69,3.5,-65
"Kimball County, NE",NE,2019,2051,1990,61,3.0,11
"Kimball County, NE",NE,2018,2040,1984,56,2.7,49
"Kimball County, NE",NE,2017,1991,1934,57,2.9,9
"Kimball County, NE",NE,2016,1982,1902,80,4.0,-77
"Kimball County, NE",NE,2015,2059,1986,73,3.5,-170
"Kimball County, NE",NE,2014,2229,2173,56,2.5,37
"Kimball County, NE",NE,2013,2192,2121,71,3.2,-26
"Kimball County, NE",NE,2012,2218,2147,71,3.2,37
"Kimball County, NE",NE,2011,2181,2102,79,3.6,61
"Kimball County, NE",NE,2010,2120,2019,101,4.8,0
"Kimble County, TX",TX,2021,1905,1826,79,4.1,87
"Kimble County, TX",TX,2020,1818,1727,91,5.0,-15
"Kimble County, TX",TX,2019,1833,1778,55,3.0,-23
"Kimble County, TX",TX,2018,1856,1800,56,3.0,-21
"Kimble County, TX",TX,2017,1877,1810,67,3.6,-76
"Kimble County, TX",TX,2016,1953,1879,74,3.8,-47
"Kimble County, TX",TX,2015,2000,1927,73,3.7,-110
"Kimble County, TX",TX,2014,2110,2027,83,3.9,-46
"Kimble County, TX",TX,2013,2156,2051,105,4.9,-28
"Kimble County, TX",TX,2012,2184,2078,106,4.9,-47
"Kimble County, TX",TX,2011,2231,2088,143,6.4,-48
"Kimble County, TX",TX,2010,2279,2142,137,6.0,0
"King and Queen County, VA",VA,2021,3812,3692,120,3.1,-66
"King and Queen County, VA",VA,2020,3878,3682,196,5.1,-39
"King and Queen County, VA",VA,2019,3917,3809,108,2.8,28
"King and Queen County, VA",VA,2018,3889,3772,117,3.0,54
"King and Queen County, VA",VA,2017,3835,3703,132,3.4,170
"King and Queen County, VA",VA,2016,3665,3515,150,4.1,20
"King and Queen County, VA",VA,2015,3645,3472,173,4.7,-11
"King and Queen County, VA",VA,2014,3656,3449,207,5.7,17
"King and Queen County, VA",VA,2013,3639,3422,217,6.0,-29
"King and Queen County, VA",VA,2012,3668,3430,238,6.5,11
"King and Queen County, VA",VA,2011,3657,3389,268,7.3,60
"King and Queen County, VA",VA,2010,3597,3301,296,8.2,0
"King County, TX",TX,2021,448,444,4,0.9,214
"King County, TX",TX,2020,234,230,4,1.7,1
"King County, TX",TX,2019,233,228,5,2.1,24
"King County, TX",TX,2018,209,203,6,2.9,45
"King County, TX",TX,2017,164,158,6,3.7,-14
"King County, TX",TX,2016,178,171,7,3.9,-22
"King County, TX",TX,2015,200,193,7,3.5,-24
"King County, TX",TX,2014,224,215,9,4.0,-14
"King County, TX",TX,2013,238,227,11,4.6,-9
"King County, TX",TX,2012,247,236,11,4.5,-41
"King County, TX",TX,2011,288,276,12,4.2,9
"King County, TX",TX,2010,279,267,12,4.3,0
"King County, WA",WA,2021,1278003,1223432,54571,4.3,-591
"King County, WA",WA,2020,1278594,1178362,100232,7.8,-7380
"King County, WA",WA,2019,1285974,1250766,35208,2.7,25319
"King County, WA",WA,2018,1260655,1218696,41959,3.3,29489
"King County, WA",WA,2017,1231166,1187422,43744,3.6,17993
"King County, WA",WA,2016,1213173,1166951,46222,3.8,28099
"King County, WA",WA,2015,1185074,1136052,49022,4.1,20251
"King County, WA",WA,2014,1164823,1112394,52429,4.5,27766
"King County, WA",WA,2013,1137057,1086876,50181,4.4,9368
"King County, WA",WA,2012,1127689,1056990,70699,6.3,21054
"King County, WA",WA,2011,1106635,1023172,83463,7.5,8899
"King County, WA",WA,2010,1097736,1005539,92197,8.4,0
"King George County, VA",VA,2021,13898,13496,402,2.9,16
"King George County, VA",VA,2020,13882,13263,619,4.5,247
"King George County, VA",VA,2019,13635,13275,360,2.6,308
"King George County, VA",VA,2018,13327,12937,390,2.9,268
"King George County, VA",VA,2017,13059,12575,484,3.7,723
"King George County, VA",VA,2016,12336,11817,519,4.2,235
"King George County, VA",VA,2015,12101,11533,568,4.7,-22
"King George County, VA",VA,2014,12123,11482,641,5.3,144
"King George County, VA",VA,2013,11979,11301,678,5.7,264
"King George County, VA",VA,2012,11715,10971,744,6.4,11
"King George County, VA",VA,2011,11704,10890,814,7.0,275
"King George County, VA",VA,2010,11429,10568,861,7.5,0
"King William County, VA",VA,2021,9114,8809,305,3.3,-183
"King William County, VA",VA,2020,9297,8804,493,5.3,-68
"King William County, VA",VA,2019,9365,9114,251,2.7,193
"King William County, VA",VA,2018,9172,8905,267,2.9,158
"King William County, VA",VA,2017,9014,8707,307,3.4,252
"King William County, VA",VA,2016,8762,8435,327,3.7,23
"King William County, VA",VA,2015,8739,8375,364,4.2,-44
"King William County, VA",VA,2014,8783,8338,445,5.1,82
"King William County, VA",VA,2013,8701,8222,479,5.5,28
"King William County, VA",VA,2012,8673,8135,538,6.2,-16
"King William County, VA",VA,2011,8689,8093,596,6.9,20
"King William County, VA",VA,2010,8669,8007,662,7.6,0
"Kingfisher County, OK",OK,2021,8647,8419,228,2.6,-74
"Kingfisher County, OK",OK,2020,8721,8336,385,4.4,-346
"Kingfisher County, OK",OK,2019,9067,8890,177,2.0,171
"Kingfisher County, OK",OK,2018,8896,8714,182,2.0,211
"Kingfisher County, OK",OK,2017,8685,8457,228,2.6,241
"Kingfisher County, OK",OK,2016,8444,8174,270,3.2,169
"Kingfisher County, OK",OK,2015,8275,8021,254,3.1,314
"Kingfisher County, OK",OK,2014,7961,7724,237,3.0,181
"Kingfisher County, OK",OK,2013,7780,7519,261,3.4,109
"Kingfisher County, OK",OK,2012,7671,7422,249,3.2,107
"Kingfisher County, OK",OK,2011,7564,7285,279,3.7,189
"Kingfisher County, OK",OK,2010,7375,7016,359,4.9,0
"Kingman County, KS",KS,2021,3272,3172,100,3.1,23
"Kingman County, KS",KS,2020,3249,3082,167,5.1,-134
"Kingman County, KS",KS,2019,3383,3276,107,3.2,-30
"Kingman County, KS",KS,2018,3413,3306,107,3.1,6
"Kingman County, KS",KS,2017,3407,3282,125,3.7,-137
"Kingman County, KS",KS,2016,3544,3388,156,4.4,-115
"Kingman County, KS",KS,2015,3659,3500,159,4.3,50
"Kingman County, KS",KS,2014,3609,3466,143,4.0,-116
"Kingman County, KS",KS,2013,3725,3522,203,5.4,-58
"Kingman County, KS",KS,2012,3783,3551,232,6.1,-59
"Kingman County, KS",KS,2011,3842,3600,242,6.3,-20
"Kingman County, KS",KS,2010,3862,3597,265,6.9,0
"Kings County, CA",CA,2021,55930,50544,5386,9.6,-991
"Kings County, CA",CA,2020,56921,50118,6803,12.0,-1002
"Kings County, CA",CA,2019,57923,53281,4642,8.0,421
"Kings County, CA",CA,2018,57502,52949,4553,7.9,237
"Kings County, CA",CA,2017,57265,52133,5132,9.0,104
"Kings County, CA",CA,2016,57161,51446,5715,10.0,-568
"Kings County, CA",CA,2015,57729,51628,6101,10.6,368
"Kings County, CA",CA,2014,57361,50447,6914,12.1,-668
"Kings County, CA",CA,2013,58029,50148,7881,13.6,-704
"Kings County, CA",CA,2012,58733,49849,8884,15.1,-349
"Kings County, CA",CA,2011,59082,49523,9559,16.2,-480
"Kings County, CA",CA,2010,59562,49730,9832,16.5,0
"Kings County, NY",NY,2021,1193447,1072663,120784,10.1,-17256
"Kings County, NY",NY,2020,1210703,1057917,152786,12.6,-52797
"Kings County, NY",NY,2019,1263500,1213528,49972,4.0,2163
"Kings County, NY",NY,2018,1261337,1208420,52917,4.2,-3288
"Kings County, NY",NY,2017,1264625,1206327,58298,4.6,58396
"Kings County, NY",NY,2016,1206229,1142605,63624,5.3,-3146
"Kings County, NY",NY,2015,1209375,1139369,70006,5.8,-4321
"Kings County, NY",NY,2014,1213696,1123287,90409,7.4,7389
"Kings County, NY",NY,2013,1206307,1093739,112568,9.3,16551
"Kings County, NY",NY,2012,1189756,1072483,117273,9.9,15457
"Kings County, NY",NY,2011,1174299,1061492,112807,9.6,1837
"Kings County, NY",NY,2010,1172462,1055400,117062,10.0,0
"Kingsbury County, SD",SD,2021,2701,2623,78,2.9,41
"Kingsbury County, SD",SD,2020,2660,2568,92,3.5,3
"Kingsbury County, SD",SD,2019,2657,2587,70,2.6,9
"Kingsbury County, SD",SD,2018,2648,2578,70,2.6,-26
"Kingsbury County, SD",SD,2017,2674,2596,78,2.9,-80
"Kingsbury County, SD",SD,2016,2754,2681,73,2.7,-17
"Kingsbury County, SD",SD,2015,2771,2691,80,2.9,-134
"Kingsbury County, SD",SD,2014,2905,2821,84,2.9,3
"Kingsbury County, SD",SD,2013,2902,2810,92,3.2,-101
"Kingsbury County, SD",SD,2012,3003,2902,101,3.4,96
"Kingsbury County, SD",SD,2011,2907,2782,125,4.3,25
"Kingsbury County, SD",SD,2010,2882,2729,153,5.3,0
"Kinney County, TX",TX,2021,1244,1175,69,5.5,-56
"Kinney County, TX",TX,2020,1300,1223,77,5.9,-50
"Kinney County, TX",TX,2019,1350,1301,49,3.6,11
"Kinney County, TX",TX,2018,1339,1280,59,4.4,182
"Kinney County, TX",TX,2017,1157,1092,65,5.6,1
"Kinney County, TX",TX,2016,1156,1089,67,5.8,-29
"Kinney County, TX",TX,2015,1185,1109,76,6.4,-42
"Kinney County, TX",TX,2014,1227,1137,90,7.3,10
"Kinney County, TX",TX,2013,1217,1100,117,9.6,-43
"Kinney County, TX",TX,2012,1260,1150,110,8.7,-12
"Kinney County, TX",TX,2011,1272,1139,133,10.5,0
"Kinney County, TX",TX,2010,1272,1129,143,11.2,0
"Kiowa County, CO",CO,2021,957,925,32,3.3,4
"Kiowa County, CO",CO,2020,953,931,22,2.3,5
"Kiowa County, CO",CO,2019,948,934,14,1.5,13
"Kiowa County, CO",CO,2018,935,919,16,1.7,19
"Kiowa County, CO",CO,2017,916,901,15,1.6,70
"Kiowa County, CO",CO,2016,846,830,16,1.9,55
"Kiowa County, CO",CO,2015,791,771,20,2.5,39
"Kiowa County, CO",CO,2014,752,727,25,3.3,-11
"Kiowa County, CO",CO,2013,763,730,33,4.3,-52
"Kiowa County, CO",CO,2012,815,777,38,4.7,-18
"Kiowa County, CO",CO,2011,833,790,43,5.2,57
"Kiowa County, CO",CO,2010,776,724,52,6.7,0
"Kiowa County, KS",KS,2021,1220,1194,26,2.1,-25
"Kiowa County, KS",KS,2020,1245,1207,38,3.1,-47
"Kiowa County, KS",KS,2019,1292,1263,29,2.2,-15
"Kiowa County, KS",KS,2018,1307,1277,30,2.3,-44
"Kiowa County, KS",KS,2017,1351,1317,34,2.5,-75
"Kiowa County, KS",KS,2016,1426,1387,39,2.7,-26
"Kiowa County, KS",KS,2015,1452,1409,43,3.0,100
"Kiowa County, KS",KS,2014,1352,1308,44,3.3,-74
"Kiowa County, KS",KS,2013,1426,1378,48,3.4,14
"Kiowa County, KS",KS,2012,1412,1359,53,3.8,61
"Kiowa County, KS",KS,2011,1351,1294,57,4.2,-47
"Kiowa County, KS",KS,2010,1398,1326,72,5.2,0
"Kiowa County, OK",OK,2021,3614,3493,121,3.3,115
"Kiowa County, OK",OK,2020,3499,3320,179,5.1,81
"Kiowa County, OK",OK,2019,3418,3297,121,3.5,-94
"Kiowa County, OK",OK,2018,3512,3372,140,4.0,-399
"Kiowa County, OK",OK,2017,3911,3716,195,5.0,-193
"Kiowa County, OK",OK,2016,4104,3893,211,5.1,-56
"Kiowa County, OK",OK,2015,4160,3971,189,4.5,106
"Kiowa County, OK",OK,2014,4054,3895,159,3.9,-90
"Kiowa County, OK",OK,2013,4144,3948,196,4.7,-111
"Kiowa County, OK",OK,2012,4255,4061,194,4.6,0
"Kiowa County, OK",OK,2011,4255,4047,208,4.9,-57
"Kiowa County, OK",OK,2010,4312,4062,250,5.8,0
"Kit Carson County, CO",CO,2021,4261,4135,126,3.0,50
"Kit Carson County, CO",CO,2020,4211,4098,113,2.7,-72
"Kit Carson County, CO",CO,2019,4283,4216,67,1.6,31
"Kit Carson County, CO",CO,2018,4252,4171,81,1.9,-93
"Kit Carson County, CO",CO,2017,4345,4276,69,1.6,-195
"Kit Carson County, CO",CO,2016,4540,4448,92,2.0,218
"Kit Carson County, CO",CO,2015,4322,4222,100,2.3,11
"Kit Carson County, CO",CO,2014,4311,4180,131,3.0,229
"Kit Carson County, CO",CO,2013,4082,3924,158,3.9,-132
"Kit Carson County, CO",CO,2012,4214,4025,189,4.5,-36
"Kit Carson County, CO",CO,2011,4250,4042,208,4.9,-118
"Kit Carson County, CO",CO,2010,4368,4158,210,4.8,0
"Kitsap County, WA",WA,2021,128186,121720,6466,5.0,-231
"Kitsap County, WA",WA,2020,128417,118545,9872,7.7,-1368
"Kitsap County, WA",WA,2019,129785,123742,6043,4.7,5573
"Kitsap County, WA",WA,2018,124212,118498,5714,4.6,3300
"Kitsap County, WA",WA,2017,120912,115114,5798,4.8,2627
"Kitsap County, WA",WA,2016,118285,111789,6496,5.5,2897
"Kitsap County, WA",WA,2015,115388,109174,6214,5.4,1961
"Kitsap County, WA",WA,2014,113427,106681,6746,5.9,-168
"Kitsap County, WA",WA,2013,113595,105576,8019,7.1,-2148
"Kitsap County, WA",WA,2012,115743,107371,8372,7.2,-591
"Kitsap County, WA",WA,2011,116334,107556,8778,7.5,-2013
"Kitsap County, WA",WA,2010,118347,109149,9198,7.8,0
"Kittitas County, WA",WA,2021,21787,20406,1381,6.3,-531
"Kittitas County, WA",WA,2020,22318,20321,1997,8.9,-1535
"Kittitas County, WA",WA,2019,23853,22546,1307,5.5,1699
"Kittitas County, WA",WA,2018,22154,20949,1205,5.4,-208
"Kittitas County, WA",WA,2017,22362,21191,1171,5.2,813
"Kittitas County, WA",WA,2016,21549,20286,1263,5.9,703
"Kittitas County, WA",WA,2015,20846,19591,1255,6.0,677
"Kittitas County, WA",WA,2014,20169,18810,1359,6.7,-20
"Kittitas County, WA",WA,2013,20189,18651,1538,7.6,-310
"Kittitas County, WA",WA,2012,20499,18848,1651,8.1,-70
"Kittitas County, WA",WA,2011,20569,18856,1713,8.3,-313
"Kittitas County, WA",WA,2010,20882,19034,1848,8.8,0
"Kittson County, MN",MN,2021,2223,2159,64,2.9,-182
"Kittson County, MN",MN,2020,2405,2290,115,4.8,9
"Kittson County, MN",MN,2019,2396,2304,92,3.8,51
"Kittson County, MN",MN,2018,2345,2272,73,3.1,-32
"Kittson County, MN",MN,2017,2377,2288,89,3.7,-26
"Kittson County, MN",MN,2016,2403,2293,110,4.6,-76
"Kittson County, MN",MN,2015,2479,2362,117,4.7,83
"Kittson County, MN",MN,2014,2396,2276,120,5.0,-25
"Kittson County, MN",MN,2013,2421,2274,147,6.1,-144
"Kittson County, MN",MN,2012,2565,2415,150,5.8,-44
"Kittson County, MN",MN,2011,2609,2430,179,6.9,30
"Kittson County, MN",MN,2010,2579,2384,195,7.6,0
"Klamath County, OR",OR,2021,29770,27762,2008,6.7,251
"Klamath County, OR",OR,2020,29519,26952,2567,8.7,191
"Klamath County, OR",OR,2019,29328,27554,1774,6.0,15
"Klamath County, OR",OR,2018,29313,27507,1806,6.2,-39
"Klamath County, OR",OR,2017,29352,27644,1708,5.8,208
"Klamath County, OR",OR,2016,29144,27206,1938,6.6,480
"Klamath County, OR",OR,2015,28664,26481,2183,7.6,-91
"Klamath County, OR",OR,2014,28755,26117,2638,9.2,-292
"Klamath County, OR",OR,2013,29047,25957,3090,10.6,-1101
"Klamath County, OR",OR,2012,30148,26620,3528,11.7,-1183
"Klamath County, OR",OR,2011,31331,27532,3799,12.1,-14
"Klamath County, OR",OR,2010,31345,27262,4083,13.0,0
"Kleberg County, TX",TX,2021,13202,12261,941,7.1,60
"Kleberg County, TX",TX,2020,13142,12030,1112,8.5,-183
"Kleberg County, TX",TX,2019,13325,12751,574,4.3,139
"Kleberg County, TX",TX,2018,13186,12528,658,5.0,-113
"Kleberg County, TX",TX,2017,13299,12506,793,6.0,-815
"Kleberg County, TX",TX,2016,14114,13165,949,6.7,-291
"Kleberg County, TX",TX,2015,14405,13548,857,5.9,-835
"Kleberg County, TX",TX,2014,15240,14398,842,5.5,-174
"Kleberg County, TX",TX,2013,15414,14408,1006,6.5,30
"Kleberg County, TX",TX,2012,15384,14330,1054,6.9,-4
"Kleberg County, TX",TX,2011,15388,14112,1276,8.3,333
"Kleberg County, TX",TX,2010,15055,13787,1268,8.4,0
"Klickitat County, WA",WA,2021,10105,9495,610,6.0,367
"Klickitat County, WA",WA,2020,9738,8941,797,8.2,-650
"Klickitat County, WA",WA,2019,10388,9767,621,6.0,239
"Klickitat County, WA",WA,2018,10149,9577,572,5.6,218
"Klickitat County, WA",WA,2017,9931,9350,581,5.9,282
"Klickitat County, WA",WA,2016,9649,9002,647,6.7,195
"Klickitat County, WA",WA,2015,9454,8796,658,7.0,-113
"Klickitat County, WA",WA,2014,9567,8848,719,7.5,-140
"Klickitat County, WA",WA,2013,9707,8813,894,9.2,-177
"Klickitat County, WA",WA,2012,9884,8957,927,9.4,-149
"Klickitat County, WA",WA,2011,10033,8966,1067,10.6,-61
"Klickitat County, WA",WA,2010,10094,8980,1114,11.0,0
"Knott County, KY",KY,2021,4275,3966,309,7.2,-12
"Knott County, KY",KY,2020,4287,3934,353,8.2,-194
"Knott County, KY",KY,2019,4481,4191,290,6.5,79
"Knott County, KY",KY,2018,4402,4109,293,6.7,-100
"Knott County, KY",KY,2017,4502,4126,376,8.4,-54
"Knott County, KY",KY,2016,4556,4035,521,11.4,-153
"Knott County, KY",KY,2015,4709,4232,477,10.1,-427
"Knott County, KY",KY,2014,5136,4567,569,11.1,-450
"Knott County, KY",KY,2013,5586,4733,853,15.3,-246
"Knott County, KY",KY,2012,5832,5024,808,13.9,-30
"Knott County, KY",KY,2011,5862,5171,691,11.8,-94
"Knott County, KY",KY,2010,5956,5147,809,13.6,0
"Knox County, IL",IL,2021,20453,19110,1343,6.6,-600
"Knox County, IL",IL,2020,21053,19199,1854,8.8,-726
"Knox County, IL",IL,2019,21779,20747,1032,4.7,-433
"Knox County, IL",IL,2018,22212,21047,1165,5.2,-314
"Knox County, IL",IL,2017,22526,21356,1170,5.2,-509
"Knox County, IL",IL,2016,23035,21619,1416,6.1,-210
"Knox County, IL",IL,2015,23245,21828,1417,6.1,-337
"Knox County, IL",IL,2014,23582,21936,1646,7.0,-68
"Knox County, IL",IL,2013,23650,21562,2088,8.8,-641
"Knox County, IL",IL,2012,24291,22258,2033,8.4,-555
"Knox County, IL",IL,2011,24846,22658,2188,8.8,-457
"Knox County, IL",IL,2010,25303,22866,2437,9.6,0
"Knox County, IN",IN,2021,18090,17576,514,2.8,-181
"Knox County, IN",IN,2020,18271,17175,1096,6.0,-306
"Knox County, IN",IN,2019,18577,18019,558,3.0,-298
"Knox County, IN",IN,2018,18875,18285,590,3.1,248
"Knox County, IN",IN,2017,18627,17996,631,3.4,-457
"Knox County, IN",IN,2016,19084,18261,823,4.3,60
"Knox County, IN",IN,2015,19024,18158,866,4.6,173
"Knox County, IN",IN,2014,18851,17870,981,5.2,188
"Knox County, IN",IN,2013,18663,17427,1236,6.6,-77
"Knox County, IN",IN,2012,18740,17420,1320,7.0,232
"Knox County, IN",IN,2011,18508,17157,1351,7.3,-29
"Knox County, IN",IN,2010,18537,17061,1476,8.0,0
"Knox County, KY",KY,2021,10049,9427,622,6.2,175
"Knox County, KY",KY,2020,9874,9089,785,8.0,-73
"Knox County, KY",KY,2019,9947,9386,561,5.6,-46
"Knox County, KY",KY,2018,9993,9380,613,6.1,-68
"Knox County, KY",KY,2017,10061,9310,751,7.5,165
"Knox County, KY",KY,2016,9896,9115,781,7.9,166
"Knox County, KY",KY,2015,9730,8940,790,8.1,-392
"Knox County, KY",KY,2014,10122,9120,1002,9.9,-402
"Knox County, KY",KY,2013,10524,9171,1353,12.9,-37
"Knox County, KY",KY,2012,10561,9200,1361,12.9,-98
"Knox County, KY",KY,2011,10659,9246,1413,13.3,-49
"Knox County, KY",KY,2010,10708,9247,1461,13.6,0
"Knox County, ME",ME,2021,19881,19008,873,4.4,319
"Knox County, ME",ME,2020,19562,18584,978,5.0,-1014
"Knox County, ME",ME,2019,20576,20033,543,2.6,-218
"Knox County, ME",ME,2018,20794,20183,611,2.9,-99
"Knox County, ME",ME,2017,20893,20221,672,3.2,131
"Knox County, ME",ME,2016,20762,20034,728,3.5,155
"Knox County, ME",ME,2015,20607,19760,847,4.1,-87
"Knox County, ME",ME,2014,20694,19638,1056,5.1,-51
"Knox County, ME",ME,2013,20745,19509,1236,6.0,184
"Knox County, ME",ME,2012,20561,19195,1366,6.6,118
"Knox County, ME",ME,2011,20443,18973,1470,7.2,-21
"Knox County, ME",ME,2010,20464,18894,1570,7.7,0
"Knox County, MO",MO,2021,1729,1676,53,3.1,-16
"Knox County, MO",MO,2020,1745,1676,69,4.0,-17
"Knox County, MO",MO,2019,1762,1713,49,2.8,-152
"Knox County, MO",MO,2018,1914,1860,54,2.8,-76
"Knox County, MO",MO,2017,1990,1926,64,3.2,8
"Knox County, MO",MO,2016,1982,1910,72,3.6,32
"Knox County, MO",MO,2015,1950,1873,77,3.9,-13
"Knox County, MO",MO,2014,1963,1873,90,4.6,-16
"Knox County, MO",MO,2013,1979,1869,110,5.6,23
"Knox County, MO",MO,2012,1956,1842,114,5.8,-13
"Knox County, MO",MO,2011,1969,1825,144,7.3,-30
"Knox County, MO",MO,2010,1999,1845,154,7.7,0
"Knox County, NE",NE,2021,4735,4638,97,2.0,46
"Knox County, NE",NE,2020,4689,4551,138,2.9,28
"Knox County, NE",NE,2019,4661,4522,139,3.0,-19
"Knox County, NE",NE,2018,4680,4533,147,3.1,-54
"Knox County, NE",NE,2017,4734,4569,165,3.5,-11
"Knox County, NE",NE,2016,4745,4601,144,3.0,9
"Knox County, NE",NE,2015,4736,4585,151,3.2,1
"Knox County, NE",NE,2014,4735,4589,146,3.1,-57
"Knox County, NE",NE,2013,4792,4627,165,3.4,11
"Knox County, NE",NE,2012,4781,4625,156,3.3,16
"Knox County, NE",NE,2011,4765,4579,186,3.9,21
"Knox County, NE",NE,2010,4744,4544,200,4.2,0
"Knox County, OH",OH,2021,31102,29846,1256,4.0,195
"Knox County, OH",OH,2020,30907,28987,1920,6.2,-929
"Knox County, OH",OH,2019,31836,30562,1274,4.0,298
"Knox County, OH",OH,2018,31538,30172,1366,4.3,46
"Knox County, OH",OH,2017,31492,30077,1415,4.5,138
"Knox County, OH",OH,2016,31354,29894,1460,4.7,23
"Knox County, OH",OH,2015,31331,29862,1469,4.7,126
"Knox County, OH",OH,2014,31205,29553,1652,5.3,837
"Knox County, OH",OH,2013,30368,28280,2088,6.9,212
"Knox County, OH",OH,2012,30156,28064,2092,6.9,-262
"Knox County, OH",OH,2011,30418,27767,2651,8.7,-544
"Knox County, OH",OH,2010,30962,27958,3004,9.7,0
"Knox County, TN",TN,2021,247312,239274,8038,3.3,4080
"Knox County, TN",TN,2020,243232,229028,14204,5.8,-2998
"Knox County, TN",TN,2019,246230,239072,7158,2.9,5163
"Knox County, TN",TN,2018,241067,233982,7085,2.9,3414
"Knox County, TN",TN,2017,237653,230101,7552,3.2,3822
"Knox County, TN",TN,2016,233831,224458,9373,4.0,4927
"Knox County, TN",TN,2015,228904,218294,10610,4.6,2638
"Knox County, TN",TN,2014,226266,213912,12354,5.5,-1717
"Knox County, TN",TN,2013,227983,213611,14372,6.3,-2565
"Knox County, TN",TN,2012,230548,216171,14377,6.2,-2146
"Knox County, TN",TN,2011,232694,216377,16317,7.0,2799
"Knox County, TN",TN,2010,229895,212529,17366,7.6,0
"Knox County, TX",TX,2021,1457,1389,68,4.7,19
"Knox County, TX",TX,2020,1438,1357,81,5.6,12
"Knox County, TX",TX,2019,1426,1380,46,3.2,-12
"Knox County, TX",TX,2018,1438,1386,52,3.6,-35
"Knox County, TX",TX,2017,1473,1414,59,4.0,-87
"Knox County, TX",TX,2016,1560,1494,66,4.2,-123
"Knox County, TX",TX,2015,1683,1619,64,3.8,-54
"Knox County, TX",TX,2014,1737,1661,76,4.4,-12
"Knox County, TX",TX,2013,1749,1655,94,5.4,-65
"Knox County, TX",TX,2012,1814,1719,95,5.2,-91
"Knox County, TX",TX,2011,1905,1791,114,6.0,-7
"Knox County, TX",TX,2010,1912,1799,113,5.9,0
"Kodiak Island Borough, AK",AK,2021,6015,5629,386,6.4,-53
"Kodiak Island Borough, AK",AK,2020,6068,5666,402,6.6,97
"Kodiak Island Borough, AK",AK,2019,5971,5674,297,5.0,-179
"Kodiak Island Borough, AK",AK,2018,6150,5820,330,5.4,-170
"Kodiak Island Borough, AK",AK,2017,6320,6025,295,4.7,-98
"Kodiak Island Borough, AK",AK,2016,6418,6101,317,4.9,-190
"Kodiak Island Borough, AK",AK,2015,6608,6300,308,4.7,45
"Kodiak Island Borough, AK",AK,2014,6563,6197,366,5.6,0
"Kodiak Island Borough, AK",AK,2013,6563,6153,410,6.2,-128
"Kodiak Island Borough, AK",AK,2012,6691,6237,454,6.8,-66
"Kodiak Island Borough, AK",AK,2011,6757,6246,511,7.6,292
"Kodiak Island Borough, AK",AK,2010,6465,5971,494,7.6,0
"Koochiching County, MN",MN,2021,5582,5336,246,4.4,-269
"Koochiching County, MN",MN,2020,5851,5405,446,7.6,-208
"Koochiching County, MN",MN,2019,6059,5652,407,6.7,80
"Koochiching County, MN",MN,2018,5979,5587,392,6.6,-24
"Koochiching County, MN",MN,2017,6003,5572,431,7.2,-156
"Koochiching County, MN",MN,2016,6159,5636,523,8.5,-117
"Koochiching County, MN",MN,2015,6276,5755,521,8.3,-180
"Koochiching County, MN",MN,2014,6456,5897,559,8.7,-281
"Koochiching County, MN",MN,2013,6737,6170,567,8.4,27
"Koochiching County, MN",MN,2012,6710,6171,539,8.0,-116
"Koochiching County, MN",MN,2011,6826,6253,573,8.4,-119
"Koochiching County, MN",MN,2010,6945,6340,605,8.7,0
"Kootenai County, ID",ID,2021,82719,79179,3540,4.3,780
"Kootenai County, ID",ID,2020,81939,76149,5790,7.1,1139
"Kootenai County, ID",ID,2019,80800,77878,2922,3.6,2566
"Kootenai County, ID",ID,2018,78234,75468,2766,3.5,2012
"Kootenai County, ID",ID,2017,76222,73269,2953,3.9,2460
"Kootenai County, ID",ID,2016,73762,70446,3316,4.5,2161
"Kootenai County, ID",ID,2015,71601,68225,3376,4.7,1449
"Kootenai County, ID",ID,2014,70152,66441,3711,5.3,193
"Kootenai County, ID",ID,2013,69959,64285,5674,8.1,1023
"Kootenai County, ID",ID,2012,68936,62746,6190,9.0,-287
"Kootenai County, ID",ID,2011,69223,62318,6905,10.0,279
"Kootenai County, ID",ID,2010,68944,61560,7384,10.7,0
"Kosciusko County, IN",IN,2021,40499,39392,1107,2.7,-874
"Kosciusko County, IN",IN,2020,41373,38796,2577,6.2,-1297
"Kosciusko County, IN",IN,2019,42670,41496,1174,2.8,-123
"Kosciusko County, IN",IN,2018,42793,41681,1112,2.6,1219
"Kosciusko County, IN",IN,2017,41574,40450,1124,2.7,32
"Kosciusko County, IN",IN,2016,41542,40008,1534,3.7,883
"Kosciusko County, IN",IN,2015,40659,39016,1643,4.0,318
"Kosciusko County, IN",IN,2014,40341,38375,1966,4.9,537
"Kosciusko County, IN",IN,2013,39804,37230,2574,6.5,1024
"Kosciusko County, IN",IN,2012,38780,35836,2944,7.6,-287
"Kosciusko County, IN",IN,2011,39067,35643,3424,8.8,-163
"Kosciusko County, IN",IN,2010,39230,35013,4217,10.7,0
"Kossuth County, IA",IA,2021,8089,7824,265,3.3,-78
"Kossuth County, IA",IA,2020,8167,7865,302,3.7,-441
"Kossuth County, IA",IA,2019,8608,8427,181,2.1,-23
"Kossuth County, IA",IA,2018,8631,8457,174,2.0,-197
"Kossuth County, IA",IA,2017,8828,8622,206,2.3,-113
"Kossuth County, IA",IA,2016,8941,8709,232,2.6,106
"Kossuth County, IA",IA,2015,8835,8585,250,2.8,173
"Kossuth County, IA",IA,2014,8662,8385,277,3.2,177
"Kossuth County, IA",IA,2013,8485,8183,302,3.6,67
"Kossuth County, IA",IA,2012,8418,8090,328,3.9,30
"Kossuth County, IA",IA,2011,8388,8016,372,4.4,30
"Kossuth County, IA",IA,2010,8358,7926,432,5.2,0
"Kusilvak Census Area, AK",AK,2021,2347,1880,467,19.9,59
"Kusilvak Census Area, AK",AK,2020,2288,1817,471,20.6,-362
"Kusilvak Census Area, AK",AK,2019,2650,2178,472,17.8,-28
"Kusilvak Census Area, AK",AK,2018,2678,2188,490,18.3,-57
"Kusilvak Census Area, AK",AK,2017,2735,2227,508,18.6,29
"Kusilvak Census Area, AK",AK,2016,2706,2142,564,20.8,-81
"Kusilvak Census Area, AK",AK,2015,2787,2160,627,22.5,-25
"Kusilvak Census Area, AK",AK,2014,2812,2152,660,23.5,41
"Kusilvak Census Area, AK",AK,2013,2771,2114,657,23.7,7
"Kusilvak Census Area, AK",AK,2012,2764,2146,618,22.4,6
"Kusilvak Census Area, AK",AK,2011,2758,2165,593,21.5,90
"Kusilvak Census Area, AK",AK,2010,2668,2107,561,21.0,0
"La Crosse County, WI",WI,2021,67244,65207,2037,3.0,1184
"La Crosse County, WI",WI,2020,66060,62474,3586,5.4,-348
"La Crosse County, WI",WI,2019,66408,64578,1830,2.8,-758
"La Crosse County, WI",WI,2018,67166,65420,1746,2.6,-701
"La Crosse County, WI",WI,2017,67867,65900,1967,2.9,479
"La Crosse County, WI",WI,2016,67388,65012,2376,3.5,924
"La Crosse County, WI",WI,2015,66464,63958,2506,3.8,-161
"La Crosse County, WI",WI,2014,66625,63762,2863,4.3,-130
"La Crosse County, WI",WI,2013,66755,63241,3514,5.3,398
"La Crosse County, WI",WI,2012,66357,62801,3556,5.4,914
"La Crosse County, WI",WI,2011,65443,61620,3823,5.8,-218
"La Crosse County, WI",WI,2010,65661,61376,4285,6.5,0
"La Paz County, AZ",AZ,2021,8616,8175,441,5.1,-110
"La Paz County, AZ",AZ,2020,8726,8117,609,7.0,-278
"La Paz County, AZ",AZ,2019,9004,8466,538,6.0,353
"La Paz County, AZ",AZ,2018,8651,8114,537,6.2,182
"La Paz County, AZ",AZ,2017,8469,8006,463,5.5,-37
"La Paz County, AZ",AZ,2016,8506,7983,523,6.1,289
"La Paz County, AZ",AZ,2015,8217,7602,615,7.5,215
"La Paz County, AZ",AZ,2014,8002,7394,608,7.6,-119
"La Paz County, AZ",AZ,2013,8121,7453,668,8.2,-84
"La Paz County, AZ",AZ,2012,8205,7503,702,8.6,341
"La Paz County, AZ",AZ,2011,7864,7096,768,9.8,-21
"La Paz County, AZ",AZ,2010,7885,7084,801,10.2,0
"La Plata County, CO",CO,2021,31905,30248,1657,5.2,981
"La Plata County, CO",CO,2020,30924,28897,2027,6.6,-703
"La Plata County, CO",CO,2019,31627,30878,749,2.4,-331
"La Plata County, CO",CO,2018,31958,31083,875,2.7,803
"La Plata County, CO",CO,2017,31155,30449,706,2.3,163
"La Plata County, CO",CO,2016,30992,30141,851,2.7,1130
"La Plata County, CO",CO,2015,29862,28871,991,3.3,-45
"La Plata County, CO",CO,2014,29907,28651,1256,4.2,355
"La Plata County, CO",CO,2013,29552,27894,1658,5.6,-25
"La Plata County, CO",CO,2012,29577,27583,1994,6.7,175
"La Plata County, CO",CO,2011,29402,27257,2145,7.3,-364
"La Plata County, CO",CO,2010,29766,27527,2239,7.5,0
"La Salle County, TX",TX,2021,3804,3641,163,4.3,101
"La Salle County, TX",TX,2020,3703,3454,249,6.7,-633
"La Salle County, TX",TX,2019,4336,4231,105,2.4,-205
"La Salle County, TX",TX,2018,4541,4430,111,2.4,366
"La Salle County, TX",TX,2017,4175,4021,154,3.7,288
"La Salle County, TX",TX,2016,3887,3687,200,5.1,-383
"La Salle County, TX",TX,2015,4270,4091,179,4.2,-299
"La Salle County, TX",TX,2014,4569,4426,143,3.1,401
"La Salle County, TX",TX,2013,4168,4010,158,3.8,505
"La Salle County, TX",TX,2012,3663,3500,163,4.4,527
"La Salle County, TX",TX,2011,3136,2917,219,7.0,408
"La Salle County, TX",TX,2010,2728,2481,247,9.1,0
"Labette County, KS",KS,2021,9413,9093,320,3.4,-235
"Labette County, KS",KS,2020,9648,9122,526,5.5,-439
"Labette County, KS",KS,2019,10087,9692,395,3.9,-164
"Labette County, KS",KS,2018,10251,9854,397,3.9,-136
"Labette County, KS",KS,2017,10387,9920,467,4.5,-395
"Labette County, KS",KS,2016,10782,10202,580,5.4,0
"Labette County, KS",KS,2015,10782,10164,618,5.7,-6
"Labette County, KS",KS,2014,10788,10164,624,5.8,37
"Labette County, KS",KS,2013,10751,9982,769,7.2,2
"Labette County, KS",KS,2012,10749,9897,852,7.9,-332
"Labette County, KS",KS,2011,11081,10097,984,8.9,-189
"Labette County, KS",KS,2010,11270,10212,1058,9.4,0
"Lac qui Parle County, MN",MN,2021,3303,3209,94,2.8,-233
"Lac qui Parle County, MN",MN,2020,3536,3361,175,4.9,-44
"Lac qui Parle County, MN",MN,2019,3580,3438,142,4.0,44
"Lac qui Parle County, MN",MN,2018,3536,3399,137,3.9,-3
"Lac qui Parle County, MN",MN,2017,3539,3416,123,3.5,-78
"Lac qui Parle County, MN",MN,2016,3617,3462,155,4.3,-156
"Lac qui Parle County, MN",MN,2015,3773,3615,158,4.2,113
"Lac qui Parle County, MN",MN,2014,3660,3482,178,4.9,-10
"Lac qui Parle County, MN",MN,2013,3670,3462,208,5.7,-190
"Lac qui Parle County, MN",MN,2012,3860,3665,195,5.1,-122
"Lac qui Parle County, MN",MN,2011,3982,3740,242,6.1,-103
"Lac qui Parle County, MN",MN,2010,4085,3812,273,6.7,0
"Lackawanna County, PA",PA,2021,103325,96225,7100,6.9,-1685
"Lackawanna County, PA",PA,2020,105010,94896,10114,9.6,-1291
"Lackawanna County, PA",PA,2019,106301,100971,5330,5.0,-162
"Lackawanna County, PA",PA,2018,106463,101395,5068,4.8,-465
"Lackawanna County, PA",PA,2017,106928,101344,5584,5.2,-159
"Lackawanna County, PA",PA,2016,107087,101105,5982,5.6,629
"Lackawanna County, PA",PA,2015,106458,100145,6313,5.9,-140
"Lackawanna County, PA",PA,2014,106598,99512,7086,6.6,-616
"Lackawanna County, PA",PA,2013,107214,98616,8598,8.0,-157
"Lackawanna County, PA",PA,2012,107371,98089,9282,8.6,355
"Lackawanna County, PA",PA,2011,107016,97780,9236,8.6,372
"Lackawanna County, PA",PA,2010,106644,97365,9279,8.7,0
"Laclede County, MO",MO,2021,16514,15802,712,4.3,-190
"Laclede County, MO",MO,2020,16704,15346,1358,8.1,-510
"Laclede County, MO",MO,2019,17214,16096,1118,6.5,462
"Laclede County, MO",MO,2018,16752,16142,610,3.6,166
"Laclede County, MO",MO,2017,16586,15802,784,4.7,444
"Laclede County, MO",MO,2016,16142,15263,879,5.4,299
"Laclede County, MO",MO,2015,15843,14817,1026,6.5,-5
"Laclede County, MO",MO,2014,15848,14561,1287,8.1,293
"Laclede County, MO",MO,2013,15555,14048,1507,9.7,-142
"Laclede County, MO",MO,2012,15697,14200,1497,9.5,-157
"Laclede County, MO",MO,2011,15854,14028,1826,11.5,8
"Laclede County, MO",MO,2010,15846,13893,1953,12.3,0
"Lafayette County, AR",AR,2021,2327,2192,135,5.8,-92
"Lafayette County, AR",AR,2020,2419,2233,186,7.7,-39
"Lafayette County, AR",AR,2019,2458,2347,111,4.5,-31
"Lafayette County, AR",AR,2018,2489,2362,127,5.1,-49
"Lafayette County, AR",AR,2017,2538,2410,128,5.0,-48
"Lafayette County, AR",AR,2016,2586,2435,151,5.8,-72
"Lafayette County, AR",AR,2015,2658,2461,197,7.4,-53
"Lafayette County, AR",AR,2014,2711,2507,204,7.5,-79
"Lafayette County, AR",AR,2013,2790,2531,259,9.3,-135
"Lafayette County, AR",AR,2012,2925,2662,263,9.0,-92
"Lafayette County, AR",AR,2011,3017,2742,275,9.1,-56
"Lafayette County, AR",AR,2010,3073,2785,288,9.4,0
"Lafayette County, FL",FL,2021,2787,2676,111,4.0,18
"Lafayette County, FL",FL,2020,2769,2640,129,4.7,-55
"Lafayette County, FL",FL,2019,2824,2739,85,3.0,16
"Lafayette County, FL",FL,2018,2808,2709,99,3.5,-110
"Lafayette County, FL",FL,2017,2918,2807,111,3.8,-59
"Lafayette County, FL",FL,2016,2977,2846,131,4.4,-240
"Lafayette County, FL",FL,2015,3217,3068,149,4.6,-131
"Lafayette County, FL",FL,2014,3348,3171,177,5.3,-141
"Lafayette County, FL",FL,2013,3489,3300,189,5.4,29
"Lafayette County, FL",FL,2012,3460,3256,204,5.9,-155
"Lafayette County, FL",FL,2011,3615,3390,225,6.2,236
"Lafayette County, FL",FL,2010,3379,3141,238,7.0,0
"Lafayette County, MO",MO,2021,16674,15963,711,4.3,176
"Lafayette County, MO",MO,2020,16498,15638,860,5.2,-202
"Lafayette County, MO",MO,2019,16700,16213,487,2.9,-18
"Lafayette County, MO",MO,2018,16718,16182,536,3.2,-241
"Lafayette County, MO",MO,2017,16959,16322,637,3.8,-214
"Lafayette County, MO",MO,2016,17173,16434,739,4.3,98
"Lafayette County, MO",MO,2015,17075,16232,843,4.9,175
"Lafayette County, MO",MO,2014,16900,15889,1011,6.0,31
"Lafayette County, MO",MO,2013,16869,15773,1096,6.5,-261
"Lafayette County, MO",MO,2012,17130,15875,1255,7.3,-248
"Lafayette County, MO",MO,2011,17378,15770,1608,9.3,-96
"Lafayette County, MO",MO,2010,17474,15775,1699,9.7,0
"Lafayette County, MS",MS,2021,27635,26498,1137,4.1,1347
"Lafayette County, MS",MS,2020,26288,24724,1564,5.9,-1725
"Lafayette County, MS",MS,2019,28013,26782,1231,4.4,-80
"Lafayette County, MS",MS,2018,28093,26963,1130,4.0,626
"Lafayette County, MS",MS,2017,27467,26294,1173,4.3,1599
"Lafayette County, MS",MS,2016,25868,24579,1289,5.0,1500
"Lafayette County, MS",MS,2015,24368,23018,1350,5.5,1166
"Lafayette County, MS",MS,2014,23202,21699,1503,6.5,153
"Lafayette County, MS",MS,2013,23049,21408,1641,7.1,-559
"Lafayette County, MS",MS,2012,23608,21823,1785,7.6,613
"Lafayette County, MS",MS,2011,22995,21063,1932,8.4,1295
"Lafayette County, MS",MS,2010,21700,19732,1968,9.1,0
"Lafayette County, WI",WI,2021,10241,9976,265,2.6,317
"Lafayette County, WI",WI,2020,9924,9498,426,4.3,-212
"Lafayette County, WI",WI,2019,10136,9881,255,2.5,-110
"Lafayette County, WI",WI,2018,10246,10013,233,2.3,60
"Lafayette County, WI",WI,2017,10186,9930,256,2.5,368
"Lafayette County, WI",WI,2016,9818,9514,304,3.1,93
"Lafayette County, WI",WI,2015,9725,9376,349,3.6,334
"Lafayette County, WI",WI,2014,9391,9000,391,4.2,45
"Lafayette County, WI",WI,2013,9346,8846,500,5.3,-44
"Lafayette County, WI",WI,2012,9390,8872,518,5.5,-71
"Lafayette County, WI",WI,2011,9461,8872,589,6.2,-37
"Lafayette County, WI",WI,2010,9498,8830,668,7.0,0
"Lafayette Parish, LA",LA,2021,115123,109956,5167,4.5,982
"Lafayette Parish, LA",LA,2020,114141,105578,8563,7.5,-1158
"Lafayette Parish, LA",LA,2019,115299,110504,4795,4.2,933
"Lafayette Parish, LA",LA,2018,114366,109324,5042,4.4,1079
"Lafayette Parish, LA",LA,2017,113287,107757,5530,4.9,-1201
"Lafayette Parish, LA",LA,2016,114488,107456,7032,6.1,-5115
"Lafayette Parish, LA",LA,2015,119603,112863,6740,5.6,-2348
"Lafayette Parish, LA",LA,2014,121951,116068,5883,4.8,2950
"Lafayette Parish, LA",LA,2013,119001,113366,5635,4.7,1763
"Lafayette Parish, LA",LA,2012,117238,111620,5618,4.8,2851
"Lafayette Parish, LA",LA,2011,114387,107958,6429,5.6,789
"Lafayette Parish, LA",LA,2010,113598,106923,6675,5.9,0
"Lafourche Parish, LA",LA,2021,40657,38805,1852,4.6,-495
"Lafourche Parish, LA",LA,2020,41152,38299,2853,6.9,-999
"Lafourche Parish, LA",LA,2019,42151,40323,1828,4.3,-85
"Lafourche Parish, LA",LA,2018,42236,40273,1963,4.6,242
"Lafourche Parish, LA",LA,2017,41994,39813,2181,5.2,-1351
"Lafourche Parish, LA",LA,2016,43345,40617,2728,6.3,-3101
"Lafourche Parish, LA",LA,2015,46446,43950,2496,5.4,-1846
"Lafourche Parish, LA",LA,2014,48292,46020,2272,4.7,1419
"Lafourche Parish, LA",LA,2013,46873,44662,2211,4.7,1205
"Lafourche Parish, LA",LA,2012,45668,43369,2299,5.0,1091
"Lafourche Parish, LA",LA,2011,44577,41990,2587,5.8,-506
"Lafourche Parish, LA",LA,2010,45083,42477,2606,5.8,0
"LaGrange County, IN",IN,2021,20421,20017,404,2.0,1122
"LaGrange County, IN",IN,2020,19299,18047,1252,6.5,-798
"LaGrange County, IN",IN,2019,20097,19544,553,2.8,-575
"LaGrange County, IN",IN,2018,20672,20161,511,2.5,684
"LaGrange County, IN",IN,2017,19988,19483,505,2.5,543
"LaGrange County, IN",IN,2016,19445,18784,661,3.4,545
"LaGrange County, IN",IN,2015,18900,18213,687,3.6,670
"LaGrange County, IN",IN,2014,18230,17419,811,4.4,584
"LaGrange County, IN",IN,2013,17646,16623,1023,5.8,627
"LaGrange County, IN",IN,2012,17019,15826,1193,7.0,316
"LaGrange County, IN",IN,2011,16703,15233,1470,8.8,136
"LaGrange County, IN",IN,2010,16567,14622,1945,11.7,0
"Lajas Municipio, PR",PR,2021,5643,4943,700,12.4,
"Lajas Municipio, PR",PR,2020,N.A.,N.A.,N.A.,N.A.,
"Lajas Municipio, PR",PR,2019,5184,4521,663,12.8,-52
"Lajas Municipio, PR",PR,2018,5236,4434,802,15.3,-237
"Lajas Municipio, PR",PR,2017,5473,4409,1064,19.4,-158
"Lajas Municipio, PR",PR,2016,5631,4580,1051,18.7,22
"Lajas Municipio, PR",PR,2015,5609,4603,1006,17.9,-282
"Lajas Municipio, PR",PR,2014,5891,4484,1407,23.9,-333
"Lajas Municipio, PR",PR,2013,6224,4520,1704,27.4,91
"Lajas Municipio, PR",PR,2012,6133,4715,1418,23.1,-125
"Lajas Municipio, PR",PR,2011,6258,4797,1461,23.3,-313
"Lajas Municipio, PR",PR,2010,6571,5070,1501,22.8,0
"Lake and Peninsula Borough, AK",AK,2021,649,591,58,8.9,36
"Lake and Peninsula Borough, AK",AK,2020,613,543,70,11.4,-96
"Lake and Peninsula Borough, AK",AK,2019,709,645,64,9.0,-35
"Lake and Peninsula Borough, AK",AK,2018,744,668,76,10.2,28
"Lake and Peninsula Borough, AK",AK,2017,716,637,79,11.0,63
"Lake and Peninsula Borough, AK",AK,2016,653,575,78,11.9,10
"Lake and Peninsula Borough, AK",AK,2015,643,565,78,12.1,2
"Lake and Peninsula Borough, AK",AK,2014,641,538,103,16.1,6
"Lake and Peninsula Borough, AK",AK,2013,635,536,99,15.6,0
"Lake and Peninsula Borough, AK",AK,2012,635,537,98,15.4,-2
"Lake and Peninsula Borough, AK",AK,2011,637,539,98,15.4,32
"Lake and Peninsula Borough, AK",AK,2010,605,515,90,14.9,0
"Lake County, CA",CA,2021,28371,26211,2160,7.6,-40
"Lake County, CA",CA,2020,28411,25614,2797,9.8,-645
"Lake County, CA",CA,2019,29056,27555,1501,5.2,-14
"Lake County, CA",CA,2018,29070,27523,1547,5.3,-232
"Lake County, CA",CA,2017,29302,27598,1704,5.8,235
"Lake County, CA",CA,2016,29067,27108,1959,6.7,61
"Lake County, CA",CA,2015,29006,26790,2216,7.6,-224
"Lake County, CA",CA,2014,29230,26585,2645,9.0,67
"Lake County, CA",CA,2013,29163,25944,3219,11.0,-297
"Lake County, CA",CA,2012,29460,25635,3825,13.0,-122
"Lake County, CA",CA,2011,29582,25210,4372,14.8,-317
"Lake County, CA",CA,2010,29899,25279,4620,15.5,0
"Lake County, CO",CO,2021,4974,4756,218,4.4,171
"Lake County, CO",CO,2020,4803,4434,369,7.7,-113
"Lake County, CO",CO,2019,4916,4807,109,2.2,162
"Lake County, CO",CO,2018,4754,4638,116,2.4,81
"Lake County, CO",CO,2017,4673,4580,93,2.0,55
"Lake County, CO",CO,2016,4618,4492,126,2.7,51
"Lake County, CO",CO,2015,4567,4397,170,3.7,63
"Lake County, CO",CO,2014,4504,4296,208,4.6,67
"Lake County, CO",CO,2013,4437,4123,314,7.1,-74
"Lake County, CO",CO,2012,4511,4117,394,8.7,141
"Lake County, CO",CO,2011,4370,3914,456,10.4,8
"Lake County, CO",CO,2010,4362,3860,502,11.5,0
"Lake County, FL",FL,2021,159493,152035,7458,4.7,2721
"Lake County, FL",FL,2020,156772,142000,14772,9.4,-3625
"Lake County, FL",FL,2019,160397,155121,5276,3.3,6034
"Lake County, FL",FL,2018,154363,148689,5674,3.7,4504
"Lake County, FL",FL,2017,149859,143453,6406,4.3,3282
"Lake County, FL",FL,2016,146577,139389,7188,4.9,5234
"Lake County, FL",FL,2015,141343,133475,7868,5.6,3209
"Lake County, FL",FL,2014,138134,129049,9085,6.6,3011
"Lake County, FL",FL,2013,135123,124697,10426,7.7,1945
"Lake County, FL",FL,2012,133178,121063,12115,9.1,134
"Lake County, FL",FL,2011,133044,118993,14051,10.6,218
"Lake County, FL",FL,2010,132826,117680,15146,11.4,0
"Lake County, IL",IL,2021,365816,346560,19256,5.3,1906
"Lake County, IL",IL,2020,363910,334143,29767,8.2,-13651
"Lake County, IL",IL,2019,377561,362682,14879,3.9,-718
"Lake County, IL",IL,2018,378279,361329,16950,4.5,5309
"Lake County, IL",IL,2017,372970,356138,16832,4.5,-403
"Lake County, IL",IL,2016,373373,353803,19570,5.2,6095
"Lake County, IL",IL,2015,367278,347425,19853,5.4,2649
"Lake County, IL",IL,2014,364629,340872,23757,6.5,1159
"Lake County, IL",IL,2013,363470,334752,28718,7.9,-2061
"Lake County, IL",IL,2012,365531,335653,29878,8.2,-2268
"Lake County, IL",IL,2011,367799,335081,32718,8.9,-1154
"Lake County, IL",IL,2010,368953,332048,36905,10.0,0
"Lake County, IN",IN,2021,222818,209298,13520,6.1,-3397
"Lake County, IN",IN,2020,226215,202695,23520,10.4,-3067
"Lake County, IN",IN,2019,229282,218059,11223,4.9,-2768
"Lake County, IN",IN,2018,232050,220711,11339,4.9,1984
"Lake County, IN",IN,2017,230066,218433,11633,5.1,-2354
"Lake County, IN",IN,2016,232420,217907,14513,6.2,2770
"Lake County, IN",IN,2015,229650,214098,15552,6.8,-1005
"Lake County, IN",IN,2014,230655,212526,18129,7.9,391
"Lake County, IN",IN,2013,230264,209792,20472,8.9,1224
"Lake County, IN",IN,2012,229040,208488,20552,9.0,-719
"Lake County, IN",IN,2011,229759,208263,21496,9.4,637
"Lake County, IN",IN,2010,229122,205072,24050,10.5,0
"Lake County, MI",MI,2021,3843,3527,316,8.2,-111
"Lake County, MI",MI,2020,3954,3509,445,11.3,179
"Lake County, MI",MI,2019,3775,3533,242,6.4,137
"Lake County, MI",MI,2018,3638,3388,250,6.9,-89
"Lake County, MI",MI,2017,3727,3427,300,8.0,-37
"Lake County, MI",MI,2016,3764,3479,285,7.6,66
"Lake County, MI",MI,2015,3698,3377,321,8.7,72
"Lake County, MI",MI,2014,3626,3219,407,11.2,-6
"Lake County, MI",MI,2013,3632,3154,478,13.2,-42
"Lake County, MI",MI,2012,3674,3200,474,12.9,-170
"Lake County, MI",MI,2011,3844,3339,505,13.1,-3
"Lake County, MI",MI,2010,3847,3240,607,15.8,0
"Lake County, MN",MN,2021,5249,5060,189,3.6,-114
"Lake County, MN",MN,2020,5363,4967,396,7.4,-198
"Lake County, MN",MN,2019,5561,5347,214,3.8,59
"Lake County, MN",MN,2018,5502,5316,186,3.4,-29
"Lake County, MN",MN,2017,5531,5316,215,3.9,117
"Lake County, MN",MN,2016,5414,5069,345,6.4,-212
"Lake County, MN",MN,2015,5626,5350,276,4.9,-70
"Lake County, MN",MN,2014,5696,5428,268,4.7,-86
"Lake County, MN",MN,2013,5782,5418,364,6.3,-53
"Lake County, MN",MN,2012,5835,5482,353,6.0,8
"Lake County, MN",MN,2011,5827,5424,403,6.9,25
"Lake County, MN",MN,2010,5802,5319,483,8.3,0
"Lake County, MT",MT,2021,14006,13472,534,3.8,264
"Lake County, MT",MT,2020,13742,12908,834,6.1,284
"Lake County, MT",MT,2019,13458,12875,583,4.3,222
"Lake County, MT",MT,2018,13236,12668,568,4.3,11
"Lake County, MT",MT,2017,13225,12623,602,4.6,147
"Lake County, MT",MT,2016,13078,12435,643,4.9,373
"Lake County, MT",MT,2015,12705,12054,651,5.1,218
"Lake County, MT",MT,2014,12487,11797,690,5.5,109
"Lake County, MT",MT,2013,12378,11583,795,6.4,-52
"Lake County, MT",MT,2012,12430,11501,929,7.5,-109
"Lake County, MT",MT,2011,12539,11443,1096,8.7,-119
"Lake County, MT",MT,2010,12658,11532,1126,8.9,0
"Lake County, OH",OH,2021,122641,116398,6243,5.1,681
"Lake County, OH",OH,2020,121960,111570,10390,8.5,-7808
"Lake County, OH",OH,2019,129768,124827,4941,3.8,1400
"Lake County, OH",OH,2018,128368,122751,5617,4.4,703
"Lake County, OH",OH,2017,127665,121195,6470,5.1,3099
"Lake County, OH",OH,2016,124566,118449,6117,4.9,1015
"Lake County, OH",OH,2015,123551,117946,5605,4.5,-835
"Lake County, OH",OH,2014,124386,117488,6898,5.5,-483
"Lake County, OH",OH,2013,124869,116992,7877,6.3,-164
"Lake County, OH",OH,2012,125033,117536,7497,6.0,-1988
"Lake County, OH",OH,2011,127021,118337,8684,6.8,-1309
"Lake County, OH",OH,2010,128330,118120,10210,8.0,0
"Lake County, OR",OR,2021,3721,3517,204,5.5,65
"Lake County, OR",OR,2020,3656,3450,206,5.6,50
"Lake County, OR",OR,2019,3606,3414,192,5.3,55
"Lake County, OR",OR,2018,3551,3358,193,5.4,65
"Lake County, OR",OR,2017,3486,3291,195,5.6,43
"Lake County, OR",OR,2016,3443,3228,215,6.2,7
"Lake County, OR",OR,2015,3436,3179,257,7.5,-76
"Lake County, OR",OR,2014,3512,3181,331,9.4,22
"Lake County, OR",OR,2013,3490,3099,391,11.2,-157
"Lake County, OR",OR,2012,3647,3175,472,12.9,-111
"Lake County, OR",OR,2011,3758,3260,498,13.3,23
"Lake County, OR",OR,2010,3735,3228,507,13.6,0
"Lake County, SD",SD,2021,6548,6349,199,3.0,122
"Lake County, SD",SD,2020,6426,6196,230,3.6,-181
"Lake County, SD",SD,2019,6607,6406,201,3.0,-9
"Lake County, SD",SD,2018,6616,6408,208,3.1,127
"Lake County, SD",SD,2017,6489,6259,230,3.5,-2
"Lake County, SD",SD,2016,6491,6268,223,3.4,-60
"Lake County, SD",SD,2015,6551,6317,234,3.6,180
"Lake County, SD",SD,2014,6371,6146,225,3.5,16
"Lake County, SD",SD,2013,6355,6114,241,3.8,26
"Lake County, SD",SD,2012,6329,6075,254,4.0,74
"Lake County, SD",SD,2011,6255,5953,302,4.8,66
"Lake County, SD",SD,2010,6189,5844,345,5.6,0
"Lake County, TN",TN,2021,1659,1560,99,6.0,-20
"Lake County, TN",TN,2020,1679,1544,135,8.0,-55
"Lake County, TN",TN,2019,1734,1639,95,5.5,-72
"Lake County, TN",TN,2018,1806,1714,92,5.1,-36
"Lake County, TN",TN,2017,1842,1739,103,5.6,-75
"Lake County, TN",TN,2016,1917,1767,150,7.8,-57
"Lake County, TN",TN,2015,1974,1807,167,8.5,-133
"Lake County, TN",TN,2014,2107,1912,195,9.3,-81
"Lake County, TN",TN,2013,2188,1968,220,10.1,-18
"Lake County, TN",TN,2012,2206,1972,234,10.6,12
"Lake County, TN",TN,2011,2194,1926,268,12.2,17
"Lake County, TN",TN,2010,2177,1932,245,11.3,0
"Lake of the Woods County, MN",MN,2021,2362,2275,87,3.7,-87
"Lake of the Woods County, MN",MN,2020,2449,2295,154,6.3,-27
"Lake of the Woods County, MN",MN,2019,2476,2366,110,4.4,65
"Lake of the Woods County, MN",MN,2018,2411,2313,98,4.1,16
"Lake of the Woods County, MN",MN,2017,2395,2282,113,4.7,13
"Lake of the Woods County, MN",MN,2016,2382,2267,115,4.8,-47
"Lake of the Woods County, MN",MN,2015,2429,2318,111,4.6,36
"Lake of the Woods County, MN",MN,2014,2393,2276,117,4.9,16
"Lake of the Woods County, MN",MN,2013,2377,2240,137,5.8,27
"Lake of the Woods County, MN",MN,2012,2350,2206,144,6.1,5
"Lake of the Woods County, MN",MN,2011,2345,2199,146,6.2,62
"Lake of the Woods County, MN",MN,2010,2283,2135,148,6.5,0
"Lamar County, AL",AL,2021,5691,5521,170,3.0,-97
"Lamar County, AL",AL,2020,5788,5474,314,5.4,-103
"Lamar County, AL",AL,2019,5891,5700,191,3.2,86
"Lamar County, AL",AL,2018,5805,5586,219,3.8,-2
"Lamar County, AL",AL,2017,5807,5558,249,4.3,164
"Lamar County, AL",AL,2016,5643,5324,319,5.7,41
"Lamar County, AL",AL,2015,5602,5246,356,6.4,-32
"Lamar County, AL",AL,2014,5634,5244,390,6.9,-161
"Lamar County, AL",AL,2013,5795,5383,412,7.1,-15
"Lamar County, AL",AL,2012,5810,5363,447,7.7,-11
"Lamar County, AL",AL,2011,5821,5262,559,9.6,24
"Lamar County, AL",AL,2010,5797,5046,751,13.0,0
"Lamar County, GA",GA,2021,8249,7904,345,4.2,265
"Lamar County, GA",GA,2020,7984,7483,501,6.3,-232
"Lamar County, GA",GA,2019,8216,7883,333,4.1,-18
"Lamar County, GA",GA,2018,8234,7848,386,4.7,107
"Lamar County, GA",GA,2017,8127,7668,459,5.6,227
"Lamar County, GA",GA,2016,7900,7375,525,6.6,303
"Lamar County, GA",GA,2015,7597,7003,594,7.8,-181
"Lamar County, GA",GA,2014,7778,7032,746,9.6,-32
"Lamar County, GA",GA,2013,7810,6934,876,11.2,-126
"Lamar County, GA",GA,2012,7936,6991,945,11.9,-161
"Lamar County, GA",GA,2011,8097,6995,1102,13.6,-88
"Lamar County, GA",GA,2010,8185,7006,1179,14.4,0
"Lamar County, MS",MS,2021,31299,30012,1287,4.1,916
"Lamar County, MS",MS,2020,30383,28592,1791,5.9,-691
"Lamar County, MS",MS,2019,31074,29752,1322,4.3,488
"Lamar County, MS",MS,2018,30586,29429,1157,3.8,490
"Lamar County, MS",MS,2017,30096,28912,1184,3.9,632
"Lamar County, MS",MS,2016,29464,28097,1367,4.6,657
"Lamar County, MS",MS,2015,28807,27400,1407,4.9,1126
"Lamar County, MS",MS,2014,27681,26247,1434,5.2,133
"Lamar County, MS",MS,2013,27548,25929,1619,5.9,-908
"Lamar County, MS",MS,2012,28456,26659,1797,6.3,-139
"Lamar County, MS",MS,2011,28595,26602,1993,7.0,855
"Lamar County, MS",MS,2010,27740,25805,1935,7.0,0
"Lamar County, TX",TX,2021,24493,23149,1344,5.5,1115
"Lamar County, TX",TX,2020,23378,21875,1503,6.4,-275
"Lamar County, TX",TX,2019,23653,22853,800,3.4,115
"Lamar County, TX",TX,2018,23538,22641,897,3.8,-40
"Lamar County, TX",TX,2017,23578,22581,997,4.2,340
"Lamar County, TX",TX,2016,23238,22161,1077,4.6,1041
"Lamar County, TX",TX,2015,22197,21125,1072,4.8,81
"Lamar County, TX",TX,2014,22116,20749,1367,6.2,-148
"Lamar County, TX",TX,2013,22264,20445,1819,8.2,-324
"Lamar County, TX",TX,2012,22588,20520,2068,9.2,-800
"Lamar County, TX",TX,2011,23388,21028,2360,10.1,54
"Lamar County, TX",TX,2010,23334,21156,2178,9.3,0
"Lamb County, TX",TX,2021,5211,4951,260,5.0,45
"Lamb County, TX",TX,2020,5166,4897,269,5.2,-38
"Lamb County, TX",TX,2019,5204,5006,198,3.8,44
"Lamb County, TX",TX,2018,5160,4931,229,4.4,7
"Lamb County, TX",TX,2017,5153,4885,268,5.2,-96
"Lamb County, TX",TX,2016,5249,4908,341,6.5,-264
"Lamb County, TX",TX,2015,5513,5017,496,9.0,-509
"Lamb County, TX",TX,2014,6022,5667,355,5.9,-114
"Lamb County, TX",TX,2013,6136,5713,423,6.9,-313
"Lamb County, TX",TX,2012,6449,5939,510,7.9,-278
"Lamb County, TX",TX,2011,6727,6202,525,7.8,-79
"Lamb County, TX",TX,2010,6806,6289,517,7.6,0
"Lamoille County, VT",VT,2021,13380,12841,539,4.0,-534
"Lamoille County, VT",VT,2020,13914,12838,1076,7.7,-550
"Lamoille County, VT",VT,2019,14464,14022,442,3.1,42
"Lamoille County, VT",VT,2018,14422,13920,502,3.5,-49
"Lamoille County, VT",VT,2017,14471,13893,578,4.0,510
"Lamoille County, VT",VT,2016,13961,13389,572,4.1,113
"Lamoille County, VT",VT,2015,13848,13212,636,4.6,30
"Lamoille County, VT",VT,2014,13818,13103,715,5.2,-55
"Lamoille County, VT",VT,2013,13873,13084,789,5.7,-124
"Lamoille County, VT",VT,2012,13997,13132,865,6.2,-540
"Lamoille County, VT",VT,2011,14537,13513,1024,7.0,19
"Lamoille County, VT",VT,2010,14518,13371,1147,7.9,0
"LaMoure County, ND",ND,2021,2043,1997,46,2.3,-28
"LaMoure County, ND",ND,2020,2071,2016,55,2.7,-20
"LaMoure County, ND",ND,2019,2091,2052,39,1.9,-63
"LaMoure County, ND",ND,2018,2154,2116,38,1.8,-143
"LaMoure County, ND",ND,2017,2297,2254,43,1.9,-13
"LaMoure County, ND",ND,2016,2310,2255,55,2.4,57
"LaMoure County, ND",ND,2015,2253,2197,56,2.5,20
"LaMoure County, ND",ND,2014,2233,2180,53,2.4,21
"LaMoure County, ND",ND,2013,2212,2162,50,2.3,-53
"LaMoure County, ND",ND,2012,2265,2210,55,2.4,-126
"LaMoure County, ND",ND,2011,2391,2322,69,2.9,-94
"LaMoure County, ND",ND,2010,2485,2399,86,3.5,0
"Lampasas County, TX",TX,2021,9291,8845,446,4.8,328
"Lampasas County, TX",TX,2020,8963,8483,480,5.4,-42
"Lampasas County, TX",TX,2019,9005,8705,300,3.3,-57
"Lampasas County, TX",TX,2018,9062,8721,341,3.8,-83
"Lampasas County, TX",TX,2017,9145,8800,345,3.8,-19
"Lampasas County, TX",TX,2016,9164,8783,381,4.2,105
"Lampasas County, TX",TX,2015,9059,8658,401,4.4,104
"Lampasas County, TX",TX,2014,8955,8446,509,5.7,-159
"Lampasas County, TX",TX,2013,9114,8456,658,7.2,42
"Lampasas County, TX",TX,2012,9072,8428,644,7.1,-62
"Lampasas County, TX",TX,2011,9134,8421,713,7.8,102
"Lampasas County, TX",TX,2010,9032,8387,645,7.1,0
"Lancaster County, NE",NE,2021,178631,174272,4359,2.4,241
"Lancaster County, NE",NE,2020,178390,171029,7361,4.1,-1087
"Lancaster County, NE",NE,2019,179477,174514,4963,2.8,2916
"Lancaster County, NE",NE,2018,176561,171912,4649,2.6,4437
"Lancaster County, NE",NE,2017,172124,167501,4623,2.7,2143
"Lancaster County, NE",NE,2016,169981,165281,4700,2.8,1807
"Lancaster County, NE",NE,2015,168174,163746,4428,2.6,91
"Lancaster County, NE",NE,2014,168083,163106,4977,3.0,-293
"Lancaster County, NE",NE,2013,168376,162683,5693,3.4,1108
"Lancaster County, NE",NE,2012,167268,161395,5873,3.5,3050
"Lancaster County, NE",NE,2011,164218,157636,6582,4.0,1892
"Lancaster County, NE",NE,2010,162326,155360,6966,4.3,0
"Lancaster County, PA",PA,2021,284893,270883,14010,4.9,-594
"Lancaster County, PA",PA,2020,285487,264119,21368,7.5,-2891
"Lancaster County, PA",PA,2019,288378,278164,10214,3.5,3076
"Lancaster County, PA",PA,2018,285302,275237,10065,3.5,3757
"Lancaster County, PA",PA,2017,281545,270538,11007,3.9,3244
"Lancaster County, PA",PA,2016,278301,266858,11443,4.1,2273
"Lancaster County, PA",PA,2015,276028,264467,11561,4.2,3769
"Lancaster County, PA",PA,2014,272259,259550,12709,4.7,2604
"Lancaster County, PA",PA,2013,269655,253945,15710,5.8,955
"Lancaster County, PA",PA,2012,268700,251573,17127,6.4,3208
"Lancaster County, PA",PA,2011,265492,247641,17851,6.7,-1730
"Lancaster County, PA",PA,2010,267222,247815,19407,7.3,0
"Lancaster County, SC",SC,2021,42926,41056,1870,4.4,754
"Lancaster County, SC",SC,2020,42172,39386,2786,6.6,1325
"Lancaster County, SC",SC,2019,40847,39502,1345,3.3,1598
"Lancaster County, SC",SC,2018,39249,37781,1468,3.7,685
"Lancaster County, SC",SC,2017,38564,36799,1765,4.6,342
"Lancaster County, SC",SC,2016,38222,36233,1989,5.2,1538
"Lancaster County, SC",SC,2015,36684,34401,2283,6.2,1423
"Lancaster County, SC",SC,2014,35261,32785,2476,7.0,862
"Lancaster County, SC",SC,2013,34399,31284,3115,9.1,13
"Lancaster County, SC",SC,2012,34386,30590,3796,11.0,94
"Lancaster County, SC",SC,2011,34292,29777,4515,13.2,21
"Lancaster County, SC",SC,2010,34271,29158,5113,14.9,0
"Lancaster County, VA",VA,2021,5244,4964,280,5.3,-116
"Lancaster County, VA",VA,2020,5360,4971,389,7.3,-111
"Lancaster County, VA",VA,2019,5471,5237,234,4.3,127
"Lancaster County, VA",VA,2018,5344,5113,231,4.3,-40
"Lancaster County, VA",VA,2017,5384,5105,279,5.2,269
"Lancaster County, VA",VA,2016,5115,4832,283,5.5,-32
"Lancaster County, VA",VA,2015,5147,4813,334,6.5,-217
"Lancaster County, VA",VA,2014,5364,4961,403,7.5,-35
"Lancaster County, VA",VA,2013,5399,5003,396,7.3,-113
"Lancaster County, VA",VA,2012,5512,5081,431,7.8,-69
"Lancaster County, VA",VA,2011,5581,5065,516,9.2,2
"Lancaster County, VA",VA,2010,5579,5021,558,10.0,0
"Lander County, NV",NV,2021,3180,3066,114,3.6,52
"Lander County, NV",NV,2020,3128,2974,154,4.9,-107
"Lander County, NV",NV,2019,3235,3131,104,3.2,114
"Lander County, NV",NV,2018,3121,3012,109,3.5,36
"Lander County, NV",NV,2017,3085,2945,140,4.5,-21
"Lander County, NV",NV,2016,3106,2909,197,6.3,-87
"Lander County, NV",NV,2015,3193,2975,218,6.8,-99
"Lander County, NV",NV,2014,3292,3064,228,6.9,-196
"Lander County, NV",NV,2013,3488,3221,267,7.7,79
"Lander County, NV",NV,2012,3409,3142,267,7.8,217
"Lander County, NV",NV,2011,3192,2900,292,9.1,150
"Lander County, NV",NV,2010,3042,2742,300,9.9,0
"Lane County, KS",KS,2021,747,732,15,2.0,-8
"Lane County, KS",KS,2020,755,734,21,2.8,-21
"Lane County, KS",KS,2019,776,756,20,2.6,-18
"Lane County, KS",KS,2018,794,772,22,2.8,5
"Lane County, KS",KS,2017,789,763,26,3.3,-25
"Lane County, KS",KS,2016,814,789,25,3.1,-66
"Lane County, KS",KS,2015,880,851,29,3.3,15
"Lane County, KS",KS,2014,865,837,28,3.2,-20
"Lane County, KS",KS,2013,885,854,31,3.5,-19
"Lane County, KS",KS,2012,904,862,42,4.6,-60
"Lane County, KS",KS,2011,964,920,44,4.6,-22
"Lane County, KS",KS,2010,986,945,41,4.2,0
"Lane County, OR",OR,2021,182197,172142,10055,5.5,3056
"Lane County, OR",OR,2020,179141,165033,14108,7.9,-881
"Lane County, OR",OR,2019,180022,172839,7183,4.0,159
"Lane County, OR",OR,2018,179863,172070,7793,4.3,-448
"Lane County, OR",OR,2017,180311,172433,7878,4.4,2264
"Lane County, OR",OR,2016,178047,169145,8902,5.0,5412
"Lane County, OR",OR,2015,172635,162845,9790,5.7,2317
"Lane County, OR",OR,2014,170318,158772,11546,6.8,1547
"Lane County, OR",OR,2013,168771,155425,13346,7.9,-4473
"Lane County, OR",OR,2012,173244,157828,15416,8.9,-4419
"Lane County, OR",OR,2011,177663,160310,17353,9.8,-1325
"Lane County, OR",OR,2010,178988,159101,19887,11.1,0
"Langlade County, WI",WI,2021,9521,9091,430,4.5,119
"Langlade County, WI",WI,2020,9402,8789,613,6.5,64
"Langlade County, WI",WI,2019,9338,8969,369,4.0,-177
"Langlade County, WI",WI,2018,9515,9141,374,3.9,-156
"Langlade County, WI",WI,2017,9671,9266,405,4.2,123
"Langlade County, WI",WI,2016,9548,9064,484,5.1,101
"Langlade County, WI",WI,2015,9447,8886,561,5.9,-105
"Langlade County, WI",WI,2014,9552,8843,709,7.4,-256
"Langlade County, WI",WI,2013,9808,8923,885,9.0,-149
"Langlade County, WI",WI,2012,9957,9046,911,9.1,-75
"Langlade County, WI",WI,2011,10032,9042,990,9.9,-148
"Langlade County, WI",WI,2010,10180,9083,1097,10.8,0
"Lanier County, GA",GA,2021,3850,3703,147,3.8,49
"Lanier County, GA",GA,2020,3801,3602,199,5.2,16
"Lanier County, GA",GA,2019,3785,3628,157,4.1,-17
"Lanier County, GA",GA,2018,3802,3630,172,4.5,-82
"Lanier County, GA",GA,2017,3884,3684,200,5.1,56
"Lanier County, GA",GA,2016,3828,3604,224,5.9,88
"Lanier County, GA",GA,2015,3740,3486,254,6.8,-47
"Lanier County, GA",GA,2014,3787,3480,307,8.1,-50
"Lanier County, GA",GA,2013,3837,3511,326,8.5,-59
"Lanier County, GA",GA,2012,3896,3537,359,9.2,-48
"Lanier County, GA",GA,2011,3944,3533,411,10.4,59
"Lanier County, GA",GA,2010,3885,3468,417,10.7,0
"Lapeer County, MI",MI,2021,40133,37704,2429,6.1,-388
"Lapeer County, MI",MI,2020,40521,35571,4950,12.2,-1353
"Lapeer County, MI",MI,2019,41874,39637,2237,5.3,343
"Lapeer County, MI",MI,2018,41531,39360,2171,5.2,102
"Lapeer County, MI",MI,2017,41429,39141,2288,5.5,751
"Lapeer County, MI",MI,2016,40678,38080,2598,6.4,1091
"Lapeer County, MI",MI,2015,39587,36768,2819,7.1,-258
"Lapeer County, MI",MI,2014,39845,36049,3796,9.5,-532
"Lapeer County, MI",MI,2013,40377,35796,4581,11.3,571
"Lapeer County, MI",MI,2012,39806,35196,4610,11.6,143
"Lapeer County, MI",MI,2011,39663,34589,5074,12.8,-1290
"Lapeer County, MI",MI,2010,40953,34495,6458,15.8,0
"LaPorte County, IN",IN,2021,46208,43873,2335,5.1,-1153
"LaPorte County, IN",IN,2020,47361,42770,4591,9.7,-260
"LaPorte County, IN",IN,2019,47621,45604,2017,4.2,-509
"LaPorte County, IN",IN,2018,48130,46059,2071,4.3,325
"LaPorte County, IN",IN,2017,47805,45695,2110,4.4,-884
"LaPorte County, IN",IN,2016,48689,45863,2826,5.8,181
"LaPorte County, IN",IN,2015,48508,45486,3022,6.2,-390
"LaPorte County, IN",IN,2014,48898,45175,3723,7.6,-101
"LaPorte County, IN",IN,2013,48999,44520,4479,9.1,-731
"LaPorte County, IN",IN,2012,49730,44948,4782,9.6,-825
"LaPorte County, IN",IN,2011,50555,45414,5141,10.2,-770
"LaPorte County, IN",IN,2010,51325,45305,6020,11.7,0
"Laramie County, WY",WY,2021,49373,47397,1976,4.0,-741
"Laramie County, WY",WY,2020,50114,47565,2549,5.1,662
"Laramie County, WY",WY,2019,49452,47695,1757,3.6,1042
"Laramie County, WY",WY,2018,48410,46535,1875,3.9,68
"Laramie County, WY",WY,2017,48342,46519,1823,3.8,-461
"Laramie County, WY",WY,2016,48803,46765,2038,4.2,578
"Laramie County, WY",WY,2015,48225,46341,1884,3.9,9
"Laramie County, WY",WY,2014,48216,46027,2189,4.5,327
"Laramie County, WY",WY,2013,47889,45571,2318,4.8,721
"Laramie County, WY",WY,2012,47168,44376,2792,5.9,583
"Laramie County, WY",WY,2011,46585,43522,3063,6.6,614
"Laramie County, WY",WY,2010,45971,42668,3303,7.2,0
"Lares Municipio, PR",PR,2021,7483,6456,1027,13.7,
"Lares Municipio, PR",PR,2020,N.A.,N.A.,N.A.,N.A.,
"Lares Municipio, PR",PR,2019,6963,5937,1026,14.7,-12
"Lares Municipio, PR",PR,2018,6975,5847,1128,16.2,-260
"Lares Municipio, PR",PR,2017,7235,5888,1347,18.6,-177
"Lares Municipio, PR",PR,2016,7412,5980,1432,19.3,54
"Lares Municipio, PR",PR,2015,7358,5860,1498,20.4,-229
"Lares Municipio, PR",PR,2014,7587,5819,1768,23.3,-505
"Lares Municipio, PR",PR,2013,8092,6088,2004,24.8,364
"Lares Municipio, PR",PR,2012,7728,6217,1511,19.6,-192
"Lares Municipio, PR",PR,2011,7920,6278,1642,20.7,-132
"Lares Municipio, PR",PR,2010,8052,6446,1606,19.9,0
"Larimer County, CO",CO,2021,206492,196875,9617,4.7,5219
"Larimer County, CO",CO,2020,201273,189216,12057,6.0,-1801
"Larimer County, CO",CO,2019,203074,198526,4548,2.2,3760
"Larimer County, CO",CO,2018,199314,194154,5160,2.6,5799
"Larimer County, CO",CO,2017,193515,189157,4358,2.3,6115
"Larimer County, CO",CO,2016,187400,182374,5026,2.7,6778
"Larimer County, CO",CO,2015,180622,174867,5755,3.2,3598
"Larimer County, CO",CO,2014,177024,169514,7510,4.2,2894
"Larimer County, CO",CO,2013,174130,164174,9956,5.7,1772
"Larimer County, CO",CO,2012,172358,160643,11715,6.8,1831
"Larimer County, CO",CO,2011,170527,157831,12696,7.4,1088
"Larimer County, CO",CO,2010,169439,155799,13640,8.1,0
"Larue County, KY",KY,2021,5803,5517,286,4.9,-38
"Larue County, KY",KY,2020,5841,5432,409,7.0,-165
"Larue County, KY",KY,2019,6006,5750,256,4.3,34
"Larue County, KY",KY,2018,5972,5713,259,4.3,-47
"Larue County, KY",KY,2017,6019,5741,278,4.6,119
"Larue County, KY",KY,2016,5900,5632,268,4.5,42
"Larue County, KY",KY,2015,5858,5563,295,5.0,90
"Larue County, KY",KY,2014,5768,5389,379,6.6,-123
"Larue County, KY",KY,2013,5891,5413,478,8.1,-61
"Larue County, KY",KY,2012,5952,5439,513,8.6,-110
"Larue County, KY",KY,2011,6062,5456,606,10.0,-33
"Larue County, KY",KY,2010,6095,5401,694,11.4,0
"Las Animas County, CO",CO,2021,6513,6087,426,6.5,115
"Las Animas County, CO",CO,2020,6398,5947,451,7.0,-82
"Las Animas County, CO",CO,2019,6480,6240,240,3.7,-3
"Las Animas County, CO",CO,2018,6483,6202,281,4.3,283
"Las Animas County, CO",CO,2017,6200,5970,230,3.7,17
"Las Animas County, CO",CO,2016,6183,5884,299,4.8,59
"Las Animas County, CO",CO,2015,6124,5793,331,5.4,-298
"Las Animas County, CO",CO,2014,6422,5940,482,7.5,-305
"Las Animas County, CO",CO,2013,6727,5988,739,11.0,-220
"Las Animas County, CO",CO,2012,6947,6102,845,12.2,-26
"Las Animas County, CO",CO,2011,6973,6174,799,11.5,-205
"Las Animas County, CO",CO,2010,7178,6381,797,11.1,0
"Las Marias Municipio, PR",PR,2021,2872,2531,341,11.9,
"Las Marias Municipio, PR",PR,2020,N.A.,N.A.,N.A.,N.A.,
"Las Marias Municipio, PR",PR,2019,2672,2365,307,11.5,52
"Las Marias Municipio, PR",PR,2018,2620,2250,370,14.1,-182
"Las Marias Municipio, PR",PR,2017,2802,2224,578,20.6,-63
"Las Marias Municipio, PR",PR,2016,2865,2439,426,14.9,-22
"Las Marias Municipio, PR",PR,2015,2887,2401,486,16.8,-14
"Las Marias Municipio, PR",PR,2014,2901,2167,734,25.3,-205
"Las Marias Municipio, PR",PR,2013,3106,2357,749,24.1,-603
"Las Marias Municipio, PR",PR,2012,3709,3108,601,16.2,-219
"Las Marias Municipio, PR",PR,2011,3928,3269,659,16.8,258
"Las Marias Municipio, PR",PR,2010,3670,2997,673,18.3,0
"Las Piedras Municipio, PR",PR,2021,12197,11265,932,7.6,
"Las Piedras Municipio, PR",PR,2020,N.A.,N.A.,N.A.,N.A.,
"Las Piedras Municipio, PR",PR,2019,11417,10404,1013,8.9,270
"Las Piedras Municipio, PR",PR,2018,11147,10070,1077,9.7,-97
"Las Piedras Municipio, PR",PR,2017,11244,9897,1347,12.0,-121
"Las Piedras Municipio, PR",PR,2016,11365,9835,1530,13.5,15
"Las Piedras Municipio, PR",PR,2015,11350,9757,1593,14.0,-71
"Las Piedras Municipio, PR",PR,2014,11421,9580,1841,16.1,-373
"Las Piedras Municipio, PR",PR,2013,11794,9724,2070,17.6,-269
"Las Piedras Municipio, PR",PR,2012,12063,9790,2273,18.8,66
"Las Piedras Municipio, PR",PR,2011,11997,9691,2306,19.2,-274
"Las Piedras Municipio, PR",PR,2010,12271,9883,2388,19.5,0
"LaSalle County, IL",IL,2021,52681,49536,3145,6.0,12
"LaSalle County, IL",IL,2020,52669,47627,5042,9.6,-2095
"LaSalle County, IL",IL,2019,54764,51979,2785,5.1,-1439
"LaSalle County, IL",IL,2018,56203,52986,3217,5.7,26
"LaSalle County, IL",IL,2017,56177,53036,3141,5.6,-1171
"LaSalle County, IL",IL,2016,57348,53477,3871,6.8,-160
"LaSalle County, IL",IL,2015,57508,53493,4015,7.0,294
"LaSalle County, IL",IL,2014,57214,52516,4698,8.2,-854
"LaSalle County, IL",IL,2013,58068,52085,5983,10.3,-1232
"LaSalle County, IL",IL,2012,59300,53306,5994,10.1,-1550
"LaSalle County, IL",IL,2011,60850,54331,6519,10.7,-932
"LaSalle County, IL",IL,2010,61782,54282,7500,12.1,0
"LaSalle Parish, LA",LA,2021,6677,6458,219,3.3,-150
"LaSalle Parish, LA",LA,2020,6827,6475,352,5.2,75
"LaSalle Parish, LA",LA,2019,6752,6474,278,4.1,378
"LaSalle Parish, LA",LA,2018,6374,6100,274,4.3,222
"LaSalle Parish, LA",LA,2017,6152,5864,288,4.7,-126
"LaSalle Parish, LA",LA,2016,6278,5862,416,6.6,-302
"LaSalle Parish, LA",LA,2015,6580,6128,452,6.9,-22
"LaSalle Parish, LA",LA,2014,6602,6264,338,5.1,-380
"LaSalle Parish, LA",LA,2013,6982,6648,334,4.8,207
"LaSalle Parish, LA",LA,2012,6775,6447,328,4.8,55
"LaSalle Parish, LA",LA,2011,6720,6355,365,5.4,275
"LaSalle Parish, LA",LA,2010,6445,6049,396,6.1,0
"Lassen County, CA",CA,2021,9159,8615,544,5.9,-234
"Lassen County, CA",CA,2020,9393,8694,699,7.4,-339
"Lassen County, CA",CA,2019,9732,9275,457,4.7,-122
"Lassen County, CA",CA,2018,9854,9376,478,4.9,-171
"Lassen County, CA",CA,2017,10025,9469,556,5.5,-338
"Lassen County, CA",CA,2016,10363,9642,721,7.0,-397
"Lassen County, CA",CA,2015,10760,9978,782,7.3,-38
"Lassen County, CA",CA,2014,10798,9803,995,9.2,-170
"Lassen County, CA",CA,2013,10968,9791,1177,10.7,-483
"Lassen County, CA",CA,2012,11451,10002,1449,12.7,-320
"Lassen County, CA",CA,2011,11771,10150,1621,13.8,-346
"Lassen County, CA",CA,2010,12117,10374,1743,14.4,0
"Latah County, ID",ID,2021,19857,19197,660,3.3,112
"Latah County, ID",ID,2020,19745,18787,958,4.9,-895
"Latah County, ID",ID,2019,20640,20082,558,2.7,328
"Latah County, ID",ID,2018,20312,19799,513,2.5,125
"Latah County, ID",ID,2017,20187,19649,538,2.7,295
"Latah County, ID",ID,2016,19892,19281,611,3.1,393
"Latah County, ID",ID,2015,19499,18875,624,3.2,270
"Latah County, ID",ID,2014,19229,18526,703,3.7,-335
"Latah County, ID",ID,2013,19564,18492,1072,5.5,-132
"Latah County, ID",ID,2012,19696,18522,1174,6.0,465
"Latah County, ID",ID,2011,19231,18050,1181,6.1,-77
"Latah County, ID",ID,2010,19308,18066,1242,6.4,0
"Latimer County, OK",OK,2021,3086,2861,225,7.3,-52
"Latimer County, OK",OK,2020,3138,2816,322,10.3,28
"Latimer County, OK",OK,2019,3110,2924,186,6.0,-91
"Latimer County, OK",OK,2018,3201,3017,184,5.7,-176
"Latimer County, OK",OK,2017,3377,3137,240,7.1,-339
"Latimer County, OK",OK,2016,3716,3406,310,8.3,-139
"Latimer County, OK",OK,2015,3855,3550,305,7.9,-98
"Latimer County, OK",OK,2014,3953,3671,282,7.1,-180
"Latimer County, OK",OK,2013,4133,3778,355,8.6,-393
"Latimer County, OK",OK,2012,4526,4154,372,8.2,114
"Latimer County, OK",OK,2011,4412,3994,418,9.5,-150
"Latimer County, OK",OK,2010,4562,4121,441,9.7,0
"Lauderdale County, AL",AL,2021,42080,40745,1335,3.2,-569
"Lauderdale County, AL",AL,2020,42649,40026,2623,6.2,-462
"Lauderdale County, AL",AL,2019,43111,41623,1488,3.5,263
"Lauderdale County, AL",AL,2018,42848,41068,1780,4.2,309
"Lauderdale County, AL",AL,2017,42539,40520,2019,4.7,359
"Lauderdale County, AL",AL,2016,42180,39490,2690,6.4,-364
"Lauderdale County, AL",AL,2015,42544,39577,2967,7.0,-1007
"Lauderdale County, AL",AL,2014,43551,40434,3117,7.2,442
"Lauderdale County, AL",AL,2013,43109,39999,3110,7.2,-342
"Lauderdale County, AL",AL,2012,43451,40035,3416,7.9,-595
"Lauderdale County, AL",AL,2011,44046,40045,4001,9.1,424
"Lauderdale County, AL",AL,2010,43622,39278,4344,10.0,0
"Lauderdale County, MS",MS,2021,29077,27504,1573,5.4,-138
"Lauderdale County, MS",MS,2020,29215,27065,2150,7.4,-1132
"Lauderdale County, MS",MS,2019,30347,28678,1669,5.5,-389
"Lauderdale County, MS",MS,2018,30736,29162,1574,5.1,-988
"Lauderdale County, MS",MS,2017,31724,29988,1736,5.5,85
"Lauderdale County, MS",MS,2016,31639,29740,1899,6.0,77
"Lauderdale County, MS",MS,2015,31562,29466,2096,6.6,-902
"Lauderdale County, MS",MS,2014,32464,30006,2458,7.6,-2136
"Lauderdale County, MS",MS,2013,34600,31730,2870,8.3,-340
"Lauderdale County, MS",MS,2012,34940,31846,3094,8.9,488
"Lauderdale County, MS",MS,2011,34452,31008,3444,10.0,1339
"Lauderdale County, MS",MS,2010,33113,29694,3419,10.3,0
"Lauderdale County, TN",TN,2021,9621,9047,574,6.0,-69
"Lauderdale County, TN",TN,2020,9690,8847,843,8.7,-63
"Lauderdale County, TN",TN,2019,9753,9225,528,5.4,65
"Lauderdale County, TN",TN,2018,9688,9127,561,5.8,279
"Lauderdale County, TN",TN,2017,9409,8865,544,5.8,-33
"Lauderdale County, TN",TN,2016,9442,8710,732,7.8,-171
"Lauderdale County, TN",TN,2015,9613,8769,844,8.8,-233
"Lauderdale County, TN",TN,2014,9846,8877,969,9.8,-414
"Lauderdale County, TN",TN,2013,10260,9065,1195,11.6,-255
"Lauderdale County, TN",TN,2012,10515,9349,1166,11.1,-112
"Lauderdale County, TN",TN,2011,10627,9287,1340,12.6,-173
"Lauderdale County, TN",TN,2010,10800,9241,1559,14.4,0
"Laurel County, KY",KY,2021,25250,24111,1139,4.5,332
"Laurel County, KY",KY,2020,24918,23247,1671,6.7,22
"Laurel County, KY",KY,2019,24896,23750,1146,4.6,103
"Laurel County, KY",KY,2018,24793,23558,1235,5.0,129
"Laurel County, KY",KY,2017,24664,23243,1421,5.8,751
"Laurel County, KY",KY,2016,23913,22450,1463,6.1,534
"Laurel County, KY",KY,2015,23379,21933,1446,6.2,-758
"Laurel County, KY",KY,2014,24137,22302,1835,7.6,-508
"Laurel County, KY",KY,2013,24645,22266,2379,9.7,-267
"Laurel County, KY",KY,2012,24912,22360,2552,10.2,-131
"Laurel County, KY",KY,2011,25043,22176,2867,11.4,-40
"Laurel County, KY",KY,2010,25083,22197,2886,11.5,0
"Laurens County, GA",GA,2021,19818,18974,844,4.3,538
"Laurens County, GA",GA,2020,19280,18000,1280,6.6,-310
"Laurens County, GA",GA,2019,19590,18664,926,4.7,89
"Laurens County, GA",GA,2018,19501,18552,949,4.9,32
"Laurens County, GA",GA,2017,19469,18315,1154,5.9,403
"Laurens County, GA",GA,2016,19066,17781,1285,6.7,632
"Laurens County, GA",GA,2015,18434,17018,1416,7.7,-570
"Laurens County, GA",GA,2014,19004,17244,1760,9.3,-391
"Laurens County, GA",GA,2013,19395,17319,2076,10.7,-326
"Laurens County, GA",GA,2012,19721,17338,2383,12.1,-537
"Laurens County, GA",GA,2011,20258,17475,2783,13.7,-406
"Laurens County, GA",GA,2010,20664,17901,2763,13.4,0
"Laurens County, SC",SC,2021,29708,28428,1280,4.3,423
"Laurens County, SC",SC,2020,29285,27330,1955,6.7,-65
"Laurens County, SC",SC,2019,29350,28494,856,2.9,177
"Laurens County, SC",SC,2018,29173,28144,1029,3.5,-55
"Laurens County, SC",SC,2017,29228,27967,1261,4.3,-715
"Laurens County, SC",SC,2016,29943,28417,1526,5.1,-326
"Laurens County, SC",SC,2015,30269,28302,1967,6.5,391
"Laurens County, SC",SC,2014,29878,27818,2060,6.9,-99
"Laurens County, SC",SC,2013,29977,27475,2502,8.3,-94
"Laurens County, SC",SC,2012,30071,27038,3033,10.1,-419
"Laurens County, SC",SC,2011,30490,26983,3507,11.5,25
"Laurens County, SC",SC,2010,30465,26667,3798,12.5,0
"Lavaca County, TX",TX,2021,8640,8253,387,4.5,299
"Lavaca County, TX",TX,2020,8341,7905,436,5.2,-182
"Lavaca County, TX",TX,2019,8523,8270,253,3.0,-177
"Lavaca County, TX",TX,2018,8700,8427,273,3.1,31
"Lavaca County, TX",TX,2017,8669,8354,315,3.6,-77
"Lavaca County, TX",TX,2016,8746,8376,370,4.2,-62
"Lavaca County, TX",TX,2015,8808,8472,336,3.8,-153
"Lavaca County, TX",TX,2014,8961,8605,356,4.0,-249
"Lavaca County, TX",TX,2013,9210,8775,435,4.7,-250
"Lavaca County, TX",TX,2012,9460,9006,454,4.8,-151
"Lavaca County, TX",TX,2011,9611,9021,590,6.1,-104
"Lavaca County, TX",TX,2010,9715,9041,674,6.9,0
"Lawrence County, AL",AL,2021,14378,13956,422,2.9,-150
"Lawrence County, AL",AL,2020,14528,13736,792,5.5,76
"Lawrence County, AL",AL,2019,14452,13973,479,3.3,256
"Lawrence County, AL",AL,2018,14196,13610,586,4.1,401
"Lawrence County, AL",AL,2017,13795,13099,696,5.0,188
"Lawrence County, AL",AL,2016,13607,12665,942,6.9,-35
"Lawrence County, AL",AL,2015,13642,12582,1060,7.8,-404
"Lawrence County, AL",AL,2014,14046,12896,1150,8.2,-227
"Lawrence County, AL",AL,2013,14273,13066,1207,8.5,-135
"Lawrence County, AL",AL,2012,14408,13078,1330,9.2,-367
"Lawrence County, AL",AL,2011,14775,13183,1592,10.8,-117
"Lawrence County, AL",AL,2010,14892,13052,1840,12.4,0
"Lawrence County, AR",AR,2021,6700,6414,286,4.3,-97
"Lawrence County, AR",AR,2020,6797,6377,420,6.2,-45
"Lawrence County, AR",AR,2019,6842,6566,276,4.0,22
"Lawrence County, AR",AR,2018,6820,6556,264,3.9,-36
"Lawrence County, AR",AR,2017,6856,6596,260,3.8,-73
"Lawrence County, AR",AR,2016,6929,6628,301,4.3,-146
"Lawrence County, AR",AR,2015,7075,6655,420,5.9,-54
"Lawrence County, AR",AR,2014,7129,6625,504,7.1,-59
"Lawrence County, AR",AR,2013,7188,6567,621,8.6,-112
"Lawrence County, AR",AR,2012,7300,6664,636,8.7,-174
"Lawrence County, AR",AR,2011,7474,6772,702,9.4,41
"Lawrence County, AR",AR,2010,7433,6752,681,9.2,0
"Lawrence County, IL",IL,2021,5602,5261,341,6.1,-145
"Lawrence County, IL",IL,2020,5747,5226,521,9.1,-173
"Lawrence County, IL",IL,2019,5920,5608,312,5.3,-116
"Lawrence County, IL",IL,2018,6036,5663,373,6.2,-59
"Lawrence County, IL",IL,2017,6095,5705,390,6.4,-105
"Lawrence County, IL",IL,2016,6200,5741,459,7.4,45
"Lawrence County, IL",IL,2015,6155,5717,438,7.1,-192
"Lawrence County, IL",IL,2014,6347,5850,497,7.8,24
"Lawrence County, IL",IL,2013,6323,5679,644,10.2,-130
"Lawrence County, IL",IL,2012,6453,5791,662,10.3,-122
"Lawrence County, IL",IL,2011,6575,5871,704,10.7,-119
"Lawrence County, IL",IL,2010,6694,5971,723,10.8,0
"Lawrence County, IN",IN,2021,20729,20007,722,3.5,47
"Lawrence County, IN",IN,2020,20682,19223,1459,7.1,-509
"Lawrence County, IN",IN,2019,21191,20437,754,3.6,40
"Lawrence County, IN",IN,2018,21151,20350,801,3.8,336
"Lawrence County, IN",IN,2017,20815,19911,904,4.3,204
"Lawrence County, IN",IN,2016,20611,19455,1156,5.6,338
"Lawrence County, IN",IN,2015,20273,18953,1320,6.5,-117
"Lawrence County, IN",IN,2014,20390,18747,1643,8.1,-291
"Lawrence County, IN",IN,2013,20681,18630,2051,9.9,118
"Lawrence County, IN",IN,2012,20563,18341,2222,10.8,-261
"Lawrence County, IN",IN,2011,20824,18454,2370,11.4,105
"Lawrence County, IN",IN,2010,20719,18158,2561,12.4,0
"Lawrence County, KY",KY,2021,5340,4998,342,6.4,134
"Lawrence County, KY",KY,2020,5206,4788,418,8.0,14
"Lawrence County, KY",KY,2019,5192,4848,344,6.6,132
"Lawrence County, KY",KY,2018,5060,4703,357,7.1,57
"Lawrence County, KY",KY,2017,5003,4557,446,8.9,-36
"Lawrence County, KY",KY,2016,5039,4496,543,10.8,70
"Lawrence County, KY",KY,2015,4969,4499,470,9.5,-307
"Lawrence County, KY",KY,2014,5276,4773,503,9.5,-302
"Lawrence County, KY",KY,2013,5578,4957,621,11.1,-61
"Lawrence County, KY",KY,2012,5639,5039,600,10.6,-148
"Lawrence County, KY",KY,2011,5787,5111,676,11.7,-13
"Lawrence County, KY",KY,2010,5800,5003,797,13.7,0
"Lawrence County, MO",MO,2021,17457,16752,705,4.0,-161
"Lawrence County, MO",MO,2020,17618,16553,1065,6.0,-266
"Lawrence County, MO",MO,2019,17884,17289,595,3.3,-163
"Lawrence County, MO",MO,2018,18047,17505,542,3.0,208
"Lawrence County, MO",MO,2017,17839,17210,629,3.5,73
"Lawrence County, MO",MO,2016,17766,16992,774,4.4,-7
"Lawrence County, MO",MO,2015,17773,16885,888,5.0,360
"Lawrence County, MO",MO,2014,17413,16383,1030,5.9,40
"Lawrence County, MO",MO,2013,17373,16216,1157,6.7,179
"Lawrence County, MO",MO,2012,17194,16037,1157,6.7,-118
"Lawrence County, MO",MO,2011,17312,15842,1470,8.5,-171
"Lawrence County, MO",MO,2010,17483,15870,1613,9.2,0
"Lawrence County, MS",MS,2021,4613,4294,319,6.9,9
"Lawrence County, MS",MS,2020,4604,4212,392,8.5,-34
"Lawrence County, MS",MS,2019,4638,4319,319,6.9,1
"Lawrence County, MS",MS,2018,4637,4355,282,6.1,-41
"Lawrence County, MS",MS,2017,4678,4364,314,6.7,23
"Lawrence County, MS",MS,2016,4655,4317,338,7.3,-77
"Lawrence County, MS",MS,2015,4732,4386,346,7.3,226
"Lawrence County, MS",MS,2014,4506,4128,378,8.4,-213
"Lawrence County, MS",MS,2013,4719,4285,434,9.2,-274
"Lawrence County, MS",MS,2012,4993,4489,504,10.1,-94
"Lawrence County, MS",MS,2011,5087,4509,578,11.4,-69
"Lawrence County, MS",MS,2010,5156,4558,598,11.6,0
"Lawrence County, OH",OH,2021,23226,22039,1187,5.1,-412
"Lawrence County, OH",OH,2020,23638,21626,2012,8.5,-407
"Lawrence County, OH",OH,2019,24045,22794,1251,5.2,129
"Lawrence County, OH",OH,2018,23916,22584,1332,5.6,-251
"Lawrence County, OH",OH,2017,24167,22735,1432,5.9,-684
"Lawrence County, OH",OH,2016,24851,23223,1628,6.6,-133
"Lawrence County, OH",OH,2015,24984,23503,1481,5.9,-925
"Lawrence County, OH",OH,2014,25909,24183,1726,6.7,-197
"Lawrence County, OH",OH,2013,26106,23820,2286,8.8,-408
"Lawrence County, OH",OH,2012,26514,24266,2248,8.5,-503
"Lawrence County, OH",OH,2011,27017,24452,2565,9.5,-728
"Lawrence County, OH",OH,2010,27745,24884,2861,10.3,0
"Lawrence County, PA",PA,2021,39632,36612,3020,7.6,-1153
"Lawrence County, PA",PA,2020,40785,36557,4228,10.4,-364
"Lawrence County, PA",PA,2019,41149,38988,2161,5.3,-101
"Lawrence County, PA",PA,2018,41250,39070,2180,5.3,232
"Lawrence County, PA",PA,2017,41018,38493,2525,6.2,-544
"Lawrence County, PA",PA,2016,41562,38799,2763,6.6,-578
"Lawrence County, PA",PA,2015,42140,39429,2711,6.4,-428
"Lawrence County, PA",PA,2014,42568,39889,2679,6.3,-328
"Lawrence County, PA",PA,2013,42896,39771,3125,7.3,-339
"Lawrence County, PA",PA,2012,43235,39892,3343,7.7,290
"Lawrence County, PA",PA,2011,42945,39420,3525,8.2,-38
"Lawrence County, PA",PA,2010,42983,39136,3847,9.0,0
"Lawrence County, SD",SD,2021,13789,13370,419,3.0,301
"Lawrence County, SD",SD,2020,13488,12703,785,5.8,166
"Lawrence County, SD",SD,2019,13322,12958,364,2.7,311
"Lawrence County, SD",SD,2018,13011,12660,351,2.7,-14
"Lawrence County, SD",SD,2017,13025,12631,394,3.0,-104
"Lawrence County, SD",SD,2016,13129,12692,437,3.3,313
"Lawrence County, SD",SD,2015,12816,12404,412,3.2,83
"Lawrence County, SD",SD,2014,12733,12300,433,3.4,-35
"Lawrence County, SD",SD,2013,12768,12274,494,3.9,-5
"Lawrence County, SD",SD,2012,12773,12230,543,4.3,-177
"Lawrence County, SD",SD,2011,12950,12342,608,4.7,-274
"Lawrence County, SD",SD,2010,13224,12607,617,4.7,0
"Lawrence County, TN",TN,2021,19378,18549,829,4.3,123
"Lawrence County, TN",TN,2020,19255,17774,1481,7.7,0
"Lawrence County, TN",TN,2019,19255,18462,793,4.1,761
"Lawrence County, TN",TN,2018,18494,17749,745,4.0,692
"Lawrence County, TN",TN,2017,17802,17019,783,4.4,-4
"Lawrence County, TN",TN,2016,17806,16776,1030,5.8,50
"Lawrence County, TN",TN,2015,17756,16593,1163,6.5,78
"Lawrence County, TN",TN,2014,17678,16235,1443,8.2,-488
"Lawrence County, TN",TN,2013,18166,16381,1785,9.8,-524
"Lawrence County, TN",TN,2012,18690,16878,1812,9.7,-520
"Lawrence County, TN",TN,2011,19210,17176,2034,10.6,-156
"Lawrence County, TN",TN,2010,19366,16944,2422,12.5,0
"Le Flore County, OK",OK,2021,19236,18340,896,4.7,213
"Le Flore County, OK",OK,2020,19023,17673,1350,7.1,80
"Le Flore County, OK",OK,2019,18943,18098,845,4.5,-162
"Le Flore County, OK",OK,2018,19105,18259,846,4.4,-156
"Le Flore County, OK",OK,2017,19261,18204,1057,5.5,-459
"Le Flore County, OK",OK,2016,19720,18405,1315,6.7,112
"Le Flore County, OK",OK,2015,19608,18285,1323,6.7,267
"Le Flore County, OK",OK,2014,19341,18055,1286,6.6,-371
"Le Flore County, OK",OK,2013,19712,18013,1699,8.6,-279
"Le Flore County, OK",OK,2012,19991,18323,1668,8.3,-35
"Le Flore County, OK",OK,2011,20026,18338,1688,8.4,-664
"Le Flore County, OK",OK,2010,20690,18831,1859,9.0,0
"Le Sueur County, MN",MN,2021,15633,14995,638,4.1,-582
"Le Sueur County, MN",MN,2020,16215,15077,1138,7.0,-324
"Le Sueur County, MN",MN,2019,16539,15755,784,4.7,382
"Le Sueur County, MN",MN,2018,16157,15445,712,4.4,229
"Le Sueur County, MN",MN,2017,15928,15178,750,4.7,378
"Le Sueur County, MN",MN,2016,15550,14790,760,4.9,-27
"Le Sueur County, MN",MN,2015,15577,14811,766,4.9,55
"Le Sueur County, MN",MN,2014,15522,14667,855,5.5,5
"Le Sueur County, MN",MN,2013,15517,14557,960,6.2,11
"Le Sueur County, MN",MN,2012,15506,14492,1014,6.5,-207
"Le Sueur County, MN",MN,2011,15713,14521,1192,7.6,-9
"Le Sueur County, MN",MN,2010,15722,14331,1391,8.8,0
"Lea County, NM",NM,2021,27957,25280,2677,9.6,-1124
"Lea County, NM",NM,2020,29081,25974,3107,10.7,-2474
"Lea County, NM",NM,2019,31555,30278,1277,4.0,1281
"Lea County, NM",NM,2018,30274,29031,1243,4.1,2141
"Lea County, NM",NM,2017,28133,26313,1820,6.5,166
"Lea County, NM",NM,2016,27967,25359,2608,9.3,-2146
"Lea County, NM",NM,2015,30113,28224,1889,6.3,-777
"Lea County, NM",NM,2014,30890,29550,1340,4.3,1402
"Lea County, NM",NM,2013,29488,28173,1315,4.5,1115
"Lea County, NM",NM,2012,28373,27061,1312,4.6,1252
"Lea County, NM",NM,2011,27121,25666,1455,5.4,1020
"Lea County, NM",NM,2010,26101,24123,1978,7.6,0
"Leake County, MS",MS,2021,7900,7457,443,5.6,-30
"Leake County, MS",MS,2020,7930,7319,611,7.7,-110
"Leake County, MS",MS,2019,8040,7593,447,5.6,212
"Leake County, MS",MS,2018,7828,7424,404,5.2,252
"Leake County, MS",MS,2017,7576,7130,446,5.9,-144
"Leake County, MS",MS,2016,7720,7242,478,6.2,-146
"Leake County, MS",MS,2015,7866,7376,490,6.2,60
"Leake County, MS",MS,2014,7806,7245,561,7.2,-306
"Leake County, MS",MS,2013,8112,7422,690,8.5,-380
"Leake County, MS",MS,2012,8492,7724,768,9.0,-398
"Leake County, MS",MS,2011,8890,8046,844,9.5,-306
"Leake County, MS",MS,2010,9196,8332,864,9.4,0
"Leavenworth County, KS",KS,2021,36842,35624,1218,3.3,213
"Leavenworth County, KS",KS,2020,36629,34565,2064,5.6,-49
"Leavenworth County, KS",KS,2019,36678,35433,1245,3.4,277
"Leavenworth County, KS",KS,2018,36401,35102,1299,3.6,-52
"Leavenworth County, KS",KS,2017,36453,35033,1420,3.9,508
"Leavenworth County, KS",KS,2016,35945,34402,1543,4.3,579
"Leavenworth County, KS",KS,2015,35366,33776,1590,4.5,319
"Leavenworth County, KS",KS,2014,35047,33312,1735,5.0,370
"Leavenworth County, KS",KS,2013,34677,32604,2073,6.0,104
"Leavenworth County, KS",KS,2012,34573,32367,2206,6.4,-6
"Leavenworth County, KS",KS,2011,34579,32103,2476,7.2,251
"Leavenworth County, KS",KS,2010,34328,31763,2565,7.5,0
"Lebanon County, PA",PA,2021,72636,68671,3965,5.5,-349
"Lebanon County, PA",PA,2020,72985,67204,5781,7.9,-154
"Lebanon County, PA",PA,2019,73139,70213,2926,4.0,1132
"Lebanon County, PA",PA,2018,72007,69180,2827,3.9,620
"Lebanon County, PA",PA,2017,71387,68391,2996,4.2,693
"Lebanon County, PA",PA,2016,70694,67561,3133,4.4,613
"Lebanon County, PA",PA,2015,70081,66849,3232,4.6,30
"Lebanon County, PA",PA,2014,70051,66536,3515,5.0,-470
"Lebanon County, PA",PA,2013,70521,66279,4242,6.0,-257
"Lebanon County, PA",PA,2012,70778,66154,4624,6.5,1069
"Lebanon County, PA",PA,2011,69709,64980,4729,6.8,-148
"Lebanon County, PA",PA,2010,69857,64798,5059,7.2,0
"Lee County, AL",AL,2021,76658,74478,2180,2.8,125
"Lee County, AL",AL,2020,76533,72090,4443,5.8,-1011
"Lee County, AL",AL,2019,77544,75315,2229,2.9,1497
"Lee County, AL",AL,2018,76047,73298,2749,3.6,1736
"Lee County, AL",AL,2017,74311,71292,3019,4.1,2552
"Lee County, AL",AL,2016,71759,67995,3764,5.2,1069
"Lee County, AL",AL,2015,70690,66958,3732,5.3,-788
"Lee County, AL",AL,2014,71478,67506,3972,5.6,1031
"Lee County, AL",AL,2013,70447,66242,4205,6.0,1480
"Lee County, AL",AL,2012,68967,64169,4798,7.0,636
"Lee County, AL",AL,2011,68331,62842,5489,8.0,1490
"Lee County, AL",AL,2010,66841,60891,5950,8.9,0
"Lee County, AR",AR,2021,2554,2411,143,5.6,-193
"Lee County, AR",AR,2020,2747,2536,211,7.7,-77
"Lee County, AR",AR,2019,2824,2700,124,4.4,-75
"Lee County, AR",AR,2018,2899,2762,137,4.7,-70
"Lee County, AR",AR,2017,2969,2825,144,4.9,-129
"Lee County, AR",AR,2016,3098,2951,147,4.7,-96
"Lee County, AR",AR,2015,3194,2984,210,6.6,-80
"Lee County, AR",AR,2014,3274,3033,241,7.4,-56
"Lee County, AR",AR,2013,3330,3028,302,9.1,-202
"Lee County, AR",AR,2012,3532,3212,320,9.1,-143
"Lee County, AR",AR,2011,3675,3342,333,9.1,-24
"Lee County, AR",AR,2010,3699,3395,304,8.2,0
"Lee County, FL",FL,2021,357018,342117,14901,4.2,11905
"Lee County, FL",FL,2020,345113,317759,27354,7.9,-899
"Lee County, FL",FL,2019,346012,334789,11223,3.2,7325
"Lee County, FL",FL,2018,338687,326661,12026,3.6,6048
"Lee County, FL",FL,2017,332639,318774,13865,4.2,2241
"Lee County, FL",FL,2016,330398,314990,15408,4.7,9812
"Lee County, FL",FL,2015,320586,303892,16694,5.2,10727
"Lee County, FL",FL,2014,309859,290623,19236,6.2,11511
"Lee County, FL",FL,2013,298348,275689,22659,7.6,7880
"Lee County, FL",FL,2012,290468,264043,26425,9.1,5105
"Lee County, FL",FL,2011,285363,254435,30928,10.8,4758
"Lee County, FL",FL,2010,280605,246599,34006,12.1,0
"Lee County, GA",GA,2021,15173,14707,466,3.1,147
"Lee County, GA",GA,2020,15026,14343,683,4.5,-127
"Lee County, GA",GA,2019,15153,14677,476,3.1,311
"Lee County, GA",GA,2018,14842,14304,538,3.6,-351
"Lee County, GA",GA,2017,15193,14555,638,4.2,636
"Lee County, GA",GA,2016,14557,13865,692,4.8,590
"Lee County, GA",GA,2015,13967,13211,756,5.4,-154
"Lee County, GA",GA,2014,14121,13237,884,6.3,-158
"Lee County, GA",GA,2013,14279,13304,975,6.8,2
"Lee County, GA",GA,2012,14277,13201,1076,7.5,-25
"Lee County, GA",GA,2011,14302,13105,1197,8.4,-80
"Lee County, GA",GA,2010,14382,13063,1319,9.2,0
"Lee County, IA",IA,2021,15340,14431,909,5.9,-419
"Lee County, IA",IA,2020,15759,14748,1011,6.4,-653
"Lee County, IA",IA,2019,16412,15801,611,3.7,230
"Lee County, IA",IA,2018,16182,15535,647,4.0,-179
"Lee County, IA",IA,2017,16361,15486,875,5.3,-1188
"Lee County, IA",IA,2016,17549,16499,1050,6.0,-716
"Lee County, IA",IA,2015,18265,17293,972,5.3,532
"Lee County, IA",IA,2014,17733,16691,1042,5.9,584
"Lee County, IA",IA,2013,17149,15926,1223,7.1,-401
"Lee County, IA",IA,2012,17550,16284,1266,7.2,32
"Lee County, IA",IA,2011,17518,16073,1445,8.2,-188
"Lee County, IA",IA,2010,17706,16108,1598,9.0,0
"Lee County, IL",IL,2021,16913,16144,769,4.5,-172
"Lee County, IL",IL,2020,17085,15894,1191,7.0,-557
"Lee County, IL",IL,2019,17642,16972,670,3.8,-311
"Lee County, IL",IL,2018,17953,17178,775,4.3,113
"Lee County, IL",IL,2017,17840,17065,775,4.3,-257
"Lee County, IL",IL,2016,18097,17168,929,5.1,221
"Lee County, IL",IL,2015,17876,16921,955,5.3,-262
"Lee County, IL",IL,2014,18138,16995,1143,6.3,64
"Lee County, IL",IL,2013,18074,16635,1439,8.0,-75
"Lee County, IL",IL,2012,18149,16640,1509,8.3,-677
"Lee County, IL",IL,2011,18826,17118,1708,9.1,-372
"Lee County, IL",IL,2010,19198,17263,1935,10.1,0
"Lee County, KY",KY,2021,2009,1896,113,5.6,-33
"Lee County, KY",KY,2020,2042,1905,137,6.7,-62
"Lee County, KY",KY,2019,2104,1990,114,5.4,22
"Lee County, KY",KY,2018,2082,1952,130,6.2,186
"Lee County, KY",KY,2017,1896,1738,158,8.3,-1
"Lee County, KY",KY,2016,1897,1714,183,9.6,-77
"Lee County, KY",KY,2015,1974,1804,170,8.6,-340
"Lee County, KY",KY,2014,2314,2090,224,9.7,-57
"Lee County, KY",KY,2013,2371,2078,293,12.4,-61
"Lee County, KY",KY,2012,2432,2123,309,12.7,-86
"Lee County, KY",KY,2011,2518,2201,317,12.6,-86
"Lee County, KY",KY,2010,2604,2273,331,12.7,0
"Lee County, MS",MS,2021,41213,39311,1902,4.6,393
"Lee County, MS",MS,2020,40820,37573,3247,8.0,-623
"Lee County, MS",MS,2019,41443,39628,1815,4.4,756
"Lee County, MS",MS,2018,40687,39067,1620,4.0,-349
"Lee County, MS",MS,2017,41036,39344,1692,4.1,416
"Lee County, MS",MS,2016,40620,38598,2022,5.0,894
"Lee County, MS",MS,2015,39726,37495,2231,5.6,1021
"Lee County, MS",MS,2014,38705,35890,2815,7.3,-871
"Lee County, MS",MS,2013,39576,36430,3146,7.9,-1912
"Lee County, MS",MS,2012,41488,38101,3387,8.2,320
"Lee County, MS",MS,2011,41168,37285,3883,9.4,1903
"Lee County, MS",MS,2010,39265,35293,3972,10.1,0
"Lee County, NC",NC,2021,25322,23956,1366,5.4,173
"Lee County, NC",NC,2020,25149,23192,1957,7.8,-789
"Lee County, NC",NC,2019,25938,24796,1142,4.4,-194
"Lee County, NC",NC,2018,26132,24975,1157,4.4,-67
"Lee County, NC",NC,2017,26199,24857,1342,5.1,49
"Lee County, NC",NC,2016,26150,24611,1539,5.9,91
"Lee County, NC",NC,2015,26059,24201,1858,7.1,1053
"Lee County, NC",NC,2014,25006,23020,1986,7.9,-1101
"Lee County, NC",NC,2013,26107,23532,2575,9.9,-1235
"Lee County, NC",NC,2012,27342,24159,3183,11.6,-31
"Lee County, NC",NC,2011,27373,24003,3370,12.3,185
"Lee County, NC",NC,2010,27188,23749,3439,12.6,0
"Lee County, SC",SC,2021,6595,6228,367,5.6,-57
"Lee County, SC",SC,2020,6652,6157,495,7.4,225
"Lee County, SC",SC,2019,6427,6177,250,3.9,10
"Lee County, SC",SC,2018,6417,6127,290,4.5,155
"Lee County, SC",SC,2017,6262,5894,368,5.9,-155
"Lee County, SC",SC,2016,6417,5972,445,6.9,-36
"Lee County, SC",SC,2015,6453,5914,539,8.4,8
"Lee County, SC",SC,2014,6445,5876,569,8.8,-132
"Lee County, SC",SC,2013,6577,5869,708,10.8,-154
"Lee County, SC",SC,2012,6731,5804,927,13.8,-174
"Lee County, SC",SC,2011,6905,5800,1105,16.0,-116
"Lee County, SC",SC,2010,7021,5867,1154,16.4,0
"Lee County, TX",TX,2021,9057,8669,388,4.3,-29
"Lee County, TX",TX,2020,9086,8637,449,4.9,-920
"Lee County, TX",TX,2019,10006,9741,265,2.6,626
"Lee County, TX",TX,2018,9380,9091,289,3.1,-87
"Lee County, TX",TX,2017,9467,9153,314,3.3,181
"Lee County, TX",TX,2016,9286,8936,350,3.8,-18
"Lee County, TX",TX,2015,9304,8971,333,3.6,-22
"Lee County, TX",TX,2014,9326,8950,376,4.0,205
"Lee County, TX",TX,2013,9121,8652,469,5.1,5
"Lee County, TX",TX,2012,9116,8628,488,5.4,253
"Lee County, TX",TX,2011,8863,8271,592,6.7,626
"Lee County, TX",TX,2010,8237,7637,600,7.3,0
"Lee County, VA",VA,2021,8030,7705,325,4.0,-271
"Lee County, VA",VA,2020,8301,7772,529,6.4,-108
"Lee County, VA",VA,2019,8409,8073,336,4.0,21
"Lee County, VA",VA,2018,8388,8047,341,4.1,-240
"Lee County, VA",VA,2017,8628,8186,442,5.1,177
"Lee County, VA",VA,2016,8451,7886,565,6.7,-150
"Lee County, VA",VA,2015,8601,7989,612,7.1,-263
"Lee County, VA",VA,2014,8864,8153,711,8.0,-434
"Lee County, VA",VA,2013,9298,8502,796,8.6,-476
"Lee County, VA",VA,2012,9774,8983,791,8.1,-440
"Lee County, VA",VA,2011,10214,9439,775,7.6,71
"Lee County, VA",VA,2010,10143,9320,823,8.1,0
"Leelanau County, MI",MI,2021,10047,9524,523,5.2,-160
"Leelanau County, MI",MI,2020,10207,9362,845,8.3,-264
"Leelanau County, MI",MI,2019,10471,10071,400,3.8,41
"Leelanau County, MI",MI,2018,10430,9982,448,4.3,-72
"Leelanau County, MI",MI,2017,10502,10005,497,4.7,-101
"Leelanau County, MI",MI,2016,10603,10083,520,4.9,-31
"Leelanau County, MI",MI,2015,10634,10068,566,5.3,81
"Leelanau County, MI",MI,2014,10553,9848,705,6.7,252
"Leelanau County, MI",MI,2013,10301,9518,783,7.6,96
"Leelanau County, MI",MI,2012,10205,9395,810,7.9,-102
"Leelanau County, MI",MI,2011,10307,9400,907,8.8,-185
"Leelanau County, MI",MI,2010,10492,9438,1054,10.0,0
"Leflore County, MS",MS,2021,9941,9131,810,8.1,181
"Leflore County, MS",MS,2020,9760,8741,1019,10.4,-149
"Leflore County, MS",MS,2019,9909,9158,751,7.6,-33
"Leflore County, MS",MS,2018,9942,9235,707,7.1,-173
"Leflore County, MS",MS,2017,10115,9342,773,7.6,-181
"Leflore County, MS",MS,2016,10296,9343,953,9.3,-170
"Leflore County, MS",MS,2015,10466,9325,1141,10.9,-62
"Leflore County, MS",MS,2014,10528,9186,1342,12.7,-212
"Leflore County, MS",MS,2013,10740,9215,1525,14.2,-575
"Leflore County, MS",MS,2012,11315,9757,1558,13.8,-324
"Leflore County, MS",MS,2011,11639,9943,1696,14.6,31
"Leflore County, MS",MS,2010,11608,9876,1732,14.9,0
"Lehigh County, PA",PA,2021,196119,182781,13338,6.8,1383
"Lehigh County, PA",PA,2020,194736,176099,18637,9.6,-996
"Lehigh County, PA",PA,2019,195732,186666,9066,4.6,2607
"Lehigh County, PA",PA,2018,193125,183886,9239,4.8,1673
"Lehigh County, PA",PA,2017,191452,181692,9760,5.1,2133
"Lehigh County, PA",PA,2016,189319,179314,10005,5.3,3452
"Lehigh County, PA",PA,2015,185867,175780,10087,5.4,2970
"Lehigh County, PA",PA,2014,182897,171665,11232,6.1,255
"Lehigh County, PA",PA,2013,182642,168805,13837,7.6,188
"Lehigh County, PA",PA,2012,182454,167310,15144,8.3,3374
"Lehigh County, PA",PA,2011,179080,163922,15158,8.5,2488
"Lehigh County, PA",PA,2010,176592,160848,15744,8.9,0
"Lemhi County, ID",ID,2021,3713,3515,198,5.3,59
"Lemhi County, ID",ID,2020,3654,3405,249,6.8,68
"Lemhi County, ID",ID,2019,3586,3414,172,4.8,57
"Lemhi County, ID",ID,2018,3529,3370,159,4.5,29
"Lemhi County, ID",ID,2017,3500,3318,182,5.2,97
"Lemhi County, ID",ID,2016,3403,3202,201,5.9,30
"Lemhi County, ID",ID,2015,3373,3153,220,6.5,34
"Lemhi County, ID",ID,2014,3339,3100,239,7.2,-141
"Lemhi County, ID",ID,2013,3480,3119,361,10.4,-104
"Lemhi County, ID",ID,2012,3584,3223,361,10.1,-77
"Lemhi County, ID",ID,2011,3661,3292,369,10.1,-119
"Lemhi County, ID",ID,2010,3780,3402,378,10.0,0
"Lenawee County, MI",MI,2021,44522,42093,2429,5.5,-1024
"Lenawee County, MI",MI,2020,45546,41328,4218,9.3,-902
"Lenawee County, MI",MI,2019,46448,44613,1835,4.0,-443
"Lenawee County, MI",MI,2018,46891,44971,1920,4.1,-248
"Lenawee County, MI",MI,2017,47139,44951,2188,4.6,-348
"Lenawee County, MI",MI,2016,47487,45278,2209,4.7,-214
"Lenawee County, MI",MI,2015,47701,45280,2421,5.1,-403
"Lenawee County, MI",MI,2014,48104,45011,3093,6.4,328
"Lenawee County, MI",MI,2013,47776,44072,3704,7.8,88
"Lenawee County, MI",MI,2012,47688,43745,3943,8.3,-464
"Lenawee County, MI",MI,2011,48152,43359,4793,10.0,-1166
"Lenawee County, MI",MI,2010,49318,43076,6242,12.7,0
"Lenoir County, NC",NC,2021,26890,25558,1332,5.0,161
"Lenoir County, NC",NC,2020,26729,25135,1594,6.0,-1035
"Lenoir County, NC",NC,2019,27764,26733,1031,3.7,287
"Lenoir County, NC",NC,2018,27477,26384,1093,4.0,-138
"Lenoir County, NC",NC,2017,27615,26385,1230,4.5,49
"Lenoir County, NC",NC,2016,27566,25947,1619,5.9,-144
"Lenoir County, NC",NC,2015,27710,25973,1737,6.3,-138
"Lenoir County, NC",NC,2014,27848,25915,1933,6.9,-696
"Lenoir County, NC",NC,2013,28544,26133,2411,8.4,-196
"Lenoir County, NC",NC,2012,28740,25852,2888,10.0,993
"Lenoir County, NC",NC,2011,27747,24729,3018,10.9,779
"Lenoir County, NC",NC,2010,26968,23802,3166,11.7,0
"Leon County, FL",FL,2021,154331,147861,6470,4.2,3639
"Leon County, FL",FL,2020,150692,141137,9555,6.3,-2935
"Leon County, FL",FL,2019,153627,148751,4876,3.2,899
"Leon County, FL",FL,2018,152728,147395,5333,3.5,1765
"Leon County, FL",FL,2017,150963,144964,5999,4.0,261
"Leon County, FL",FL,2016,150702,143808,6894,4.6,2577
"Leon County, FL",FL,2015,148125,140607,7518,5.1,-1486
"Leon County, FL",FL,2014,149611,141074,8537,5.7,1803
"Leon County, FL",FL,2013,147808,138410,9398,6.4,-493
"Leon County, FL",FL,2012,148301,137606,10695,7.2,-794
"Leon County, FL",FL,2011,149095,137538,11557,7.8,270
"Leon County, FL",FL,2010,148825,137411,11414,7.7,0
"Leon County, TX",TX,2021,6184,5746,438,7.1,141
"Leon County, TX",TX,2020,6043,5571,472,7.8,-201
"Leon County, TX",TX,2019,6244,5972,272,4.4,174
"Leon County, TX",TX,2018,6070,5764,306,5.0,-74
"Leon County, TX",TX,2017,6144,5752,392,6.4,-369
"Leon County, TX",TX,2016,6513,6091,422,6.5,-423
"Leon County, TX",TX,2015,6936,6563,373,5.4,-274
"Leon County, TX",TX,2014,7210,6822,388,5.4,258
"Leon County, TX",TX,2013,6952,6468,484,7.0,14
"Leon County, TX",TX,2012,6938,6429,509,7.3,-221
"Leon County, TX",TX,2011,7159,6517,642,9.0,-116
"Leon County, TX",TX,2010,7275,6626,649,8.9,0
"Leslie County, KY",KY,2021,2534,2328,206,8.1,-44
"Leslie County, KY",KY,2020,2578,2307,271,10.5,-98
"Leslie County, KY",KY,2019,2676,2468,208,7.8,58
"Leslie County, KY",KY,2018,2618,2437,181,6.9,-116
"Leslie County, KY",KY,2017,2734,2463,271,9.9,-55
"Leslie County, KY",KY,2016,2789,2417,372,13.3,-78
"Leslie County, KY",KY,2015,2867,2550,317,11.1,-309
"Leslie County, KY",KY,2014,3176,2769,407,12.8,-316
"Leslie County, KY",KY,2013,3492,2883,609,17.4,-104
"Leslie County, KY",KY,2012,3596,3081,515,14.3,-45
"Leslie County, KY",KY,2011,3641,3182,459,12.6,14
"Leslie County, KY",KY,2010,3627,3154,473,13.0,0
"Letcher County, KY",KY,2021,6038,5579,459,7.6,-24
"Letcher County, KY",KY,2020,6062,5468,594,9.8,-222
"Letcher County, KY",KY,2019,6284,5845,439,7.0,40
"Letcher County, KY",KY,2018,6244,5854,390,6.2,-49
"Letcher County, KY",KY,2017,6293,5714,579,9.2,-128
"Letcher County, KY",KY,2016,6421,5634,787,12.3,-182
"Letcher County, KY",KY,2015,6603,5843,760,11.5,-643
"Letcher County, KY",KY,2014,7246,6355,891,12.3,-795
"Letcher County, KY",KY,2013,8041,6709,1332,16.6,-545
"Letcher County, KY",KY,2012,8586,7424,1162,13.5,-320
"Letcher County, KY",KY,2011,8906,7997,909,10.2,201
"Letcher County, KY",KY,2010,8705,7701,1004,11.5,0
"Levy County, FL",FL,2021,16849,16095,754,4.5,370
"Levy County, FL",FL,2020,16479,15398,1081,6.6,-99
"Levy County, FL",FL,2019,16578,15942,636,3.8,-106
"Levy County, FL",FL,2018,16684,16015,669,4.0,36
"Levy County, FL",FL,2017,16648,15892,756,4.5,-54
"Levy County, FL",FL,2016,16702,15831,871,5.2,192
"Levy County, FL",FL,2015,16510,15547,963,5.8,234
"Levy County, FL",FL,2014,16276,15129,1147,7.0,-23
"Levy County, FL",FL,2013,16299,14911,1388,8.5,-331
"Levy County, FL",FL,2012,16630,15035,1595,9.6,-242
"Levy County, FL",FL,2011,16872,15039,1833,10.9,-303
"Levy County, FL",FL,2010,17175,15189,1986,11.6,0
"Lewis and Clark County, MT",MT,2021,37256,36149,1107,3.0,514
"Lewis and Clark County, MT",MT,2020,36742,34955,1787,4.9,244
"Lewis and Clark County, MT",MT,2019,36498,35380,1118,3.1,792
"Lewis and Clark County, MT",MT,2018,35706,34511,1195,3.3,229
"Lewis and Clark County, MT",MT,2017,35477,34234,1243,3.5,310
"Lewis and Clark County, MT",MT,2016,35167,33961,1206,3.4,151
"Lewis and Clark County, MT",MT,2015,35016,33805,1211,3.5,-205
"Lewis and Clark County, MT",MT,2014,35221,33913,1308,3.7,123
"Lewis and Clark County, MT",MT,2013,35098,33587,1511,4.3,169
"Lewis and Clark County, MT",MT,2012,34929,33287,1642,4.7,414
"Lewis and Clark County, MT",MT,2011,34515,32764,1751,5.1,176
"Lewis and Clark County, MT",MT,2010,34339,32483,1856,5.4,0
"Lewis County, ID",ID,2021,1661,1567,94,5.7,3
"Lewis County, ID",ID,2020,1658,1527,131,7.9,10
"Lewis County, ID",ID,2019,1648,1556,92,5.6,19
"Lewis County, ID",ID,2018,1629,1538,91,5.6,4
"Lewis County, ID",ID,2017,1625,1530,95,5.8,1
"Lewis County, ID",ID,2016,1624,1524,100,6.2,34
"Lewis County, ID",ID,2015,1590,1506,84,5.3,2
"Lewis County, ID",ID,2014,1588,1523,65,4.1,-36
"Lewis County, ID",ID,2013,1624,1533,91,5.6,22
"Lewis County, ID",ID,2012,1602,1513,89,5.6,49
"Lewis County, ID",ID,2011,1553,1458,95,6.1,-20
"Lewis County, ID",ID,2010,1573,1471,102,6.5,0
"Lewis County, KY",KY,2021,4703,4344,359,7.6,50
"Lewis County, KY",KY,2020,4653,4225,428,9.2,-5
"Lewis County, KY",KY,2019,4658,4267,391,8.4,-38
"Lewis County, KY",KY,2018,4696,4314,382,8.1,-6
"Lewis County, KY",KY,2017,4702,4275,427,9.1,-40
"Lewis County, KY",KY,2016,4742,4281,461,9.7,-47
"Lewis County, KY",KY,2015,4789,4368,421,8.8,-383
"Lewis County, KY",KY,2014,5172,4676,496,9.6,-121
"Lewis County, KY",KY,2013,5293,4655,638,12.1,-92
"Lewis County, KY",KY,2012,5385,4755,630,11.7,-144
"Lewis County, KY",KY,2011,5529,4812,717,13.0,-92
"Lewis County, KY",KY,2010,5621,4839,782,13.9,0
"Lewis County, MO",MO,2021,4826,4657,169,3.5,-107
"Lewis County, MO",MO,2020,4933,4693,240,4.9,-35
"Lewis County, MO",MO,2019,4968,4819,149,3.0,-97
"Lewis County, MO",MO,2018,5065,4924,141,2.8,-40
"Lewis County, MO",MO,2017,5105,4931,174,3.4,-27
"Lewis County, MO",MO,2016,5132,4900,232,4.5,-49
"Lewis County, MO",MO,2015,5181,4921,260,5.0,41
"Lewis County, MO",MO,2014,5140,4871,269,5.2,74
"Lewis County, MO",MO,2013,5066,4782,284,5.6,-62
"Lewis County, MO",MO,2012,5128,4836,292,5.7,13
"Lewis County, MO",MO,2011,5115,4752,363,7.1,-66
"Lewis County, MO",MO,2010,5181,4742,439,8.5,0
"Lewis County, NY",NY,2021,11534,10955,579,5.0,-73
"Lewis County, NY",NY,2020,11607,10741,866,7.5,-240
"Lewis County, NY",NY,2019,11847,11216,631,5.3,-23
"Lewis County, NY",NY,2018,11870,11215,655,5.5,58
"Lewis County, NY",NY,2017,11812,11034,778,6.6,60
"Lewis County, NY",NY,2016,11752,10949,803,6.8,3
"Lewis County, NY",NY,2015,11749,10930,819,7.0,-104
"Lewis County, NY",NY,2014,11853,10915,938,7.9,-386
"Lewis County, NY",NY,2013,12239,11052,1187,9.7,-15
"Lewis County, NY",NY,2012,12254,11013,1241,10.1,-159
"Lewis County, NY",NY,2011,12413,11206,1207,9.7,-359
"Lewis County, NY",NY,2010,12772,11582,1190,9.3,0
"Lewis County, TN",TN,2021,5555,5294,261,4.7,212
"Lewis County, TN",TN,2020,5343,4944,399,7.5,121
"Lewis County, TN",TN,2019,5222,5010,212,4.1,147
"Lewis County, TN",TN,2018,5075,4850,225,4.4,126
"Lewis County, TN",TN,2017,4949,4723,226,4.6,59
"Lewis County, TN",TN,2016,4890,4599,291,6.0,76
"Lewis County, TN",TN,2015,4814,4465,349,7.2,-52
"Lewis County, TN",TN,2014,4866,4428,438,9.0,-141
"Lewis County, TN",TN,2013,5007,4478,529,10.6,-35
"Lewis County, TN",TN,2012,5042,4488,554,11.0,-202
"Lewis County, TN",TN,2011,5244,4557,687,13.1,-174
"Lewis County, TN",TN,2010,5418,4591,827,15.3,0
"Lewis County, WA",WA,2021,34798,32614,2184,6.3,-15
"Lewis County, WA",WA,2020,34813,31557,3256,9.4,-450
"Lewis County, WA",WA,2019,35263,33050,2213,6.3,1143
"Lewis County, WA",WA,2018,34120,31989,2131,6.2,869
"Lewis County, WA",WA,2017,33251,31087,2164,6.5,1313
"Lewis County, WA",WA,2016,31938,29483,2455,7.7,735
"Lewis County, WA",WA,2015,31203,28657,2546,8.2,724
"Lewis County, WA",WA,2014,30479,27793,2686,8.8,-832
"Lewis County, WA",WA,2013,31311,28070,3241,10.4,-698
"Lewis County, WA",WA,2012,32009,28485,3524,11.0,-94
"Lewis County, WA",WA,2011,32103,28412,3691,11.5,-1059
"Lewis County, WA",WA,2010,33162,29213,3949,11.9,0
"Lewis County, WV",WV,2021,6196,5765,431,7.0,-5
"Lewis County, WV",WV,2020,6201,5538,663,10.7,-605
"Lewis County, WV",WV,2019,6806,6382,424,6.2,73
"Lewis County, WV",WV,2018,6733,6363,370,5.5,170
"Lewis County, WV",WV,2017,6563,6128,435,6.6,-287
"Lewis County, WV",WV,2016,6850,6268,582,8.5,-207
"Lewis County, WV",WV,2015,7057,6489,568,8.0,-189
"Lewis County, WV",WV,2014,7246,6795,451,6.2,-121
"Lewis County, WV",WV,2013,7367,6900,467,6.3,-17
"Lewis County, WV",WV,2012,7384,6882,502,6.8,215
"Lewis County, WV",WV,2011,7169,6648,521,7.3,186
"Lewis County, WV",WV,2010,6983,6368,615,8.8,0
"Lexington city, VA",VA,2021,2047,1946,101,4.9,4
"Lexington city, VA",VA,2020,2043,1902,141,6.9,-72
"Lexington city, VA",VA,2019,2115,2017,98,4.6,17
"Lexington city, VA",VA,2018,2098,2000,98,4.7,-44
"Lexington city, VA",VA,2017,2142,2014,128,6.0,-125
"Lexington city, VA",VA,2016,2267,2130,137,6.0,7
"Lexington city, VA",VA,2015,2260,2108,152,6.7,-20
"Lexington city, VA",VA,2014,2280,2106,174,7.6,29
"Lexington city, VA",VA,2013,2251,2064,187,8.3,-28
"Lexington city, VA",VA,2012,2279,2083,196,8.6,-10
"Lexington city, VA",VA,2011,2289,2080,209,9.1,-15
"Lexington city, VA",VA,2010,2304,2085,219,9.5,0
"Lexington County, SC",SC,2021,149900,145337,4563,3.0,2293
"Lexington County, SC",SC,2020,147607,141382,6225,4.2,404
"Lexington County, SC",SC,2019,147203,143835,3368,2.3,2471
"Lexington County, SC",SC,2018,144732,140635,4097,2.8,-831
"Lexington County, SC",SC,2017,145563,140415,5148,3.5,-2094
"Lexington County, SC",SC,2016,147657,141777,5880,4.0,2352
"Lexington County, SC",SC,2015,145305,138353,6952,4.8,3765
"Lexington County, SC",SC,2014,141540,134576,6964,4.9,3558
"Lexington County, SC",SC,2013,137982,130217,7765,5.6,1117
"Lexington County, SC",SC,2012,136865,127490,9375,6.8,1869
"Lexington County, SC",SC,2011,134996,124359,10637,7.9,947
"Lexington County, SC",SC,2010,134049,122886,11163,8.3,0
"Liberty County, FL",FL,2021,2582,2474,108,4.2,-10
"Liberty County, FL",FL,2020,2592,2457,135,5.2,-38
"Liberty County, FL",FL,2019,2630,2536,94,3.6,36
"Liberty County, FL",FL,2018,2594,2489,105,4.0,-6
"Liberty County, FL",FL,2017,2600,2480,120,4.6,-46
"Liberty County, FL",FL,2016,2646,2509,137,5.2,-2
"Liberty County, FL",FL,2015,2648,2491,157,5.9,-100
"Liberty County, FL",FL,2014,2748,2560,188,6.8,-90
"Liberty County, FL",FL,2013,2838,2638,200,7.0,109
"Liberty County, FL",FL,2012,2729,2505,224,8.2,-117
"Liberty County, FL",FL,2011,2846,2586,260,9.1,-64
"Liberty County, FL",FL,2010,2910,2663,247,8.5,0
"Liberty County, GA",GA,2021,26349,25304,1045,4.0,641
"Liberty County, GA",GA,2020,25708,24110,1598,6.2,-288
"Liberty County, GA",GA,2019,25996,24972,1024,3.9,72
"Liberty County, GA",GA,2018,25924,24802,1122,4.3,175
"Liberty County, GA",GA,2017,25749,24412,1337,5.2,702
"Liberty County, GA",GA,2016,25047,23562,1485,5.9,357
"Liberty County, GA",GA,2015,24690,23103,1587,6.4,-904
"Liberty County, GA",GA,2014,25594,23631,1963,7.7,-572
"Liberty County, GA",GA,2013,26166,23961,2205,8.4,-895
"Liberty County, GA",GA,2012,27061,24686,2375,8.8,-475
"Liberty County, GA",GA,2011,27536,24989,2547,9.2,537
"Liberty County, GA",GA,2010,26999,24523,2476,9.2,0
"Liberty County, MT",MT,2021,983,959,24,2.4,11
"Liberty County, MT",MT,2020,972,946,26,2.7,15
"Liberty County, MT",MT,2019,957,932,25,2.6,-11
"Liberty County, MT",MT,2018,968,944,24,2.5,-17
"Liberty County, MT",MT,2017,985,955,30,3.0,-3
"Liberty County, MT",MT,2016,988,956,32,3.2,2
"Liberty County, MT",MT,2015,986,959,27,2.7,12
"Liberty County, MT",MT,2014,974,943,31,3.2,-19
"Liberty County, MT",MT,2013,993,959,34,3.4,-42
"Liberty County, MT",MT,2012,1035,994,41,4.0,17
"Liberty County, MT",MT,2011,1018,979,39,3.8,-16
"Liberty County, MT",MT,2010,1034,990,44,4.3,0
"Liberty County, TX",TX,2021,34870,31677,3193,9.2,744
"Liberty County, TX",TX,2020,34126,30560,3566,10.4,1049
"Liberty County, TX",TX,2019,33077,31416,1661,5.0,663
"Liberty County, TX",TX,2018,32414,30516,1898,5.9,663
"Liberty County, TX",TX,2017,31751,29470,2281,7.2,197
"Liberty County, TX",TX,2016,31554,29176,2378,7.5,586
"Liberty County, TX",TX,2015,30968,28813,2155,7.0,20
"Liberty County, TX",TX,2014,30948,28700,2248,7.3,-23
"Liberty County, TX",TX,2013,30971,28194,2777,9.0,168
"Liberty County, TX",TX,2012,30803,27868,2935,9.5,-13
"Liberty County, TX",TX,2011,30816,27286,3530,11.5,148
"Liberty County, TX",TX,2010,30668,27066,3602,11.7,0
"Licking County, OH",OH,2021,91375,87636,3739,4.1,1294
"Licking County, OH",OH,2020,90081,84147,5934,6.6,-1290
"Licking County, OH",OH,2019,91371,87930,3441,3.8,1495
"Licking County, OH",OH,2018,89876,86320,3556,4.0,530
"Licking County, OH",OH,2017,89346,85575,3771,4.2,752
"Licking County, OH",OH,2016,88594,84685,3909,4.4,1372
"Licking County, OH",OH,2015,87222,83310,3912,4.5,348
"Licking County, OH",OH,2014,86874,82315,4559,5.2,442
"Licking County, OH",OH,2013,86432,80469,5963,6.9,387
"Licking County, OH",OH,2012,86045,80235,5810,6.8,-540
"Licking County, OH",OH,2011,86585,79337,7248,8.4,-1089
"Licking County, OH",OH,2010,87674,79229,8445,9.6,0
"Limestone County, AL",AL,2021,46572,45430,1142,2.5,682
"Limestone County, AL",AL,2020,45890,43726,2164,4.7,942
"Limestone County, AL",AL,2019,44948,43686,1262,2.8,1511
"Limestone County, AL",AL,2018,43437,41904,1533,3.5,1432
"Limestone County, AL",AL,2017,42005,40275,1730,4.1,1656
"Limestone County, AL",AL,2016,40349,38229,2120,5.3,501
"Limestone County, AL",AL,2015,39848,37653,2195,5.5,200
"Limestone County, AL",AL,2014,39648,37244,2404,6.1,257
"Limestone County, AL",AL,2013,39391,36891,2500,6.3,374
"Limestone County, AL",AL,2012,39017,36267,2750,7.0,23
"Limestone County, AL",AL,2011,38994,35648,3346,8.6,638
"Limestone County, AL",AL,2010,38356,34700,3656,9.5,0
"Limestone County, TX",TX,2021,8528,8001,527,6.2,278
"Limestone County, TX",TX,2020,8250,7662,588,7.1,-253
"Limestone County, TX",TX,2019,8503,8175,328,3.9,176
"Limestone County, TX",TX,2018,8327,7938,389,4.7,72
"Limestone County, TX",TX,2017,8255,7791,464,5.6,-74
"Limestone County, TX",TX,2016,8329,7862,467,5.6,-255
"Limestone County, TX",TX,2015,8584,8150,434,5.1,-605
"Limestone County, TX",TX,2014,9189,8646,543,5.9,-276
"Limestone County, TX",TX,2013,9465,8822,643,6.8,-118
"Limestone County, TX",TX,2012,9583,8927,656,6.8,8
"Limestone County, TX",TX,2011,9575,8755,820,8.6,-378
"Limestone County, TX",TX,2010,9953,9164,789,7.9,0
"Lincoln County, AR",AR,2021,3729,3558,171,4.6,-139
"Lincoln County, AR",AR,2020,3868,3637,231,6.0,-35
"Lincoln County, AR",AR,2019,3903,3738,165,4.2,-105
"Lincoln County, AR",AR,2018,4008,3839,169,4.2,-44
"Lincoln County, AR",AR,2017,4052,3882,170,4.2,-50
"Lincoln County, AR",AR,2016,4102,3904,198,4.8,-41
"Lincoln County, AR",AR,2015,4143,3892,251,6.1,-103
"Lincoln County, AR",AR,2014,4246,3952,294,6.9,-132
"Lincoln County, AR",AR,2013,4378,4023,355,8.1,-224
"Lincoln County, AR",AR,2012,4602,4215,387,8.4,-154
"Lincoln County, AR",AR,2011,4756,4331,425,8.9,63
"Lincoln County, AR",AR,2010,4693,4268,425,9.1,0
"Lincoln County, CO",CO,2021,2364,2265,99,4.2,24
"Lincoln County, CO",CO,2020,2340,2241,99,4.2,-58
"Lincoln County, CO",CO,2019,2398,2346,52,2.2,-38
"Lincoln County, CO",CO,2018,2436,2382,54,2.2,78
"Lincoln County, CO",CO,2017,2358,2313,45,1.9,78
"Lincoln County, CO",CO,2016,2280,2224,56,2.5,111
"Lincoln County, CO",CO,2015,2169,2098,71,3.3,37
"Lincoln County, CO",CO,2014,2132,2046,86,4.0,27
"Lincoln County, CO",CO,2013,2105,1984,121,5.7,-45
"Lincoln County, CO",CO,2012,2150,2009,141,6.6,-37
"Lincoln County, CO",CO,2011,2187,2043,144,6.6,43
"Lincoln County, CO",CO,2010,2144,2009,135,6.3,0
"Lincoln County, GA",GA,2021,3558,3415,143,4.0,50
"Lincoln County, GA",GA,2020,3508,3320,188,5.4,-47
"Lincoln County, GA",GA,2019,3555,3413,142,4.0,-55
"Lincoln County, GA",GA,2018,3610,3429,181,5.0,6
"Lincoln County, GA",GA,2017,3604,3414,190,5.3,125
"Lincoln County, GA",GA,2016,3479,3271,208,6.0,152
"Lincoln County, GA",GA,2015,3327,3099,228,6.9,-5
"Lincoln County, GA",GA,2014,3332,3054,278,8.3,-114
"Lincoln County, GA",GA,2013,3446,3103,343,10.0,-79
"Lincoln County, GA",GA,2012,3525,3150,375,10.6,-104
"Lincoln County, GA",GA,2011,3629,3212,417,11.5,-64
"Lincoln County, GA",GA,2010,3693,3261,432,11.7,0
"Lincoln County, ID",ID,2021,2698,2578,120,4.4,41
"Lincoln County, ID",ID,2020,2657,2496,161,6.1,-41
"Lincoln County, ID",ID,2019,2698,2600,98,3.6,-24
"Lincoln County, ID",ID,2018,2722,2628,94,3.5,1
"Lincoln County, ID",ID,2017,2721,2633,88,3.2,82
"Lincoln County, ID",ID,2016,2639,2525,114,4.3,-3
"Lincoln County, ID",ID,2015,2642,2531,111,4.2,49
"Lincoln County, ID",ID,2014,2593,2455,138,5.3,-82
"Lincoln County, ID",ID,2013,2675,2449,226,8.4,-38
"Lincoln County, ID",ID,2012,2713,2456,257,9.5,35
"Lincoln County, ID",ID,2011,2678,2362,316,11.8,-37
"Lincoln County, ID",ID,2010,2715,2363,352,13.0,0
"Lincoln County, KS",KS,2021,1689,1652,37,2.2,-45
"Lincoln County, KS",KS,2020,1734,1686,48,2.8,58
"Lincoln County, KS",KS,2019,1676,1638,38,2.3,-32
"Lincoln County, KS",KS,2018,1708,1667,41,2.4,16
"Lincoln County, KS",KS,2017,1692,1644,48,2.8,-54
"Lincoln County, KS",KS,2016,1746,1686,60,3.4,-56
"Lincoln County, KS",KS,2015,1802,1740,62,3.4,27
"Lincoln County, KS",KS,2014,1775,1702,73,4.1,-6
"Lincoln County, KS",KS,2013,1781,1699,82,4.6,-73
"Lincoln County, KS",KS,2012,1854,1764,90,4.9,-32
"Lincoln County, KS",KS,2011,1886,1790,96,5.1,4
"Lincoln County, KS",KS,2010,1882,1771,111,5.9,0
"Lincoln County, KY",KY,2021,9278,8759,519,5.6,67
"Lincoln County, KY",KY,2020,9211,8502,709,7.7,-166
"Lincoln County, KY",KY,2019,9377,8932,445,4.7,37
"Lincoln County, KY",KY,2018,9340,8882,458,4.9,-36
"Lincoln County, KY",KY,2017,9376,8855,521,5.6,228
"Lincoln County, KY",KY,2016,9148,8599,549,6.0,117
"Lincoln County, KY",KY,2015,9031,8428,603,6.7,-301
"Lincoln County, KY",KY,2014,9332,8510,822,8.8,-586
"Lincoln County, KY",KY,2013,9918,8869,1049,10.6,-189
"Lincoln County, KY",KY,2012,10107,9061,1046,10.3,-323
"Lincoln County, KY",KY,2011,10430,9155,1275,12.2,-251
"Lincoln County, KY",KY,2010,10681,9299,1382,12.9,0
"Lincoln County, ME",ME,2021,16707,15967,740,4.4,321
"Lincoln County, ME",ME,2020,16386,15584,802,4.9,-718
"Lincoln County, ME",ME,2019,17104,16648,456,2.7,-9
"Lincoln County, ME",ME,2018,17113,16587,526,3.1,-75
"Lincoln County, ME",ME,2017,17188,16620,568,3.3,131
"Lincoln County, ME",ME,2016,17057,16429,628,3.7,222
"Lincoln County, ME",ME,2015,16835,16086,749,4.4,-410
"Lincoln County, ME",ME,2014,17245,16234,1011,5.9,-92
"Lincoln County, ME",ME,2013,17337,16149,1188,6.9,129
"Lincoln County, ME",ME,2012,17208,15997,1211,7.0,86
"Lincoln County, ME",ME,2011,17122,15818,1304,7.6,-64
"Lincoln County, ME",ME,2010,17186,15834,1352,7.9,0
"Lincoln County, MN",MN,2021,2957,2858,99,3.3,-194
"Lincoln County, MN",MN,2020,3151,3005,146,4.6,-139
"Lincoln County, MN",MN,2019,3290,3158,132,4.0,16
"Lincoln County, MN",MN,2018,3274,3169,105,3.2,-98
"Lincoln County, MN",MN,2017,3372,3263,109,3.2,-8
"Lincoln County, MN",MN,2016,3380,3257,123,3.6,-19
"Lincoln County, MN",MN,2015,3399,3278,121,3.6,112
"Lincoln County, MN",MN,2014,3287,3141,146,4.4,-26
"Lincoln County, MN",MN,2013,3313,3158,155,4.7,-112
"Lincoln County, MN",MN,2012,3425,3262,163,4.8,-30
"Lincoln County, MN",MN,2011,3455,3276,179,5.2,7
"Lincoln County, MN",MN,2010,3448,3257,191,5.5,0
"Lincoln County, MO",MO,2021,29307,27956,1351,4.6,284
"Lincoln County, MO",MO,2020,29023,27257,1766,6.1,-71
"Lincoln County, MO",MO,2019,29094,28193,901,3.1,1007
"Lincoln County, MO",MO,2018,28087,27192,895,3.2,744
"Lincoln County, MO",MO,2017,27343,26367,976,3.6,143
"Lincoln County, MO",MO,2016,27200,25980,1220,4.5,405
"Lincoln County, MO",MO,2015,26795,25383,1412,5.3,311
"Lincoln County, MO",MO,2014,26484,24751,1733,6.5,243
"Lincoln County, MO",MO,2013,26241,24232,2009,7.7,48
"Lincoln County, MO",MO,2012,26193,23944,2249,8.6,-376
"Lincoln County, MO",MO,2011,26569,23843,2726,10.3,-12
"Lincoln County, MO",MO,2010,26581,23476,3105,11.7,0
"Lincoln County, MS",MS,2021,14774,14032,742,5.0,486
"Lincoln County, MS",MS,2020,14288,13256,1032,7.2,-348
"Lincoln County, MS",MS,2019,14636,13811,825,5.6,60
"Lincoln County, MS",MS,2018,14576,13870,706,4.8,60
"Lincoln County, MS",MS,2017,14516,13740,776,5.3,158
"Lincoln County, MS",MS,2016,14358,13524,834,5.8,176
"Lincoln County, MS",MS,2015,14182,13310,872,6.1,484
"Lincoln County, MS",MS,2014,13698,12783,915,6.7,-226
"Lincoln County, MS",MS,2013,13924,12859,1065,7.6,-640
"Lincoln County, MS",MS,2012,14564,13334,1230,8.4,-301
"Lincoln County, MS",MS,2011,14865,13448,1417,9.5,378
"Lincoln County, MS",MS,2010,14487,13007,1480,10.2,0
"Lincoln County, MT",MT,2021,8100,7617,483,6.0,-19
"Lincoln County, MT",MT,2020,8119,7308,811,10.0,-103
"Lincoln County, MT",MT,2019,8222,7610,612,7.4,77
"Lincoln County, MT",MT,2018,8145,7540,605,7.4,194
"Lincoln County, MT",MT,2017,7951,7271,680,8.6,11
"Lincoln County, MT",MT,2016,7940,7200,740,9.3,116
"Lincoln County, MT",MT,2015,7824,7015,809,10.3,-96
"Lincoln County, MT",MT,2014,7920,7036,884,11.2,-200
"Lincoln County, MT",MT,2013,8120,7079,1041,12.8,-71
"Lincoln County, MT",MT,2012,8191,7194,997,12.2,14
"Lincoln County, MT",MT,2011,8177,7017,1160,14.2,-247
"Lincoln County, MT",MT,2010,8424,7180,1244,14.8,0
"Lincoln County, NC",NC,2021,43823,42039,1784,4.1,1074
"Lincoln County, NC",NC,2020,42749,40040,2709,6.3,-876
"Lincoln County, NC",NC,2019,43625,42104,1521,3.5,1584
"Lincoln County, NC",NC,2018,42041,40563,1478,3.5,723
"Lincoln County, NC",NC,2017,41318,39652,1666,4.0,352
"Lincoln County, NC",NC,2016,40966,39033,1933,4.7,394
"Lincoln County, NC",NC,2015,40572,38396,2176,5.4,932
"Lincoln County, NC",NC,2014,39640,37271,2369,6.0,-304
"Lincoln County, NC",NC,2013,39944,36739,3205,8.0,-341
"Lincoln County, NC",NC,2012,40285,36321,3964,9.8,271
"Lincoln County, NC",NC,2011,40014,35545,4469,11.2,-107
"Lincoln County, NC",NC,2010,40121,35064,5057,12.6,0
"Lincoln County, NE",NE,2021,18596,18187,409,2.2,60
"Lincoln County, NE",NE,2020,18536,17821,715,3.9,0
"Lincoln County, NE",NE,2019,18536,17900,636,3.4,50
"Lincoln County, NE",NE,2018,18486,17919,567,3.1,-139
"Lincoln County, NE",NE,2017,18625,18051,574,3.1,-190
"Lincoln County, NE",NE,2016,18815,18238,577,3.1,204
"Lincoln County, NE",NE,2015,18611,18073,538,2.9,-131
"Lincoln County, NE",NE,2014,18742,18137,605,3.2,-439
"Lincoln County, NE",NE,2013,19181,18471,710,3.7,-55
"Lincoln County, NE",NE,2012,19236,18499,737,3.8,-193
"Lincoln County, NE",NE,2011,19429,18576,853,4.4,55
"Lincoln County, NE",NE,2010,19374,18482,892,4.6,0
"Lincoln County, NM",NM,2021,8843,8183,660,7.5,164
"Lincoln County, NM",NM,2020,8679,7925,754,8.7,-414
"Lincoln County, NM",NM,2019,9093,8669,424,4.7,293
"Lincoln County, NM",NM,2018,8800,8402,398,4.5,-6
"Lincoln County, NM",NM,2017,8806,8327,479,5.4,98
"Lincoln County, NM",NM,2016,8708,8184,524,6.0,-43
"Lincoln County, NM",NM,2015,8751,8240,511,5.8,-104
"Lincoln County, NM",NM,2014,8855,8329,526,5.9,-3
"Lincoln County, NM",NM,2013,8858,8290,568,6.4,-117
"Lincoln County, NM",NM,2012,8975,8401,574,6.4,-87
"Lincoln County, NM",NM,2011,9062,8471,591,6.5,-252
"Lincoln County, NM",NM,2010,9314,8646,668,7.2,0
"Lincoln County, NV",NV,2021,2151,2078,73,3.4,126
"Lincoln County, NV",NV,2020,2025,1922,103,5.1,-111
"Lincoln County, NV",NV,2019,2136,2051,85,4.0,87
"Lincoln County, NV",NV,2018,2049,1961,88,4.3,52
"Lincoln County, NV",NV,2017,1997,1902,95,4.8,28
"Lincoln County, NV",NV,2016,1969,1863,106,5.4,49
"Lincoln County, NV",NV,2015,1920,1802,118,6.1,-14
"Lincoln County, NV",NV,2014,1934,1787,147,7.6,-67
"Lincoln County, NV",NV,2013,2001,1802,199,9.9,-88
"Lincoln County, NV",NV,2012,2089,1863,226,10.8,29
"Lincoln County, NV",NV,2011,2060,1826,234,11.4,58
"Lincoln County, NV",NV,2010,2002,1785,217,10.8,0
"Lincoln County, OK",OK,2021,15810,15249,561,3.5,352
"Lincoln County, OK",OK,2020,15458,14577,881,5.7,-182
"Lincoln County, OK",OK,2019,15640,15111,529,3.4,10
"Lincoln County, OK",OK,2018,15630,15096,534,3.4,-80
"Lincoln County, OK",OK,2017,15710,15064,646,4.1,-147
"Lincoln County, OK",OK,2016,15857,15044,813,5.1,-8
"Lincoln County, OK",OK,2015,15865,15143,722,4.6,383
"Lincoln County, OK",OK,2014,15482,14805,677,4.4,36
"Lincoln County, OK",OK,2013,15446,14675,771,5.0,-47
"Lincoln County, OK",OK,2012,15493,14747,746,4.8,35
"Lincoln County, OK",OK,2011,15458,14657,801,5.2,-178
"Lincoln County, OK",OK,2010,15636,14656,980,6.3,0
"Lincoln County, OR",OR,2021,21119,19680,1439,6.8,362
"Lincoln County, OR",OR,2020,20757,18505,2252,10.8,-2
"Lincoln County, OR",OR,2019,20759,19871,888,4.3,-126
"Lincoln County, OR",OR,2018,20885,19901,984,4.7,-72
"Lincoln County, OR",OR,2017,20957,19974,983,4.7,114
"Lincoln County, OR",OR,2016,20843,19695,1148,5.5,314
"Lincoln County, OR",OR,2015,20529,19197,1332,6.5,-141
"Lincoln County, OR",OR,2014,20670,19082,1588,7.7,-85
"Lincoln County, OR",OR,2013,20755,18950,1805,8.7,-710
"Lincoln County, OR",OR,2012,21465,19338,2127,9.9,-501
"Lincoln County, OR",OR,2011,21966,19649,2317,10.5,-241
"Lincoln County, OR",OR,2010,22207,19734,2473,11.1,0
"Lincoln County, SD",SD,2021,36741,35841,900,2.4,708
"Lincoln County, SD",SD,2020,36033,34811,1222,3.4,513
"Lincoln County, SD",SD,2019,35520,34744,776,2.2,1771
"Lincoln County, SD",SD,2018,33749,33026,723,2.1,837
"Lincoln County, SD",SD,2017,32912,32160,752,2.3,1316
"Lincoln County, SD",SD,2016,31596,30908,688,2.2,945
"Lincoln County, SD",SD,2015,30651,29974,677,2.2,871
"Lincoln County, SD",SD,2014,29780,29077,703,2.4,985
"Lincoln County, SD",SD,2013,28795,28029,766,2.7,677
"Lincoln County, SD",SD,2012,28118,27258,860,3.1,876
"Lincoln County, SD",SD,2011,27242,26291,951,3.5,785
"Lincoln County, SD",SD,2010,26457,25435,1022,3.9,0
"Lincoln County, TN",TN,2021,16155,15500,655,4.1,181
"Lincoln County, TN",TN,2020,15974,14633,1341,8.4,-882
"Lincoln County, TN",TN,2019,16856,16247,609,3.6,135
"Lincoln County, TN",TN,2018,16721,16211,510,3.1,418
"Lincoln County, TN",TN,2017,16303,15771,532,3.3,329
"Lincoln County, TN",TN,2016,15974,15318,656,4.1,800
"Lincoln County, TN",TN,2015,15174,14450,724,4.8,-196
"Lincoln County, TN",TN,2014,15370,14545,825,5.4,-239
"Lincoln County, TN",TN,2013,15609,14637,972,6.2,40
"Lincoln County, TN",TN,2012,15569,14602,967,6.2,-158
"Lincoln County, TN",TN,2011,15727,14663,1064,6.8,17
"Lincoln County, TN",TN,2010,15710,14566,1144,7.3,0
"Lincoln County, WA",WA,2021,4691,4462,229,4.9,11
"Lincoln County, WA",WA,2020,4680,4367,313,6.7,-412
"Lincoln County, WA",WA,2019,5092,4831,261,5.1,-12
"Lincoln County, WA",WA,2018,5104,4857,247,4.8,132
"Lincoln County, WA",WA,2017,4972,4730,242,4.9,78
"Lincoln County, WA",WA,2016,4894,4626,268,5.5,17
"Lincoln County, WA",WA,2015,4877,4601,276,5.7,-154
"Lincoln County, WA",WA,2014,5031,4749,282,5.6,-55
"Lincoln County, WA",WA,2013,5086,4745,341,6.7,-143
"Lincoln County, WA",WA,2012,5229,4882,347,6.6,-24
"Lincoln County, WA",WA,2011,5253,4872,381,7.3,27
"Lincoln County, WA",WA,2010,5226,4832,394,7.5,0
"Lincoln County, WI",WI,2021,14926,14379,547,3.7,51
"Lincoln County, WI",WI,2020,14875,13990,885,5.9,-240
"Lincoln County, WI",WI,2019,15115,14582,533,3.5,-204
"Lincoln County, WI",WI,2018,15319,14843,476,3.1,-225
"Lincoln County, WI",WI,2017,15544,14996,548,3.5,326
"Lincoln County, WI",WI,2016,15218,14570,648,4.3,1
"Lincoln County, WI",WI,2015,15217,14475,742,4.9,-139
"Lincoln County, WI",WI,2014,15356,14415,941,6.1,183
"Lincoln County, WI",WI,2013,15173,13919,1254,8.3,86
"Lincoln County, WI",WI,2012,15087,13730,1357,9.0,-200
"Lincoln County, WI",WI,2011,15287,13819,1468,9.6,-377
"Lincoln County, WI",WI,2010,15664,13920,1744,11.1,0
"Lincoln County, WV",WV,2021,7086,6621,465,6.6,-19
"Lincoln County, WV",WV,2020,7105,6404,701,9.9,-112
"Lincoln County, WV",WV,2019,7217,6758,459,6.4,30
"Lincoln County, WV",WV,2018,7187,6697,490,6.8,-18
"Lincoln County, WV",WV,2017,7205,6711,494,6.9,-107
"Lincoln County, WV",WV,2016,7312,6688,624,8.5,-125
"Lincoln County, WV",WV,2015,7437,6729,708,9.5,-152
"Lincoln County, WV",WV,2014,7589,6874,715,9.4,35
"Lincoln County, WV",WV,2013,7554,6836,718,9.5,-145
"Lincoln County, WV",WV,2012,7699,6931,768,10.0,30
"Lincoln County, WV",WV,2011,7669,6872,797,10.4,-197
"Lincoln County, WV",WV,2010,7866,6938,928,11.8,0
"Lincoln County, WY",WY,2021,9514,9154,360,3.8,220
"Lincoln County, WY",WY,2020,9294,8831,463,5.0,254
"Lincoln County, WY",WY,2019,9040,8727,313,3.5,216
"Lincoln County, WY",WY,2018,8824,8488,336,3.8,53
"Lincoln County, WY",WY,2017,8771,8440,331,3.8,46
"Lincoln County, WY",WY,2016,8725,8313,412,4.7,382
"Lincoln County, WY",WY,2015,8343,7955,388,4.7,198
"Lincoln County, WY",WY,2014,8145,7706,439,5.4,95
"Lincoln County, WY",WY,2013,8050,7583,467,5.8,-136
"Lincoln County, WY",WY,2012,8186,7583,603,7.4,-455
"Lincoln County, WY",WY,2011,8641,7921,720,8.3,-11
"Lincoln County, WY",WY,2010,8652,7869,783,9.0,0
"Lincoln Parish, LA",LA,2021,21118,20215,903,4.3,131
"Lincoln Parish, LA",LA,2020,20987,19584,1403,6.7,-1030
"Lincoln Parish, LA",LA,2019,22017,20876,1141,5.2,-46
"Lincoln Parish, LA",LA,2018,22063,20935,1128,5.1,466
"Lincoln Parish, LA",LA,2017,21597,20480,1117,5.2,107
"Lincoln Parish, LA",LA,2016,21490,20153,1337,6.2,516
"Lincoln Parish, LA",LA,2015,20974,19518,1456,6.9,394
"Lincoln Parish, LA",LA,2014,20580,19061,1519,7.4,36
"Lincoln Parish, LA",LA,2013,20544,18997,1547,7.5,986
"Lincoln Parish, LA",LA,2012,19558,17948,1610,8.2,-584
"Lincoln Parish, LA",LA,2011,20142,18372,1770,8.8,-142
"Lincoln Parish, LA",LA,2010,20284,18609,1675,8.3,0
"Linn County, IA",IA,2021,118805,112825,5980,5.0,-1512
"Linn County, IA",IA,2020,120317,112852,7465,6.2,-4851
"Linn County, IA",IA,2019,125168,121717,3451,2.8,3164
"Linn County, IA",IA,2018,122004,118622,3382,2.8,2074
"Linn County, IA",IA,2017,119930,115983,3947,3.3,516
"Linn County, IA",IA,2016,119414,115074,4340,3.6,-782
"Linn County, IA",IA,2015,120196,115687,4509,3.8,-809
"Linn County, IA",IA,2014,121005,115706,5299,4.4,1175
"Linn County, IA",IA,2013,119830,113828,6002,5.0,459
"Linn County, IA",IA,2012,119371,113117,6254,5.2,-535
"Linn County, IA",IA,2011,119906,112974,6932,5.8,93
"Linn County, IA",IA,2010,119813,112523,7290,6.1,0
"Linn County, KS",KS,2021,4331,4145,186,4.3,2
"Linn County, KS",KS,2020,4329,4028,301,7.0,-96
"Linn County, KS",KS,2019,4425,4162,263,5.9,-6
"Linn County, KS",KS,2018,4431,4175,256,5.8,4
"Linn County, KS",KS,2017,4427,4168,259,5.9,65
"Linn County, KS",KS,2016,4362,4083,279,6.4,22
"Linn County, KS",KS,2015,4340,4062,278,6.4,15
"Linn County, KS",KS,2014,4325,4005,320,7.4,-20
"Linn County, KS",KS,2013,4345,3968,377,8.7,-53
"Linn County, KS",KS,2012,4398,3964,434,9.9,-121
"Linn County, KS",KS,2011,4519,4023,496,11.0,-13
"Linn County, KS",KS,2010,4532,4032,500,11.0,0
"Linn County, MO",MO,2021,5077,4801,276,5.4,29
"Linn County, MO",MO,2020,5048,4738,310,6.1,-10
"Linn County, MO",MO,2019,5058,4825,233,4.6,-56
"Linn County, MO",MO,2018,5114,4878,236,4.6,-141
"Linn County, MO",MO,2017,5255,4951,304,5.8,-11
"Linn County, MO",MO,2016,5266,4914,352,6.7,53
"Linn County, MO",MO,2015,5213,4840,373,7.2,10
"Linn County, MO",MO,2014,5203,4777,426,8.2,-100
"Linn County, MO",MO,2013,5303,4831,472,8.9,154
"Linn County, MO",MO,2012,5149,4656,493,9.6,-163
"Linn County, MO",MO,2011,5312,4669,643,12.1,-113
"Linn County, MO",MO,2010,5425,4749,676,12.5,0
"Linn County, OR",OR,2021,60636,57235,3401,5.6,1509
"Linn County, OR",OR,2020,59127,54551,4576,7.7,620
"Linn County, OR",OR,2019,58507,56004,2503,4.3,222
"Linn County, OR",OR,2018,58285,55623,2662,4.6,849
"Linn County, OR",OR,2017,57436,54752,2684,4.7,754
"Linn County, OR",OR,2016,56682,53505,3177,5.6,1471
"Linn County, OR",OR,2015,55211,51589,3622,6.6,804
"Linn County, OR",OR,2014,54407,50071,4336,8.0,499
"Linn County, OR",OR,2013,53908,48763,5145,9.5,-1697
"Linn County, OR",OR,2012,55605,49637,5968,10.7,-1105
"Linn County, OR",OR,2011,56710,50195,6515,11.5,-590
"Linn County, OR",OR,2010,57300,49890,7410,12.9,0
"Lipscomb County, TX",TX,2021,1502,1446,56,3.7,-10
"Lipscomb County, TX",TX,2020,1512,1449,63,4.2,-98
"Lipscomb County, TX",TX,2019,1610,1567,43,2.7,-26
"Lipscomb County, TX",TX,2018,1636,1591,45,2.8,23
"Lipscomb County, TX",TX,2017,1613,1561,52,3.2,-39
"Lipscomb County, TX",TX,2016,1652,1579,73,4.4,-73
"Lipscomb County, TX",TX,2015,1725,1657,68,3.9,-20
"Lipscomb County, TX",TX,2014,1745,1686,59,3.4,28
"Lipscomb County, TX",TX,2013,1717,1649,68,4.0,-37
"Lipscomb County, TX",TX,2012,1754,1687,67,3.8,14
"Lipscomb County, TX",TX,2011,1740,1658,82,4.7,73
"Lipscomb County, TX",TX,2010,1667,1569,98,5.9,0
"Litchfield County, CT",CT,2021,101537,95963,5574,5.5,-1947
"Litchfield County, CT",CT,2020,103484,96504,6980,6.7,-3446
"Litchfield County, CT",CT,2019,106930,103418,3512,3.3,685
"Litchfield County, CT",CT,2018,106245,102370,3875,3.6,827
"Litchfield County, CT",CT,2017,105418,101111,4307,4.1,668
"Litchfield County, CT",CT,2016,104750,100083,4667,4.5,-521
"Litchfield County, CT",CT,2015,105271,99925,5346,5.1,-271
"Litchfield County, CT",CT,2014,105542,99183,6359,6.0,909
"Litchfield County, CT",CT,2013,104633,97045,7588,7.3,-1433
"Litchfield County, CT",CT,2012,106066,97982,8084,7.6,-1846
"Litchfield County, CT",CT,2011,107912,98938,8974,8.3,-377
"Litchfield County, CT",CT,2010,108289,98339,9950,9.2,0
"Little River County, AR",AR,2021,5250,5015,235,4.5,-103
"Little River County, AR",AR,2020,5353,5003,350,6.5,-176
"Little River County, AR",AR,2019,5529,5297,232,4.2,69
"Little River County, AR",AR,2018,5460,5177,283,5.2,-38
"Little River County, AR",AR,2017,5498,5230,268,4.9,-104
"Little River County, AR",AR,2016,5602,5339,263,4.7,-15
"Little River County, AR",AR,2015,5617,5315,302,5.4,30
"Little River County, AR",AR,2014,5587,5228,359,6.4,-154
"Little River County, AR",AR,2013,5741,5315,426,7.4,-264
"Little River County, AR",AR,2012,6005,5584,421,7.0,-109
"Little River County, AR",AR,2011,6114,5658,456,7.5,-99
"Little River County, AR",AR,2010,6213,5750,463,7.5,0
"Live Oak County, TX",TX,2021,4937,4601,336,6.8,-184
"Live Oak County, TX",TX,2020,5121,4736,385,7.5,-354
"Live Oak County, TX",TX,2019,5475,5306,169,3.1,342
"Live Oak County, TX",TX,2018,5133,4936,197,3.8,-244
"Live Oak County, TX",TX,2017,5377,5124,253,4.7,171
"Live Oak County, TX",TX,2016,5206,4897,309,5.9,-686
"Live Oak County, TX",TX,2015,5892,5654,238,4.0,-214
"Live Oak County, TX",TX,2014,6106,5885,221,3.6,86
"Live Oak County, TX",TX,2013,6020,5755,265,4.4,264
"Live Oak County, TX",TX,2012,5756,5494,262,4.6,525
"Live Oak County, TX",TX,2011,5231,4908,323,6.2,593
"Live Oak County, TX",TX,2010,4638,4296,342,7.4,0
"Livingston County, IL",IL,2021,15499,14739,760,4.9,-375
"Livingston County, IL",IL,2020,15874,14784,1090,6.9,-729
"Livingston County, IL",IL,2019,16603,15959,644,3.9,-92
"Livingston County, IL",IL,2018,16695,15976,719,4.3,11
"Livingston County, IL",IL,2017,16684,15941,743,4.5,-413
"Livingston County, IL",IL,2016,17097,16174,923,5.4,-190
"Livingston County, IL",IL,2015,17287,16355,932,5.4,-187
"Livingston County, IL",IL,2014,17474,16348,1126,6.4,-210
"Livingston County, IL",IL,2013,17684,16261,1423,8.0,-462
"Livingston County, IL",IL,2012,18146,16731,1415,7.8,-695
"Livingston County, IL",IL,2011,18841,17242,1599,8.5,-444
"Livingston County, IL",IL,2010,19285,17342,1943,10.1,0
"Livingston County, KY",KY,2021,3632,3409,223,6.1,133
"Livingston County, KY",KY,2020,3499,3242,257,7.3,-144
"Livingston County, KY",KY,2019,3643,3445,198,5.4,-20
"Livingston County, KY",KY,2018,3663,3421,242,6.6,-93
"Livingston County, KY",KY,2017,3756,3478,278,7.4,69
"Livingston County, KY",KY,2016,3687,3425,262,7.1,9
"Livingston County, KY",KY,2015,3678,3416,262,7.1,-83
"Livingston County, KY",KY,2014,3761,3453,308,8.2,-127
"Livingston County, KY",KY,2013,3888,3507,381,9.8,-88
"Livingston County, KY",KY,2012,3976,3588,388,9.8,-57
"Livingston County, KY",KY,2011,4033,3593,440,10.9,-24
"Livingston County, KY",KY,2010,4057,3564,493,12.2,0
"Livingston County, MI",MI,2021,101855,97621,4234,4.2,1062
"Livingston County, MI",MI,2020,100793,92104,8689,8.6,-5249
"Livingston County, MI",MI,2019,106042,102606,3436,3.2,1517
"Livingston County, MI",MI,2018,104525,101074,3451,3.3,1600
"Livingston County, MI",MI,2017,102925,99425,3500,3.4,2990
"Livingston County, MI",MI,2016,99935,95886,4049,4.1,3812
"Livingston County, MI",MI,2015,96123,91736,4387,4.6,756
"Livingston County, MI",MI,2014,95367,89348,6019,6.3,308
"Livingston County, MI",MI,2013,95059,88055,7004,7.4,1677
"Livingston County, MI",MI,2012,93382,86053,7329,7.8,1070
"Livingston County, MI",MI,2011,92312,84291,8021,8.7,-1132
"Livingston County, MI",MI,2010,93444,83377,10067,10.8,0
"Livingston County, MO",MO,2021,7256,7037,219,3.0,-33
"Livingston County, MO",MO,2020,7289,7019,270,3.7,-28
"Livingston County, MO",MO,2019,7317,7141,176,2.4,-173
"Livingston County, MO",MO,2018,7490,7307,183,2.4,37
"Livingston County, MO",MO,2017,7453,7235,218,2.9,111
"Livingston County, MO",MO,2016,7342,7056,286,3.9,83
"Livingston County, MO",MO,2015,7259,6944,315,4.3,-23
"Livingston County, MO",MO,2014,7282,6914,368,5.1,35
"Livingston County, MO",MO,2013,7247,6834,413,5.7,72
"Livingston County, MO",MO,2012,7175,6716,459,6.4,122
"Livingston County, MO",MO,2011,7053,6509,544,7.7,-65
"Livingston County, MO",MO,2010,7118,6541,577,8.1,0
"Livingston County, NY",NY,2021,29821,28533,1288,4.3,-433
"Livingston County, NY",NY,2020,30254,28189,2065,6.8,-1143
"Livingston County, NY",NY,2019,31397,30117,1280,4.1,49
"Livingston County, NY",NY,2018,31348,30001,1347,4.3,143
"Livingston County, NY",NY,2017,31205,29646,1559,5.0,153
"Livingston County, NY",NY,2016,31052,29491,1561,5.0,-143
"Livingston County, NY",NY,2015,31195,29543,1652,5.3,286
"Livingston County, NY",NY,2014,30909,29103,1806,5.8,-934
"Livingston County, NY",NY,2013,31843,29547,2296,7.2,-253
"Livingston County, NY",NY,2012,32096,29545,2551,7.9,53
"Livingston County, NY",NY,2011,32043,29583,2460,7.7,-740
"Livingston County, NY",NY,2010,32783,30079,2704,8.2,0
"Livingston Parish, LA",LA,2021,69221,66611,2610,3.8,494
"Livingston Parish, LA",LA,2020,68727,64067,4660,6.8,-880
"Livingston Parish, LA",LA,2019,69607,66865,2742,3.9,396
"Livingston Parish, LA",LA,2018,69211,66455,2756,4.0,1387
"Livingston Parish, LA",LA,2017,67824,64965,2859,4.2,-935
"Livingston Parish, LA",LA,2016,68759,65272,3487,5.1,743
"Livingston Parish, LA",LA,2015,68016,64556,3460,5.1,1713
"Livingston Parish, LA",LA,2014,66303,62728,3575,5.4,2193
"Livingston Parish, LA",LA,2013,64110,60514,3596,5.6,1664
"Livingston Parish, LA",LA,2012,62446,58633,3813,6.1,758
"Livingston Parish, LA",LA,2011,61688,57415,4273,6.9,441
"Livingston Parish, LA",LA,2010,61247,56907,4340,7.1,0
"Llano County, TX",TX,2021,8900,8469,431,4.8,507
"Llano County, TX",TX,2020,8393,7911,482,5.7,-153
"Llano County, TX",TX,2019,8546,8250,296,3.5,109
"Llano County, TX",TX,2018,8437,8122,315,3.7,133
"Llano County, TX",TX,2017,8304,7985,319,3.8,8
"Llano County, TX",TX,2016,8296,7950,346,4.2,144
"Llano County, TX",TX,2015,8152,7803,349,4.3,75
"Llano County, TX",TX,2014,8077,7654,423,5.2,-17
"Llano County, TX",TX,2013,8094,7569,525,6.5,47
"Llano County, TX",TX,2012,8047,7504,543,6.7,36
"Llano County, TX",TX,2011,8011,7371,640,8.0,6
"Llano County, TX",TX,2010,8005,7357,648,8.1,0
"Logan County, AR",AR,2021,8383,8033,350,4.2,-281
"Logan County, AR",AR,2020,8664,8085,579,6.7,134
"Logan County, AR",AR,2019,8530,8168,362,4.2,-204
"Logan County, AR",AR,2018,8734,8389,345,4.0,-163
"Logan County, AR",AR,2017,8897,8553,344,3.9,-248
"Logan County, AR",AR,2016,9145,8724,421,4.6,-59
"Logan County, AR",AR,2015,9204,8682,522,5.7,54
"Logan County, AR",AR,2014,9150,8616,534,5.8,-148
"Logan County, AR",AR,2013,9298,8593,705,7.6,-366
"Logan County, AR",AR,2012,9664,8922,742,7.7,48
"Logan County, AR",AR,2011,9616,8809,807,8.4,-179
"Logan County, AR",AR,2010,9795,8988,807,8.2,0
"Logan County, CO",CO,2021,10985,10505,480,4.4,118
"Logan County, CO",CO,2020,10867,10385,482,4.4,-178
"Logan County, CO",CO,2019,11045,10793,252,2.3,-61
"Logan County, CO",CO,2018,11106,10819,287,2.6,97
"Logan County, CO",CO,2017,11009,10770,239,2.2,-8
"Logan County, CO",CO,2016,11017,10707,310,2.8,82
"Logan County, CO",CO,2015,10935,10614,321,2.9,-57
"Logan County, CO",CO,2014,10992,10577,415,3.8,195
"Logan County, CO",CO,2013,10797,10253,544,5.0,-236
"Logan County, CO",CO,2012,11033,10363,670,6.1,-19
"Logan County, CO",CO,2011,11052,10331,721,6.5,-163
"Logan County, CO",CO,2010,11215,10469,746,6.7,0
"Logan County, IL",IL,2021,11820,11253,567,4.8,-237
"Logan County, IL",IL,2020,12057,11226,831,6.9,-615
"Logan County, IL",IL,2019,12672,12146,526,4.2,-257
"Logan County, IL",IL,2018,12929,12328,601,4.6,56
"Logan County, IL",IL,2017,12873,12279,594,4.6,-224
"Logan County, IL",IL,2016,13097,12398,699,5.3,90
"Logan County, IL",IL,2015,13007,12301,706,5.4,11
"Logan County, IL",IL,2014,12996,12157,839,6.5,-56
"Logan County, IL",IL,2013,13052,12000,1052,8.1,-398
"Logan County, IL",IL,2012,13450,12435,1015,7.5,-246
"Logan County, IL",IL,2011,13696,12629,1067,7.8,-216
"Logan County, IL",IL,2010,13912,12688,1224,8.8,0
"Logan County, KS",KS,2021,1632,1606,26,1.6,24
"Logan County, KS",KS,2020,1608,1571,37,2.3,-21
"Logan County, KS",KS,2019,1629,1596,33,2.0,-63
"Logan County, KS",KS,2018,1692,1657,35,2.1,11
"Logan County, KS",KS,2017,1681,1645,36,2.1,-50
"Logan County, KS",KS,2016,1731,1687,44,2.5,-29
"Logan County, KS",KS,2015,1760,1717,43,2.4,23
"Logan County, KS",KS,2014,1737,1698,39,2.2,-10
"Logan County, KS",KS,2013,1747,1698,49,2.8,-14
"Logan County, KS",KS,2012,1761,1708,53,3.0,-22
"Logan County, KS",KS,2011,1783,1726,57,3.2,45
"Logan County, KS",KS,2010,1738,1677,61,3.5,0
"Logan County, KY",KY,2021,12296,11829,467,3.8,193
"Logan County, KY",KY,2020,12103,11454,649,5.4,-493
"Logan County, KY",KY,2019,12596,12114,482,3.8,183
"Logan County, KY",KY,2018,12413,11946,467,3.8,249
"Logan County, KY",KY,2017,12164,11641,523,4.3,429
"Logan County, KY",KY,2016,11735,11225,510,4.3,287
"Logan County, KY",KY,2015,11448,10903,545,4.8,-478
"Logan County, KY",KY,2014,11926,11254,672,5.6,-211
"Logan County, KY",KY,2013,12137,11282,855,7.0,-61
"Logan County, KY",KY,2012,12198,11271,927,7.6,-273
"Logan County, KY",KY,2011,12471,11359,1112,8.9,-209
"Logan County, KY",KY,2010,12680,11409,1271,10.0,0
"Logan County, ND",ND,2021,863,837,26,3.0,-1
"Logan County, ND",ND,2020,864,836,28,3.2,-10
"Logan County, ND",ND,2019,874,856,18,2.1,-36
"Logan County, ND",ND,2018,910,890,20,2.2,-47
"Logan County, ND",ND,2017,957,933,24,2.5,0
"Logan County, ND",ND,2016,957,924,33,3.4,16
"Logan County, ND",ND,2015,941,914,27,2.9,23
"Logan County, ND",ND,2014,918,891,27,2.9,10
"Logan County, ND",ND,2013,908,880,28,3.1,5
"Logan County, ND",ND,2012,903,877,26,2.9,-72
"Logan County, ND",ND,2011,975,946,29,3.0,-27
"Logan County, ND",ND,2010,1002,967,35,3.5,0
"Logan County, NE",NE,2021,471,463,8,1.7,-5
"Logan County, NE",NE,2020,476,464,12,2.5,-2
"Logan County, NE",NE,2019,478,464,14,2.9,8
"Logan County, NE",NE,2018,470,456,14,3.0,-5
"Logan County, NE",NE,2017,475,462,13,2.7,-11
"Logan County, NE",NE,2016,486,472,14,2.9,-9
"Logan County, NE",NE,2015,495,480,15,3.0,0
"Logan County, NE",NE,2014,495,480,15,3.0,-7
"Logan County, NE",NE,2013,502,486,16,3.2,-2
"Logan County, NE",NE,2012,504,489,15,3.0,-5
"Logan County, NE",NE,2011,509,491,18,3.5,17
"Logan County, NE",NE,2010,492,469,23,4.7,0
"Logan County, OH",OH,2021,22462,21532,930,4.1,-237
"Logan County, OH",OH,2020,22699,20836,1863,8.2,-334
"Logan County, OH",OH,2019,23033,22186,847,3.7,-210
"Logan County, OH",OH,2018,23243,22382,861,3.7,-410
"Logan County, OH",OH,2017,23653,22691,962,4.1,240
"Logan County, OH",OH,2016,23413,22426,987,4.2,241
"Logan County, OH",OH,2015,23172,22186,986,4.3,26
"Logan County, OH",OH,2014,23146,21983,1163,5.0,115
"Logan County, OH",OH,2013,23031,21459,1572,6.8,425
"Logan County, OH",OH,2012,22606,20992,1614,7.1,-178
"Logan County, OH",OH,2011,22784,20566,2218,9.7,-596
"Logan County, OH",OH,2010,23380,20614,2766,11.8,0
"Logan County, OK",OK,2021,22737,21997,740,3.3,510
"Logan County, OK",OK,2020,22227,21070,1157,5.2,-21
"Logan County, OK",OK,2019,22248,21640,608,2.7,374
"Logan County, OK",OK,2018,21874,21235,639,2.9,285
"Logan County, OK",OK,2017,21589,20836,753,3.5,30
"Logan County, OK",OK,2016,21559,20717,842,3.9,98
"Logan County, OK",OK,2015,21461,20665,796,3.7,479
"Logan County, OK",OK,2014,20982,20169,813,3.9,257
"Logan County, OK",OK,2013,20725,19811,914,4.4,202
"Logan County, OK",OK,2012,20523,19653,870,4.2,363
"Logan County, OK",OK,2011,20160,19226,934,4.6,373
"Logan County, OK",OK,2010,19787,18711,1076,5.4,0
"Logan County, WV",WV,2021,11111,10376,735,6.6,48
"Logan County, WV",WV,2020,11063,9752,1311,11.9,-106
"Logan County, WV",WV,2019,11169,10505,664,5.9,330
"Logan County, WV",WV,2018,10839,10100,739,6.8,-5
"Logan County, WV",WV,2017,10844,10035,809,7.5,-351
"Logan County, WV",WV,2016,11195,10052,1143,10.2,-425
"Logan County, WV",WV,2015,11620,10345,1275,11.0,-378
"Logan County, WV",WV,2014,11998,10756,1242,10.4,-392
"Logan County, WV",WV,2013,12390,11185,1205,9.7,-506
"Logan County, WV",WV,2012,12896,11680,1216,9.4,-11
"Logan County, WV",WV,2011,12907,11786,1121,8.7,232
"Logan County, WV",WV,2010,12675,11388,1287,10.2,0
"Loiza Municipio, PR",PR,2021,8974,8187,787,8.8,
"Loiza Municipio, PR",PR,2020,N.A.,N.A.,N.A.,N.A.,
"Loiza Municipio, PR",PR,2019,8347,7708,639,7.7,37
"Loiza Municipio, PR",PR,2018,8310,7619,691,8.3,-118
"Loiza Municipio, PR",PR,2017,8428,7619,809,9.6,-226
"Loiza Municipio, PR",PR,2016,8654,7675,979,11.3,-139
"Loiza Municipio, PR",PR,2015,8793,7760,1033,11.7,-151
"Loiza Municipio, PR",PR,2014,8944,7761,1183,13.2,-176
"Loiza Municipio, PR",PR,2013,9120,7979,1141,12.5,-257
"Loiza Municipio, PR",PR,2012,9377,8171,1206,12.9,-279
"Loiza Municipio, PR",PR,2011,9656,8200,1456,15.1,-584
"Loiza Municipio, PR",PR,2010,10240,8523,1717,16.8,0
"Long County, GA",GA,2021,8467,8210,257,3.0,283
"Long County, GA",GA,2020,8184,7828,356,4.3,-169
"Long County, GA",GA,2019,8353,8035,318,3.8,283
"Long County, GA",GA,2018,8070,7746,324,4.0,17
"Long County, GA",GA,2017,8053,7660,393,4.9,629
"Long County, GA",GA,2016,7424,7018,406,5.5,419
"Long County, GA",GA,2015,7005,6587,418,6.0,315
"Long County, GA",GA,2014,6690,6192,498,7.4,2
"Long County, GA",GA,2013,6688,6148,540,8.1,63
"Long County, GA",GA,2012,6625,6067,558,8.4,261
"Long County, GA",GA,2011,6364,5803,561,8.8,118
"Long County, GA",GA,2010,6246,5713,533,8.5,0
"Lonoke County, AR",AR,2021,33141,32034,1107,3.3,-620
"Lonoke County, AR",AR,2020,33761,31886,1875,5.6,-520
"Lonoke County, AR",AR,2019,34281,33199,1082,3.2,116
"Lonoke County, AR",AR,2018,34165,33096,1069,3.1,325
"Lonoke County, AR",AR,2017,33840,32727,1113,3.3,398
"Lonoke County, AR",AR,2016,33442,32327,1115,3.3,304
"Lonoke County, AR",AR,2015,33138,31769,1369,4.1,137
"Lonoke County, AR",AR,2014,33001,31356,1645,5.0,5
"Lonoke County, AR",AR,2013,32996,31033,1963,5.9,-238
"Lonoke County, AR",AR,2012,33234,31210,2024,6.1,-70
"Lonoke County, AR",AR,2011,33304,31099,2205,6.6,39
"Lonoke County, AR",AR,2010,33265,31105,2160,6.5,0
"Lorain County, OH",OH,2021,151288,142587,8701,5.8,-513
"Lorain County, OH",OH,2020,151801,136706,15095,9.9,-6543
"Lorain County, OH",OH,2019,158344,151370,6974,4.4,2040
"Lorain County, OH",OH,2018,156304,148445,7859,5.0,676
"Lorain County, OH",OH,2017,155628,146182,9446,6.1,3364
"Lorain County, OH",OH,2016,152264,143118,9146,6.0,2369
"Lorain County, OH",OH,2015,149895,141498,8397,5.6,-320
"Lorain County, OH",OH,2014,150215,140520,9695,6.5,150
"Lorain County, OH",OH,2013,150065,138932,11133,7.4,262
"Lorain County, OH",OH,2012,149803,139170,10633,7.1,-2083
"Lorain County, OH",OH,2011,151886,139980,11906,7.8,-1639
"Lorain County, OH",OH,2010,153525,139440,14085,9.2,0
"Los Alamos County, NM",NM,2021,10035,9737,298,3.0,247
"Los Alamos County, NM",NM,2020,9788,9432,356,3.6,131
"Los Alamos County, NM",NM,2019,9657,9345,312,3.2,465
"Los Alamos County, NM",NM,2018,9192,8882,310,3.4,-29
"Los Alamos County, NM",NM,2017,9221,8871,350,3.8,359
"Los Alamos County, NM",NM,2016,8862,8482,380,4.3,304
"Los Alamos County, NM",NM,2015,8558,8208,350,4.1,49
"Los Alamos County, NM",NM,2014,8509,8162,347,4.1,-164
"Los Alamos County, NM",NM,2013,8673,8308,365,4.2,-343
"Los Alamos County, NM",NM,2012,9016,8672,344,3.8,-224
"Los Alamos County, NM",NM,2011,9240,8927,313,3.4,-165
"Los Alamos County, NM",NM,2010,9405,9076,329,3.5,0
"Los Angeles County, CA",CA,2021,4994057,4548852,445205,8.9,25145
"Los Angeles County, CA",CA,2020,4968912,4355926,612986,12.3,-184179
"Los Angeles County, CA",CA,2019,5153091,4926056,227035,4.4,31812
"Los Angeles County, CA",CA,2018,5121279,4885329,235950,4.6,11469
"Los Angeles County, CA",CA,2017,5109810,4864120,245690,4.8,90890
"Los Angeles County, CA",CA,2016,5018920,4751209,267711,5.3,45164
"Los Angeles County, CA",CA,2015,4973756,4641054,332702,6.7,-8656
"Los Angeles County, CA",CA,2014,4982412,4572171,410241,8.2,26606
"Los Angeles County, CA",CA,2013,4955806,4471400,484406,9.8,50923
"Los Angeles County, CA",CA,2012,4904883,4365690,539193,11.0,-36784
"Los Angeles County, CA",CA,2011,4941667,4337370,604297,12.2,995
"Los Angeles County, CA",CA,2010,4940672,4318722,621950,12.6,0
"Loudon County, TN",TN,2021,23966,23152,814,3.4,255
"Loudon County, TN",TN,2020,23711,22242,1469,6.2,-182
"Loudon County, TN",TN,2019,23893,23083,810,3.4,719
"Loudon County, TN",TN,2018,23174,22389,785,3.4,511
"Loudon County, TN",TN,2017,22663,21827,836,3.7,368
"Loudon County, TN",TN,2016,22295,21250,1045,4.7,314
"Loudon County, TN",TN,2015,21981,20760,1221,5.6,141
"Loudon County, TN",TN,2014,21840,20378,1462,6.7,-319
"Loudon County, TN",TN,2013,22159,20442,1717,7.7,-147
"Loudon County, TN",TN,2012,22306,20587,1719,7.7,-235
"Loudon County, TN",TN,2011,22541,20551,1990,8.8,169
"Loudon County, TN",TN,2010,22372,20259,2113,9.4,0
"Loudoun County, VA",VA,2021,222649,215775,6874,3.1,-4601
"Loudoun County, VA",VA,2020,227250,215250,12000,5.3,-2381
"Loudoun County, VA",VA,2019,229631,224380,5251,2.3,7805
"Loudoun County, VA",VA,2018,221826,216382,5444,2.5,5650
"Loudoun County, VA",VA,2017,216176,209681,6495,3.0,8574
"Loudoun County, VA",VA,2016,207602,201078,6524,3.1,6711
"Loudoun County, VA",VA,2015,200891,193830,7061,3.5,4194
"Loudoun County, VA",VA,2014,196697,188499,8198,4.2,5532
"Loudoun County, VA",VA,2013,191165,182994,8171,4.3,5307
"Loudoun County, VA",VA,2012,185858,177761,8097,4.4,4617
"Loudoun County, VA",VA,2011,181241,172808,8433,4.7,5648
"Loudoun County, VA",VA,2010,175593,166403,9190,5.2,0
"Louisa County, IA",IA,2021,5903,5650,253,4.3,-82
"Louisa County, IA",IA,2020,5985,5697,288,4.8,-182
"Louisa County, IA",IA,2019,6167,5988,179,2.9,26
"Louisa County, IA",IA,2018,6141,5980,161,2.6,12
"Louisa County, IA",IA,2017,6129,5932,197,3.2,-5
"Louisa County, IA",IA,2016,6134,5896,238,3.9,109
"Louisa County, IA",IA,2015,6025,5799,226,3.8,92
"Louisa County, IA",IA,2014,5933,5667,266,4.5,75
"Louisa County, IA",IA,2013,5858,5562,296,5.1,46
"Louisa County, IA",IA,2012,5812,5492,320,5.5,-119
"Louisa County, IA",IA,2011,5931,5563,368,6.2,-19
"Louisa County, IA",IA,2010,5950,5510,440,7.4,0
"Louisa County, VA",VA,2021,19910,19239,671,3.4,-101
"Louisa County, VA",VA,2020,20011,18973,1038,5.2,-338
"Louisa County, VA",VA,2019,20349,19810,539,2.6,391
"Louisa County, VA",VA,2018,19958,19408,550,2.8,193
"Louisa County, VA",VA,2017,19765,19098,667,3.4,1170
"Louisa County, VA",VA,2016,18595,17895,700,3.8,-271
"Louisa County, VA",VA,2015,18866,18078,788,4.2,353
"Louisa County, VA",VA,2014,18513,17591,922,5.0,457
"Louisa County, VA",VA,2013,18056,17057,999,5.5,120
"Louisa County, VA",VA,2012,17936,16842,1094,6.1,23
"Louisa County, VA",VA,2011,17913,16695,1218,6.8,34
"Louisa County, VA",VA,2010,17879,16505,1374,7.7,0
"Loup County, NE",NE,2021,400,392,8,2.0,-9
"Loup County, NE",NE,2020,409,396,13,3.2,-11
"Loup County, NE",NE,2019,420,403,17,4.0,18
"Loup County, NE",NE,2018,402,389,13,3.2,0
"Loup County, NE",NE,2017,402,390,12,3.0,4
"Loup County, NE",NE,2016,398,384,14,3.5,19
"Loup County, NE",NE,2015,379,366,13,3.4,-3
"Loup County, NE",NE,2014,382,367,15,3.9,5
"Loup County, NE",NE,2013,377,360,17,4.5,-14
"Loup County, NE",NE,2012,391,377,14,3.6,12
"Loup County, NE",NE,2011,379,361,18,4.7,11
"Loup County, NE",NE,2010,368,347,21,5.7,0
"Love County, OK",OK,2021,6054,5896,158,2.6,-441
"Love County, OK",OK,2020,6495,6218,277,4.3,341
"Love County, OK",OK,2019,6154,6021,133,2.2,-257
"Love County, OK",OK,2018,6411,6278,133,2.1,-150
"Love County, OK",OK,2017,6561,6376,185,2.8,-7
"Love County, OK",OK,2016,6568,6368,200,3.0,594
"Love County, OK",OK,2015,5974,5767,207,3.5,542
"Love County, OK",OK,2014,5432,5243,189,3.5,187
"Love County, OK",OK,2013,5245,5023,222,4.2,153
"Love County, OK",OK,2012,5092,4883,209,4.1,190
"Love County, OK",OK,2011,4902,4667,235,4.8,134
"Love County, OK",OK,2010,4768,4507,261,5.5,0
"Loving County, TX",TX,2021,438,434,4,0.9,143
"Loving County, TX",TX,2020,295,290,5,1.7,-203
"Loving County, TX",TX,2019,498,494,4,0.8,233
"Loving County, TX",TX,2018,265,261,4,1.5,165
"Loving County, TX",TX,2017,100,95,5,5.0,14
"Loving County, TX",TX,2016,86,82,4,4.7,9
"Loving County, TX",TX,2015,77,73,4,5.2,-1
"Loving County, TX",TX,2014,78,74,4,5.1,3
"Loving County, TX",TX,2013,75,71,4,5.3,8
"Loving County, TX",TX,2012,67,63,4,6.0,1
"Loving County, TX",TX,2011,66,62,4,6.1,-5
"Loving County, TX",TX,2010,71,67,4,5.6,0
"Lowndes County, AL",AL,2021,3578,3248,330,9.2,-145
"Lowndes County, AL",AL,2020,3723,3182,541,14.5,166
"Lowndes County, AL",AL,2019,3557,3342,215,6.0,-97
"Lowndes County, AL",AL,2018,3654,3389,265,7.3,-50
"Lowndes County, AL",AL,2017,3704,3393,311,8.4,-66
"Lowndes County, AL",AL,2016,3770,3371,399,10.6,-49
"Lowndes County, AL",AL,2015,3819,3376,443,11.6,-60
"Lowndes County, AL",AL,2014,3879,3384,495,12.8,-131
"Lowndes County, AL",AL,2013,4010,3436,574,14.3,-83
"Lowndes County, AL",AL,2012,4093,3448,645,15.8,-140
"Lowndes County, AL",AL,2011,4233,3491,742,17.5,-109
"Lowndes County, AL",AL,2010,4342,3555,787,18.1,0
"Lowndes County, GA",GA,2021,51719,49616,2103,4.1,227
"Lowndes County, GA",GA,2020,51492,48386,3106,6.0,-246
"Lowndes County, GA",GA,2019,51738,49834,1904,3.7,-176
"Lowndes County, GA",GA,2018,51914,49772,2142,4.1,-283
"Lowndes County, GA",GA,2017,52197,49748,2449,4.7,885
"Lowndes County, GA",GA,2016,51312,48569,2743,5.3,1522
"Lowndes County, GA",GA,2015,49790,46796,2994,6.0,-677
"Lowndes County, GA",GA,2014,50467,46786,3681,7.3,-568
"Lowndes County, GA",GA,2013,51035,46965,4070,8.0,-1247
"Lowndes County, GA",GA,2012,52282,47580,4702,9.0,1006
"Lowndes County, GA",GA,2011,51276,46228,5048,9.8,111
"Lowndes County, GA",GA,2010,51165,46177,4988,9.7,0
"Lowndes County, MS",MS,2021,24797,23333,1464,5.9,157
"Lowndes County, MS",MS,2020,24640,22625,2015,8.2,-1092
"Lowndes County, MS",MS,2019,25732,24376,1356,5.3,602
"Lowndes County, MS",MS,2018,25130,23874,1256,5.0,-111
"Lowndes County, MS",MS,2017,25241,23851,1390,5.5,-164
"Lowndes County, MS",MS,2016,25405,23813,1592,6.3,358
"Lowndes County, MS",MS,2015,25047,23264,1783,7.1,-142
"Lowndes County, MS",MS,2014,25189,22968,2221,8.8,-1798
"Lowndes County, MS",MS,2013,26987,24493,2494,9.2,-824
"Lowndes County, MS",MS,2012,27811,25319,2492,9.0,429
"Lowndes County, MS",MS,2011,27382,24565,2817,10.3,1198
"Lowndes County, MS",MS,2010,26184,23166,3018,11.5,0
"Lubbock County, TX",TX,2021,160338,153092,7246,4.5,4535
"Lubbock County, TX",TX,2020,155803,146854,8949,5.7,-483
"Lubbock County, TX",TX,2019,156286,151849,4437,2.8,1276
"Lubbock County, TX",TX,2018,155010,150231,4779,3.1,193
"Lubbock County, TX",TX,2017,154817,149850,4967,3.2,1191
"Lubbock County, TX",TX,2016,153626,148411,5215,3.4,3996
"Lubbock County, TX",TX,2015,149630,144499,5131,3.4,2062
"Lubbock County, TX",TX,2014,147568,141676,5892,4.0,431
"Lubbock County, TX",TX,2013,147137,139809,7328,5.0,1856
"Lubbock County, TX",TX,2012,145281,137565,7716,5.3,-385
"Lubbock County, TX",TX,2011,145666,136634,9032,6.2,2145
"Lubbock County, TX",TX,2010,143521,134500,9021,6.3,0
"Lucas County, IA",IA,2021,4606,4463,143,3.1,-39
"Lucas County, IA",IA,2020,4645,4479,166,3.6,-97
"Lucas County, IA",IA,2019,4742,4650,92,1.9,184
"Lucas County, IA",IA,2018,4558,4468,90,2.0,151
"Lucas County, IA",IA,2017,4407,4285,122,2.8,3
"Lucas County, IA",IA,2016,4404,4266,138,3.1,2
"Lucas County, IA",IA,2015,4402,4248,154,3.5,91
"Lucas County, IA",IA,2014,4311,4143,168,3.9,59
"Lucas County, IA",IA,2013,4252,4052,200,4.7,52
"Lucas County, IA",IA,2012,4200,3999,201,4.8,-3
"Lucas County, IA",IA,2011,4203,3977,226,5.4,-18
"Lucas County, IA",IA,2010,4221,3959,262,6.2,0
"Lucas County, OH",OH,2021,204976,192214,12762,6.2,-3104
"Lucas County, OH",OH,2020,208080,186564,21516,10.3,-3783
"Lucas County, OH",OH,2019,211863,201934,9929,4.7,1179
"Lucas County, OH",OH,2018,210684,199681,11003,5.2,-874
"Lucas County, OH",OH,2017,211558,199138,12420,5.9,309
"Lucas County, OH",OH,2016,211249,200233,11016,5.2,1794
"Lucas County, OH",OH,2015,209455,198218,11237,5.4,36
"Lucas County, OH",OH,2014,209419,195995,13424,6.4,-1155
"Lucas County, OH",OH,2013,210574,192357,18217,8.7,105
"Lucas County, OH",OH,2012,210469,192955,17514,8.3,-2282
"Lucas County, OH",OH,2011,212751,191763,20988,9.9,-4984
"Lucas County, OH",OH,2010,217735,192562,25173,11.6,0
"Luce County, MI",MI,2021,2119,1969,150,7.1,-105
"Luce County, MI",MI,2020,2224,2022,202,9.1,-46
"Luce County, MI",MI,2019,2270,2124,146,6.4,-112
"Luce County, MI",MI,2018,2382,2232,150,6.3,-30
"Luce County, MI",MI,2017,2412,2250,162,6.7,3
"Luce County, MI",MI,2016,2409,2245,164,6.8,-63
"Luce County, MI",MI,2015,2472,2297,175,7.1,-16
"Luce County, MI",MI,2014,2488,2276,212,8.5,82
"Luce County, MI",MI,2013,2406,2159,247,10.3,31
"Luce County, MI",MI,2012,2375,2118,257,10.8,-29
"Luce County, MI",MI,2011,2404,2122,282,11.7,-69
"Luce County, MI",MI,2010,2473,2151,322,13.0,0
"Lumpkin County, GA",GA,2021,17402,16923,479,2.8,845
"Lumpkin County, GA",GA,2020,16557,15770,787,4.8,-403
"Lumpkin County, GA",GA,2019,16960,16398,562,3.3,201
"Lumpkin County, GA",GA,2018,16759,16154,605,3.6,-139
"Lumpkin County, GA",GA,2017,16898,16191,707,4.2,923
"Lumpkin County, GA",GA,2016,15975,15199,776,4.9,830
"Lumpkin County, GA",GA,2015,15145,14312,833,5.5,-87
"Lumpkin County, GA",GA,2014,15232,14260,972,6.4,110
"Lumpkin County, GA",GA,2013,15122,14015,1107,7.3,-4
"Lumpkin County, GA",GA,2012,15126,13882,1244,8.2,276
"Lumpkin County, GA",GA,2011,14850,13415,1435,9.7,102
"Lumpkin County, GA",GA,2010,14748,13200,1548,10.5,0
"Luna County, NM",NM,2021,9989,8471,1518,15.2,-196
"Luna County, NM",NM,2020,10185,8590,1595,15.7,-289
"Luna County, NM",NM,2019,10474,9182,1292,12.3,236
"Luna County, NM",NM,2018,10238,9034,1204,11.8,-419
"Luna County, NM",NM,2017,10657,9178,1479,13.9,-213
"Luna County, NM",NM,2016,10870,9283,1587,14.6,-260
"Luna County, NM",NM,2015,11130,9184,1946,17.5,-280
"Luna County, NM",NM,2014,11410,9373,2037,17.9,48
"Luna County, NM",NM,2013,11362,9210,2152,18.9,-76
"Luna County, NM",NM,2012,11438,9195,2243,19.6,72
"Luna County, NM",NM,2011,11366,9146,2220,19.5,-150
"Luna County, NM",NM,2010,11516,9288,2228,19.3,0
"Lunenburg County, VA",VA,2021,5044,4852,192,3.8,-210
"Lunenburg County, VA",VA,2020,5254,4979,275,5.2,-133
"Lunenburg County, VA",VA,2019,5387,5219,168,3.1,15
"Lunenburg County, VA",VA,2018,5372,5201,171,3.2,-32
"Lunenburg County, VA",VA,2017,5404,5182,222,4.1,144
"Lunenburg County, VA",VA,2016,5260,5021,239,4.5,-45
"Lunenburg County, VA",VA,2015,5305,5038,267,5.0,-53
"Lunenburg County, VA",VA,2014,5358,5048,310,5.8,33
"Lunenburg County, VA",VA,2013,5325,4958,367,6.9,-50
"Lunenburg County, VA",VA,2012,5375,4977,398,7.4,-125
"Lunenburg County, VA",VA,2011,5500,5032,468,8.5,-58
"Lunenburg County, VA",VA,2010,5558,5018,540,9.7,0
"Luquillo Municipio, PR",PR,2021,6622,6035,587,8.9,
"Luquillo Municipio, PR",PR,2020,N.A.,N.A.,N.A.,N.A.,
"Luquillo Municipio, PR",PR,2019,6202,5613,589,9.5,-135
"Luquillo Municipio, PR",PR,2018,6337,5483,854,13.5,114
"Luquillo Municipio, PR",PR,2017,6223,5424,799,12.8,-110
"Luquillo Municipio, PR",PR,2016,6333,5434,899,14.2,-122
"Luquillo Municipio, PR",PR,2015,6455,5451,1004,15.6,-203
"Luquillo Municipio, PR",PR,2014,6658,5377,1281,19.2,-138
"Luquillo Municipio, PR",PR,2013,6796,5513,1283,18.9,-185
"Luquillo Municipio, PR",PR,2012,6981,5609,1372,19.7,-91
"Luquillo Municipio, PR",PR,2011,7072,5600,1472,20.8,-184
"Luquillo Municipio, PR",PR,2010,7256,5767,1489,20.5,0
"Luzerne County, PA",PA,2021,156930,143982,12948,8.3,-2513
"Luzerne County, PA",PA,2020,159443,141990,17453,10.9,-649
"Luzerne County, PA",PA,2019,160092,150771,9321,5.8,419
"Luzerne County, PA",PA,2018,159673,150704,8969,5.6,-395
"Luzerne County, PA",PA,2017,160068,150490,9578,6.0,870
"Luzerne County, PA",PA,2016,159198,149291,9907,6.2,328
"Luzerne County, PA",PA,2015,158870,148426,10444,6.6,-20
"Luzerne County, PA",PA,2014,158890,147114,11776,7.4,-1204
"Luzerne County, PA",PA,2013,160094,145551,14543,9.1,-328
"Luzerne County, PA",PA,2012,160422,145056,15366,9.6,978
"Luzerne County, PA",PA,2011,159444,144450,14994,9.4,232
"Luzerne County, PA",PA,2010,159212,143804,15408,9.7,0
"Lycoming County, PA",PA,2021,55322,51607,3715,6.7,-1438
"Lycoming County, PA",PA,2020,56760,51752,5008,8.8,-797
"Lycoming County, PA",PA,2019,57557,54714,2843,4.9,-394
"Lycoming County, PA",PA,2018,57951,55068,2883,5.0,-438
"Lycoming County, PA",PA,2017,58389,55072,3317,5.7,-408
"Lycoming County, PA",PA,2016,58797,54941,3856,6.6,-2136
"Lycoming County, PA",PA,2015,60933,57180,3753,6.2,-539
"Lycoming County, PA",PA,2014,61472,57647,3825,6.2,-172
"Lycoming County, PA",PA,2013,61644,56975,4669,7.6,-974
"Lycoming County, PA",PA,2012,62618,57796,4822,7.7,1655
"Lycoming County, PA",PA,2011,60963,56344,4619,7.6,1679
"Lycoming County, PA",PA,2010,59284,54149,5135,8.7,0
"Lyman County, SD",SD,2021,1691,1617,74,4.4,33
"Lyman County, SD",SD,2020,1658,1568,90,5.4,-11
"Lyman County, SD",SD,2019,1669,1601,68,4.1,-21
"Lyman County, SD",SD,2018,1690,1625,65,3.8,-53
"Lyman County, SD",SD,2017,1743,1662,81,4.6,-41
"Lyman County, SD",SD,2016,1784,1700,84,4.7,-20
"Lyman County, SD",SD,2015,1804,1721,83,4.6,-12
"Lyman County, SD",SD,2014,1816,1741,75,4.1,-56
"Lyman County, SD",SD,2013,1872,1784,88,4.7,-26
"Lyman County, SD",SD,2012,1898,1791,107,5.6,-27
"Lyman County, SD",SD,2011,1925,1805,120,6.2,-32
"Lyman County, SD",SD,2010,1957,1832,125,6.4,0
"Lynchburg city, VA",VA,2021,34699,32939,1760,5.1,-1162
"Lynchburg city, VA",VA,2020,35861,33263,2598,7.2,-1115
"Lynchburg city, VA",VA,2019,36976,35617,1359,3.7,378
"Lynchburg city, VA",VA,2018,36598,35146,1452,4.0,226
"Lynchburg city, VA",VA,2017,36372,34606,1766,4.9,815
"Lynchburg city, VA",VA,2016,35557,33738,1819,5.1,-206
"Lynchburg city, VA",VA,2015,35763,33791,1972,5.5,-349
"Lynchburg city, VA",VA,2014,36112,33853,2259,6.3,372
"Lynchburg city, VA",VA,2013,35740,33266,2474,6.9,204
"Lynchburg city, VA",VA,2012,35536,32933,2603,7.3,-167
"Lynchburg city, VA",VA,2011,35703,32834,2869,8.0,-196
"Lynchburg city, VA",VA,2010,35899,32781,3118,8.7,0
"Lynn County, TX",TX,2021,2798,2678,120,4.3,76
"Lynn County, TX",TX,2020,2722,2573,149,5.5,-28
"Lynn County, TX",TX,2019,2750,2668,82,3.0,29
"Lynn County, TX",TX,2018,2721,2632,89,3.3,-32
"Lynn County, TX",TX,2017,2753,2649,104,3.8,22
"Lynn County, TX",TX,2016,2731,2622,109,4.0,-32
"Lynn County, TX",TX,2015,2763,2651,112,4.1,-95
"Lynn County, TX",TX,2014,2858,2731,127,4.4,4
"Lynn County, TX",TX,2013,2854,2702,152,5.3,-94
"Lynn County, TX",TX,2012,2948,2770,178,6.0,-134
"Lynn County, TX",TX,2011,3082,2872,210,6.8,9
"Lynn County, TX",TX,2010,3073,2870,203,6.6,0
"Lyon County, IA",IA,2021,6941,6782,159,2.3,52
"Lyon County, IA",IA,2020,6889,6720,169,2.5,-316
"Lyon County, IA",IA,2019,7205,7092,113,1.6,119
"Lyon County, IA",IA,2018,7086,6978,108,1.5,23
"Lyon County, IA",IA,2017,7063,6941,122,1.7,-62
"Lyon County, IA",IA,2016,7125,6981,144,2.0,61
"Lyon County, IA",IA,2015,7064,6924,140,2.0,48
"Lyon County, IA",IA,2014,7016,6838,178,2.5,152
"Lyon County, IA",IA,2013,6864,6665,199,2.9,3
"Lyon County, IA",IA,2012,6861,6657,204,3.0,59
"Lyon County, IA",IA,2011,6802,6586,216,3.2,417
"Lyon County, IA",IA,2010,6385,6135,250,3.9,0
"Lyon County, KS",KS,2021,16921,16440,481,2.8,311
"Lyon County, KS",KS,2020,16610,15861,749,4.5,-187
"Lyon County, KS",KS,2019,16797,16235,562,3.3,135
"Lyon County, KS",KS,2018,16662,16088,574,3.4,-202
"Lyon County, KS",KS,2017,16864,16228,636,3.8,-33
"Lyon County, KS",KS,2016,16897,16206,691,4.1,215
"Lyon County, KS",KS,2015,16682,15966,716,4.3,143
"Lyon County, KS",KS,2014,16539,15698,841,5.1,73
"Lyon County, KS",KS,2013,16466,15283,1183,7.2,-827
"Lyon County, KS",KS,2012,17293,16291,1002,5.8,-122
"Lyon County, KS",KS,2011,17415,16316,1099,6.3,-67
"Lyon County, KS",KS,2010,17482,16331,1151,6.6,0
"Lyon County, KY",KY,2021,3113,2974,139,4.5,59
"Lyon County, KY",KY,2020,3054,2897,157,5.1,-67
"Lyon County, KY",KY,2019,3121,2980,141,4.5,72
"Lyon County, KY",KY,2018,3049,2899,150,4.9,56
"Lyon County, KY",KY,2017,2993,2822,171,5.7,32
"Lyon County, KY",KY,2016,2961,2789,172,5.8,97
"Lyon County, KY",KY,2015,2864,2701,163,5.7,-119
"Lyon County, KY",KY,2014,2983,2775,208,7.0,-110
"Lyon County, KY",KY,2013,3093,2841,252,8.1,-11
"Lyon County, KY",KY,2012,3104,2817,287,9.2,18
"Lyon County, KY",KY,2011,3086,2767,319,10.3,87
"Lyon County, KY",KY,2010,2999,2648,351,11.7,0
"Lyon County, MN",MN,2021,13966,13583,383,2.7,-701
"Lyon County, MN",MN,2020,14667,13999,668,4.6,-5
"Lyon County, MN",MN,2019,14672,14175,497,3.4,-151
"Lyon County, MN",MN,2018,14823,14371,452,3.0,-211
"Lyon County, MN",MN,2017,15034,14549,485,3.2,-142
"Lyon County, MN",MN,2016,15176,14637,539,3.6,-143
"Lyon County, MN",MN,2015,15319,14816,503,3.3,3
"Lyon County, MN",MN,2014,15316,14750,566,3.7,21
"Lyon County, MN",MN,2013,15295,14653,642,4.2,50
"Lyon County, MN",MN,2012,15245,14568,677,4.4,-184
"Lyon County, MN",MN,2011,15429,14613,816,5.3,192
"Lyon County, MN",MN,2010,15237,14382,855,5.6,0
"Lyon County, NV",NV,2021,23425,22197,1228,5.2,790
"Lyon County, NV",NV,2020,22635,20617,2018,8.9,-575
"Lyon County, NV",NV,2019,23210,22069,1141,4.9,1038
"Lyon County, NV",NV,2018,22172,20999,1173,5.3,693
"Lyon County, NV",NV,2017,21479,20190,1289,6.0,373
"Lyon County, NV",NV,2016,21106,19500,1606,7.6,-181
"Lyon County, NV",NV,2015,21287,19251,2036,9.6,-971
"Lyon County, NV",NV,2014,22258,19879,2379,10.7,49
"Lyon County, NV",NV,2013,22209,19274,2935,13.2,-214
"Lyon County, NV",NV,2012,22423,18995,3428,15.3,-330
"Lyon County, NV",NV,2011,22753,18857,3896,17.1,-201
"Lyon County, NV",NV,2010,22954,18858,4096,17.8,0
"Mackinac County, MI",MI,2021,4785,4375,410,8.6,-147
"Mackinac County, MI",MI,2020,4932,4248,684,13.9,-267
"Mackinac County, MI",MI,2019,5199,4713,486,9.3,-9
"Mackinac County, MI",MI,2018,5208,4710,498,9.6,11
"Mackinac County, MI",MI,2017,5197,4678,519,10.0,-11
"Mackinac County, MI",MI,2016,5208,4689,519,10.0,57
"Mackinac County, MI",MI,2015,5151,4644,507,9.8,-155
"Mackinac County, MI",MI,2014,5306,4711,595,11.2,48
"Mackinac County, MI",MI,2013,5258,4619,639,12.2,47
"Mackinac County, MI",MI,2012,5211,4586,625,12.0,-63
"Mackinac County, MI",MI,2011,5274,4607,667,12.6,-226
"Mackinac County, MI",MI,2010,5500,4721,779,14.2,0
"Macomb County, MI",MI,2021,439812,413707,26105,5.9,-2425
"Macomb County, MI",MI,2020,442237,390268,51969,11.8,-14588
"Macomb County, MI",MI,2019,456825,437744,19081,4.2,4987
"Macomb County, MI",MI,2018,451838,433446,18392,4.1,4000
"Macomb County, MI",MI,2017,447838,428149,19689,4.4,12397
"Macomb County, MI",MI,2016,435441,412956,22485,5.2,15371
"Macomb County, MI",MI,2015,420070,396168,23902,5.7,-503
"Macomb County, MI",MI,2014,420573,387466,33107,7.9,-771
"Macomb County, MI",MI,2013,421344,381732,39612,9.4,8671
"Macomb County, MI",MI,2012,412673,372357,40316,9.8,5331
"Macomb County, MI",MI,2011,407342,363502,43840,10.8,-10029
"Macomb County, MI",MI,2010,417371,361414,55957,13.4,0
"Macon County, AL",AL,2021,7948,7471,477,6.0,-238
"Macon County, AL",AL,2020,8186,7327,859,10.5,204
"Macon County, AL",AL,2019,7982,7627,355,4.4,35
"Macon County, AL",AL,2018,7947,7520,427,5.4,-32
"Macon County, AL",AL,2017,7979,7508,471,5.9,176
"Macon County, AL",AL,2016,7803,7208,595,7.6,-148
"Macon County, AL",AL,2015,7951,7307,644,8.1,-299
"Macon County, AL",AL,2014,8250,7502,748,9.1,-160
"Macon County, AL",AL,2013,8410,7587,823,9.8,111
"Macon County, AL",AL,2012,8299,7388,911,11.0,-203
"Macon County, AL",AL,2011,8502,7321,1181,13.9,-426
"Macon County, AL",AL,2010,8928,7635,1293,14.5,0
"Macon County, GA",GA,2021,4684,4389,295,6.3,31
"Macon County, GA",GA,2020,4653,4300,353,7.6,-76
"Macon County, GA",GA,2019,4729,4504,225,4.8,17
"Macon County, GA",GA,2018,4712,4416,296,6.3,-53
"Macon County, GA",GA,2017,4765,4431,334,7.0,84
"Macon County, GA",GA,2016,4681,4289,392,8.4,114
"Macon County, GA",GA,2015,4567,4140,427,9.3,-166
"Macon County, GA",GA,2014,4733,4173,560,11.8,-222
"Macon County, GA",GA,2013,4955,4327,628,12.7,-196
"Macon County, GA",GA,2012,5151,4476,675,13.1,-116
"Macon County, GA",GA,2011,5267,4545,722,13.7,-132
"Macon County, GA",GA,2010,5399,4677,722,13.4,0
"Macon County, IL",IL,2021,46552,42989,3563,7.7,-504
"Macon County, IL",IL,2020,47056,42338,4718,10.0,-1688
"Macon County, IL",IL,2019,48744,46300,2444,5.0,-1281
"Macon County, IL",IL,2018,50025,47262,2763,5.5,360
"Macon County, IL",IL,2017,49665,46914,2751,5.5,-1117
"Macon County, IL",IL,2016,50782,47430,3352,6.6,-151
"Macon County, IL",IL,2015,50933,47380,3553,7.0,-169
"Macon County, IL",IL,2014,51102,46727,4375,8.6,-1586
"Macon County, IL",IL,2013,52688,46762,5926,11.2,-1652
"Macon County, IL",IL,2012,54340,48944,5396,9.9,-879
"Macon County, IL",IL,2011,55219,49724,5495,10.0,-198
"Macon County, IL",IL,2010,55417,49217,6200,11.2,0
"Macon County, MO",MO,2021,7365,7093,272,3.7,-53
"Macon County, MO",MO,2020,7418,7064,354,4.8,-46
"Macon County, MO",MO,2019,7464,7225,239,3.2,-136
"Macon County, MO",MO,2018,7600,7378,222,2.9,29
"Macon County, MO",MO,2017,7571,7298,273,3.6,-35
"Macon County, MO",MO,2016,7606,7243,363,4.8,181
"Macon County, MO",MO,2015,7425,7022,403,5.4,3
"Macon County, MO",MO,2014,7422,6964,458,6.2,19
"Macon County, MO",MO,2013,7403,6915,488,6.6,-52
"Macon County, MO",MO,2012,7455,6938,517,6.9,1
"Macon County, MO",MO,2011,7454,6824,630,8.5,4
"Macon County, MO",MO,2010,7450,6765,685,9.2,0
"Macon County, NC",NC,2021,15285,14641,644,4.2,315
"Macon County, NC",NC,2020,14970,13993,977,6.5,-544
"Macon County, NC",NC,2019,15514,14918,596,3.8,373
"Macon County, NC",NC,2018,15141,14536,605,4.0,126
"Macon County, NC",NC,2017,15015,14317,698,4.6,-156
"Macon County, NC",NC,2016,15171,14353,818,5.4,67
"Macon County, NC",NC,2015,15104,14183,921,6.1,69
"Macon County, NC",NC,2014,15035,14071,964,6.4,-194
"Macon County, NC",NC,2013,15229,13871,1358,8.9,-394
"Macon County, NC",NC,2012,15623,13924,1699,10.9,57
"Macon County, NC",NC,2011,15566,13804,1762,11.3,52
"Macon County, NC",NC,2010,15514,13745,1769,11.4,0
"Macon County, TN",TN,2021,11349,10934,415,3.7,187
"Macon County, TN",TN,2020,11162,10440,722,6.5,-242
"Macon County, TN",TN,2019,11404,11049,355,3.1,403
"Macon County, TN",TN,2018,11001,10649,352,3.2,282
"Macon County, TN",TN,2017,10719,10351,368,3.4,476
"Macon County, TN",TN,2016,10243,9795,448,4.4,260
"Macon County, TN",TN,2015,9983,9458,525,5.3,2
"Macon County, TN",TN,2014,9981,9328,653,6.5,-113
"Macon County, TN",TN,2013,10094,9271,823,8.2,-35
"Macon County, TN",TN,2012,10129,9272,857,8.5,-187
"Macon County, TN",TN,2011,10316,9240,1076,10.4,60
"Macon County, TN",TN,2010,10256,9085,1171,11.4,0
"Macoupin County, IL",IL,2021,21984,20988,996,4.5,88
"Macoupin County, IL",IL,2020,21896,20351,1545,7.1,-1161
"Macoupin County, IL",IL,2019,23057,22117,940,4.1,-49
"Macoupin County, IL",IL,2018,23106,21985,1121,4.9,96
"Macoupin County, IL",IL,2017,23010,21885,1125,4.9,-448
"Macoupin County, IL",IL,2016,23458,22060,1398,6.0,366
"Macoupin County, IL",IL,2015,23092,21629,1463,6.3,-40
"Macoupin County, IL",IL,2014,23132,21388,1744,7.5,-318
"Macoupin County, IL",IL,2013,23450,21241,2209,9.4,-511
"Macoupin County, IL",IL,2012,23961,21674,2287,9.5,-793
"Macoupin County, IL",IL,2011,24754,22344,2410,9.7,15
"Macoupin County, IL",IL,2010,24739,22168,2571,10.4,0
"Madera County, CA",CA,2021,61944,56468,5476,8.8,92
"Madera County, CA",CA,2020,61852,54920,6932,11.2,-352
"Madera County, CA",CA,2019,62204,57848,4356,7.0,943
"Madera County, CA",CA,2018,61261,56882,4379,7.1,352
"Madera County, CA",CA,2017,60909,55932,4977,8.2,-142
"Madera County, CA",CA,2016,61051,55393,5658,9.3,1244
"Madera County, CA",CA,2015,59807,53480,6327,10.6,-1905
"Madera County, CA",CA,2014,61712,54720,6992,11.3,-361
"Madera County, CA",CA,2013,62073,54168,7905,12.7,-373
"Madera County, CA",CA,2012,62446,53282,9164,14.7,472
"Madera County, CA",CA,2011,61974,51786,10188,16.4,231
"Madera County, CA",CA,2010,61743,51236,10507,17.0,0
"Madison County, AL",AL,2021,192204,187100,5104,2.7,2572
"Madison County, AL",AL,2020,189632,179871,9761,5.1,1873
"Madison County, AL",AL,2019,187759,182655,5104,2.7,4257
"Madison County, AL",AL,2018,183502,177181,6321,3.4,5623
"Madison County, AL",AL,2017,177879,170808,7071,4.0,5754
"Madison County, AL",AL,2016,172125,163288,8837,5.1,1652
"Madison County, AL",AL,2015,170473,161071,9402,5.5,96
"Madison County, AL",AL,2014,170377,159923,10454,6.1,-801
"Madison County, AL",AL,2013,171178,160213,10965,6.4,854
"Madison County, AL",AL,2012,170324,158207,12117,7.1,-1355
"Madison County, AL",AL,2011,171679,157588,14091,8.2,1735
"Madison County, AL",AL,2010,169944,155994,13950,8.2,0
"Madison County, AR",AR,2021,7373,7142,231,3.1,81
"Madison County, AR",AR,2020,7292,7001,291,4.0,-119
"Madison County, AR",AR,2019,7411,7225,186,2.5,68
"Madison County, AR",AR,2018,7343,7133,210,2.9,-26
"Madison County, AR",AR,2017,7369,7157,212,2.9,72
"Madison County, AR",AR,2016,7297,7063,234,3.2,184
"Madison County, AR",AR,2015,7113,6843,270,3.8,90
"Madison County, AR",AR,2014,7023,6691,332,4.7,123
"Madison County, AR",AR,2013,6900,6510,390,5.7,-105
"Madison County, AR",AR,2012,7005,6611,394,5.6,-208
"Madison County, AR",AR,2011,7213,6748,465,6.4,-52
"Madison County, AR",AR,2010,7265,6771,494,6.8,0
"Madison County, FL",FL,2021,7720,7339,381,4.9,174
"Madison County, FL",FL,2020,7546,7042,504,6.7,147
"Madison County, FL",FL,2019,7399,7112,287,3.9,163
"Madison County, FL",FL,2018,7236,6944,292,4.0,-77
"Madison County, FL",FL,2017,7313,6982,331,4.5,-37
"Madison County, FL",FL,2016,7350,6960,390,5.3,-154
"Madison County, FL",FL,2015,7504,7039,465,6.2,-223
"Madison County, FL",FL,2014,7727,7161,566,7.3,-166
"Madison County, FL",FL,2013,7893,7252,641,8.1,-54
"Madison County, FL",FL,2012,7947,7245,702,8.8,-82
"Madison County, FL",FL,2011,8029,7262,767,9.6,151
"Madison County, FL",FL,2010,7878,7114,764,9.7,0
"Madison County, GA",GA,2021,13599,13184,415,3.1,382
"Madison County, GA",GA,2020,13217,12553,664,5.0,-213
"Madison County, GA",GA,2019,13430,13000,430,3.2,-287
"Madison County, GA",GA,2018,13717,13226,491,3.6,25
"Madison County, GA",GA,2017,13692,13102,590,4.3,608
"Madison County, GA",GA,2016,13084,12428,656,5.0,603
"Madison County, GA",GA,2015,12481,11776,705,5.6,-205
"Madison County, GA",GA,2014,12686,11835,851,6.7,-207
"Madison County, GA",GA,2013,12893,11922,971,7.5,-191
"Madison County, GA",GA,2012,13084,11931,1153,8.8,-122
"Madison County, GA",GA,2011,13206,11873,1333,10.1,-209
"Madison County, GA",GA,2010,13415,11999,1416,10.6,0
"Madison County, IA",IA,2021,8486,8105,381,4.5,67
"Madison County, IA",IA,2020,8419,7949,470,5.6,-343
"Madison County, IA",IA,2019,8762,8457,305,3.5,217
"Madison County, IA",IA,2018,8545,8274,271,3.2,169
"Madison County, IA",IA,2017,8376,8079,297,3.5,82
"Madison County, IA",IA,2016,8294,8002,292,3.5,59
"Madison County, IA",IA,2015,8235,7916,319,3.9,4
"Madison County, IA",IA,2014,8231,7859,372,4.5,130
"Madison County, IA",IA,2013,8101,7690,411,5.1,-68
"Madison County, IA",IA,2012,8169,7712,457,5.6,-141
"Madison County, IA",IA,2011,8310,7807,503,6.1,-129
"Madison County, IA",IA,2010,8439,7888,551,6.5,0
"Madison County, ID",ID,2021,23322,22810,512,2.2,924
"Madison County, ID",ID,2020,22398,21780,618,2.8,211
"Madison County, ID",ID,2019,22187,21774,413,1.9,409
"Madison County, ID",ID,2018,21778,21397,381,1.7,455
"Madison County, ID",ID,2017,21323,20918,405,1.9,758
"Madison County, ID",ID,2016,20565,20083,482,2.3,757
"Madison County, ID",ID,2015,19808,19315,493,2.5,839
"Madison County, ID",ID,2014,18969,18423,546,2.9,406
"Madison County, ID",ID,2013,18563,17717,846,4.6,75
"Madison County, ID",ID,2012,18488,17624,864,4.7,601
"Madison County, ID",ID,2011,17887,16965,922,5.2,374
"Madison County, ID",ID,2010,17513,16604,909,5.2,0
"Madison County, IL",IL,2021,130828,124425,6403,4.9,-59
"Madison County, IL",IL,2020,130887,120552,10335,7.9,-4143
"Madison County, IL",IL,2019,135030,129990,5040,3.7,306
"Madison County, IL",IL,2018,134724,128681,6043,4.5,421
"Madison County, IL",IL,2017,134303,127896,6407,4.8,-1382
"Madison County, IL",IL,2016,135685,127691,7994,5.9,2438
"Madison County, IL",IL,2015,133247,125231,8016,6.0,984
"Madison County, IL",IL,2014,132263,122876,9387,7.1,-852
"Madison County, IL",IL,2013,133115,121325,11790,8.9,-1966
"Madison County, IL",IL,2012,135081,123107,11974,8.9,-2619
"Madison County, IL",IL,2011,137700,125357,12343,9.0,-782
"Madison County, IL",IL,2010,138482,124794,13688,9.9,0
"Madison County, IN",IN,2021,58663,56257,2406,4.1,219
"Madison County, IN",IN,2020,58444,53754,4690,8.0,-722
"Madison County, IN",IN,2019,59166,57004,2162,3.7,116
"Madison County, IN",IN,2018,59050,56770,2280,3.9,492
"Madison County, IN",IN,2017,58558,56248,2310,3.9,-463
"Madison County, IN",IN,2016,59021,56085,2936,5.0,810
"Madison County, IN",IN,2015,58211,54928,3283,5.6,248
"Madison County, IN",IN,2014,57963,53843,4120,7.1,-178
"Madison County, IN",IN,2013,58141,52821,5320,9.2,116
"Madison County, IN",IN,2012,58025,52315,5710,9.8,-899
"Madison County, IN",IN,2011,58924,52634,6290,10.7,-469
"Madison County, IN",IN,2010,59393,52412,6981,11.8,0
"Madison County, KY",KY,2021,46664,44742,1922,4.1,824
"Madison County, KY",KY,2020,45840,43156,2684,5.9,-1817
"Madison County, KY",KY,2019,47657,45919,1738,3.6,791
"Madison County, KY",KY,2018,46866,45113,1753,3.7,689
"Madison County, KY",KY,2017,46177,44242,1935,4.2,1062
"Madison County, KY",KY,2016,45115,43253,1862,4.1,-77
"Madison County, KY",KY,2015,45192,43268,1924,4.3,-134
"Madison County, KY",KY,2014,45326,42882,2444,5.4,-438
"Madison County, KY",KY,2013,45764,42783,2981,6.5,1119
"Madison County, KY",KY,2012,44645,41616,3029,6.8,479
"Madison County, KY",KY,2011,44166,40700,3466,7.8,900
"Madison County, KY",KY,2010,43266,39550,3716,8.6,0
"Madison County, MO",MO,2021,5473,5231,242,4.4,21
"Madison County, MO",MO,2020,5452,5099,353,6.5,20
"Madison County, MO",MO,2019,5432,5257,175,3.2,-17
"Madison County, MO",MO,2018,5449,5261,188,3.5,-37
"Madison County, MO",MO,2017,5486,5241,245,4.5,14
"Madison County, MO",MO,2016,5472,5172,300,5.5,-14
"Madison County, MO",MO,2015,5486,5157,329,6.0,3
"Madison County, MO",MO,2014,5483,5101,382,7.0,-67
"Madison County, MO",MO,2013,5550,5120,430,7.7,205
"Madison County, MO",MO,2012,5345,4889,456,8.5,7
"Madison County, MO",MO,2011,5338,4771,567,10.6,-95
"Madison County, MO",MO,2010,5433,4777,656,12.1,0
"Madison County, MS",MS,2021,52799,50539,2260,4.3,473
"Madison County, MS",MS,2020,52326,48986,3340,6.4,-1542
"Madison County, MS",MS,2019,53868,51497,2371,4.4,754
"Madison County, MS",MS,2018,53114,51080,2034,3.8,18
"Madison County, MS",MS,2017,53096,50971,2125,4.0,-13
"Madison County, MS",MS,2016,53109,50769,2340,4.4,1636
"Madison County, MS",MS,2015,51473,49085,2388,4.6,1877
"Madison County, MS",MS,2014,49596,46959,2637,5.3,-198
"Madison County, MS",MS,2013,49794,46896,2898,5.8,-1177
"Madison County, MS",MS,2012,50971,47856,3115,6.1,99
"Madison County, MS",MS,2011,50872,47452,3420,6.7,2019
"Madison County, MS",MS,2010,48853,45347,3506,7.2,0
"Madison County, MT",MT,2021,4743,4592,151,3.2,57
"Madison County, MT",MT,2020,4686,4454,232,5.0,-149
"Madison County, MT",MT,2019,4835,4676,159,3.3,221
"Madison County, MT",MT,2018,4614,4448,166,3.6,193
"Madison County, MT",MT,2017,4421,4246,175,4.0,9
"Madison County, MT",MT,2016,4412,4239,173,3.9,124
"Madison County, MT",MT,2015,4288,4129,159,3.7,57
"Madison County, MT",MT,2014,4231,4037,194,4.6,67
"Madison County, MT",MT,2013,4164,3937,227,5.5,51
"Madison County, MT",MT,2012,4113,3863,250,6.1,-64
"Madison County, MT",MT,2011,4177,3884,293,7.0,19
"Madison County, MT",MT,2010,4158,3847,311,7.5,0
"Madison County, NC",NC,2021,9623,9212,411,4.3,325
"Madison County, NC",NC,2020,9298,8675,623,6.7,-722
"Madison County, NC",NC,2019,10020,9660,360,3.6,92
"Madison County, NC",NC,2018,9928,9562,366,3.7,102
"Madison County, NC",NC,2017,9826,9408,418,4.3,155
"Madison County, NC",NC,2016,9671,9200,471,4.9,212
"Madison County, NC",NC,2015,9459,8928,531,5.6,62
"Madison County, NC",NC,2014,9397,8829,568,6.0,-107
"Madison County, NC",NC,2013,9504,8747,757,8.0,-68
"Madison County, NC",NC,2012,9572,8615,957,10.0,85
"Madison County, NC",NC,2011,9487,8513,974,10.3,62
"Madison County, NC",NC,2010,9425,8456,969,10.3,0
"Madison County, NE",NE,2021,20079,19598,481,2.4,266
"Madison County, NE",NE,2020,19813,19073,740,3.7,-247
"Madison County, NE",NE,2019,20060,19503,557,2.8,392
"Madison County, NE",NE,2018,19668,19160,508,2.6,234
"Madison County, NE",NE,2017,19434,18918,516,2.7,168
"Madison County, NE",NE,2016,19266,18738,528,2.7,-18
"Madison County, NE",NE,2015,19284,18757,527,2.7,-213
"Madison County, NE",NE,2014,19497,18926,571,2.9,204
"Madison County, NE",NE,2013,19293,18634,659,3.4,123
"Madison County, NE",NE,2012,19170,18482,688,3.6,72
"Madison County, NE",NE,2011,19098,18319,779,4.1,175
"Madison County, NE",NE,2010,18923,18110,813,4.3,0
"Madison County, NY",NY,2021,32206,30749,1457,4.5,-739
"Madison County, NY",NY,2020,32945,30462,2483,7.5,-692
"Madison County, NY",NY,2019,33637,32187,1450,4.3,279
"Madison County, NY",NY,2018,33358,31773,1585,4.8,374
"Madison County, NY",NY,2017,32984,31177,1807,5.5,267
"Madison County, NY",NY,2016,32717,30966,1751,5.4,-118
"Madison County, NY",NY,2015,32835,30957,1878,5.7,-547
"Madison County, NY",NY,2014,33382,31224,2158,6.5,-1003
"Madison County, NY",NY,2013,34385,31702,2683,7.8,-183
"Madison County, NY",NY,2012,34568,31589,2979,8.6,-209
"Madison County, NY",NY,2011,34777,31921,2856,8.2,-833
"Madison County, NY",NY,2010,35610,32603,3007,8.4,0
"Madison County, OH",OH,2021,20815,20014,801,3.8,330
"Madison County, OH",OH,2020,20485,19253,1232,6.0,-537
"Madison County, OH",OH,2019,21022,20290,732,3.5,334
"Madison County, OH",OH,2018,20688,19903,785,3.8,-29
"Madison County, OH",OH,2017,20717,19914,803,3.9,300
"Madison County, OH",OH,2016,20417,19608,809,4.0,-146
"Madison County, OH",OH,2015,20563,19725,838,4.1,51
"Madison County, OH",OH,2014,20512,19540,972,4.7,290
"Madison County, OH",OH,2013,20222,18959,1263,6.2,128
"Madison County, OH",OH,2012,20094,18812,1282,6.4,-182
"Madison County, OH",OH,2011,20276,18673,1603,7.9,-423
"Madison County, OH",OH,2010,20699,18823,1876,9.1,0
"Madison County, TN",TN,2021,49358,47131,2227,4.5,-13
"Madison County, TN",TN,2020,49371,45711,3660,7.4,-158
"Madison County, TN",TN,2019,49529,47770,1759,3.6,767
"Madison County, TN",TN,2018,48762,46925,1837,3.8,634
"Madison County, TN",TN,2017,48128,46233,1895,3.9,299
"Madison County, TN",TN,2016,47829,45493,2336,4.9,1200
"Madison County, TN",TN,2015,46629,43904,2725,5.8,31
"Madison County, TN",TN,2014,46598,43431,3167,6.8,-1073
"Madison County, TN",TN,2013,47671,43839,3832,8.0,-793
"Madison County, TN",TN,2012,48464,44456,4008,8.3,-485
"Madison County, TN",TN,2011,48949,44320,4629,9.5,705
"Madison County, TN",TN,2010,48244,43316,4928,10.2,0
"Madison County, TX",TX,2021,4691,4398,293,6.2,253
"Madison County, TX",TX,2020,4438,4120,318,7.2,-42
"Madison County, TX",TX,2019,4480,4292,188,4.2,-42
"Madison County, TX",TX,2018,4522,4321,201,4.4,-129
"Madison County, TX",TX,2017,4651,4430,221,4.8,-119
"Madison County, TX",TX,2016,4770,4527,243,5.1,-349
"Madison County, TX",TX,2015,5119,4897,222,4.3,101
"Madison County, TX",TX,2014,5018,4770,248,4.9,207
"Madison County, TX",TX,2013,4811,4497,314,6.5,169
"Madison County, TX",TX,2012,4642,4316,326,7.0,-40
"Madison County, TX",TX,2011,4682,4281,401,8.6,-77
"Madison County, TX",TX,2010,4759,4357,402,8.4,0
"Madison County, VA",VA,2021,7329,7148,181,2.5,-7
"Madison County, VA",VA,2020,7336,7058,278,3.8,-197
"Madison County, VA",VA,2019,7533,7368,165,2.2,187
"Madison County, VA",VA,2018,7346,7168,178,2.4,13
"Madison County, VA",VA,2017,7333,7120,213,2.9,150
"Madison County, VA",VA,2016,7183,6962,221,3.1,-72
"Madison County, VA",VA,2015,7255,7011,244,3.4,-17
"Madison County, VA",VA,2014,7272,6984,288,4.0,43
"Madison County, VA",VA,2013,7229,6914,315,4.4,-23
"Madison County, VA",VA,2012,7252,6911,341,4.7,41
"Madison County, VA",VA,2011,7211,6834,377,5.2,33
"Madison County, VA",VA,2010,7178,6714,464,6.5,0
"Madison Parish, LA",LA,2021,3478,3244,234,6.7,-54
"Madison Parish, LA",LA,2020,3532,3211,321,9.1,-13
"Madison Parish, LA",LA,2019,3545,3272,273,7.7,-76
"Madison Parish, LA",LA,2018,3621,3324,297,8.2,-164
"Madison Parish, LA",LA,2017,3785,3479,306,8.1,-55
"Madison Parish, LA",LA,2016,3840,3495,345,9.0,-47
"Madison Parish, LA",LA,2015,3887,3528,359,9.2,-16
"Madison Parish, LA",LA,2014,3903,3479,424,10.9,-50
"Madison Parish, LA",LA,2013,3953,3533,420,10.6,54
"Madison Parish, LA",LA,2012,3899,3449,450,11.5,-85
"Madison Parish, LA",LA,2011,3984,3503,481,12.1,-173
"Madison Parish, LA",LA,2010,4157,3683,474,11.4,0
"Magoffin County, KY",KY,2021,3242,2836,406,12.5,63
"Magoffin County, KY",KY,2020,3179,2685,494,15.5,63
"Magoffin County, KY",KY,2019,3116,2792,324,10.4,194
"Magoffin County, KY",KY,2018,2922,2556,366,12.5,-64
"Magoffin County, KY",KY,2017,2986,2509,477,16.0,-153
"Magoffin County, KY",KY,2016,3139,2525,614,19.6,-183
"Magoffin County, KY",KY,2015,3322,2803,519,15.6,-404
"Magoffin County, KY",KY,2014,3726,3207,519,13.9,-273
"Magoffin County, KY",KY,2013,3999,3302,697,17.4,-41
"Magoffin County, KY",KY,2012,4040,3343,697,17.3,-120
"Magoffin County, KY",KY,2011,4160,3449,711,17.1,-157
"Magoffin County, KY",KY,2010,4317,3426,891,20.6,0
"Mahaska County, IA",IA,2021,11953,11512,441,3.7,23
"Mahaska County, IA",IA,2020,11930,11375,555,4.7,-191
"Mahaska County, IA",IA,2019,12121,11831,290,2.4,252
"Mahaska County, IA",IA,2018,11869,11576,293,2.5,138
"Mahaska County, IA",IA,2017,11731,11361,370,3.2,-128
"Mahaska County, IA",IA,2016,11859,11424,435,3.7,23
"Mahaska County, IA",IA,2015,11836,11372,464,3.9,-24
"Mahaska County, IA",IA,2014,11860,11341,519,4.4,193
"Mahaska County, IA",IA,2013,11667,11105,562,4.8,-18
"Mahaska County, IA",IA,2012,11685,11077,608,5.2,-201
"Mahaska County, IA",IA,2011,11886,11181,705,5.9,-5
"Mahaska County, IA",IA,2010,11891,11073,818,6.9,0
"Mahnomen County, MN",MN,2021,2141,2014,127,5.9,-79
"Mahnomen County, MN",MN,2020,2220,1925,295,13.3,-105
"Mahnomen County, MN",MN,2019,2325,2208,117,5.0,-11
"Mahnomen County, MN",MN,2018,2336,2221,115,4.9,-36
"Mahnomen County, MN",MN,2017,2372,2252,120,5.1,-16
"Mahnomen County, MN",MN,2016,2388,2250,138,5.8,-25
"Mahnomen County, MN",MN,2015,2413,2270,143,5.9,45
"Mahnomen County, MN",MN,2014,2368,2231,137,5.8,-32
"Mahnomen County, MN",MN,2013,2400,2259,141,5.9,-80
"Mahnomen County, MN",MN,2012,2480,2307,173,7.0,-19
"Mahnomen County, MN",MN,2011,2499,2309,190,7.6,-5
"Mahnomen County, MN",MN,2010,2504,2297,207,8.3,0
"Mahoning County, OH",OH,2021,98659,92395,6264,6.3,-1493
"Mahoning County, OH",OH,2020,100152,89923,10229,10.2,-3955
"Mahoning County, OH",OH,2019,104107,98092,6015,5.8,-641
"Mahoning County, OH",OH,2018,104748,98585,6163,5.9,-994
"Mahoning County, OH",OH,2017,105742,98488,7254,6.9,-638
"Mahoning County, OH",OH,2016,106380,99542,6838,6.4,-925
"Mahoning County, OH",OH,2015,107305,100697,6608,6.2,-950
"Mahoning County, OH",OH,2014,108255,100993,7262,6.7,-1214
"Mahoning County, OH",OH,2013,109469,100150,9319,8.5,-1287
"Mahoning County, OH",OH,2012,110756,101578,9178,8.3,-1868
"Mahoning County, OH",OH,2011,112624,101590,11034,9.8,-2639
"Mahoning County, OH",OH,2010,115263,101734,13529,11.7,0
"Major County, OK",OK,2021,3680,3565,115,3.1,12
"Major County, OK",OK,2020,3668,3491,177,4.8,-182
"Major County, OK",OK,2019,3850,3771,79,2.1,-147
"Major County, OK",OK,2018,3997,3915,82,2.1,-9
"Major County, OK",OK,2017,4006,3886,120,3.0,15
"Major County, OK",OK,2016,3991,3832,159,4.0,-305
"Major County, OK",OK,2015,4296,4159,137,3.2,-62
"Major County, OK",OK,2014,4358,4249,109,2.5,231
"Major County, OK",OK,2013,4127,3992,135,3.3,67
"Major County, OK",OK,2012,4060,3922,138,3.4,17
"Major County, OK",OK,2011,4043,3889,154,3.8,105
"Major County, OK",OK,2010,3938,3748,190,4.8,0
"Malheur County, OR",OR,2021,12717,12163,554,4.4,139
"Malheur County, OR",OR,2020,12578,11918,660,5.2,310
"Malheur County, OR",OR,2019,12268,11772,496,4.0,-71
"Malheur County, OR",OR,2018,12339,11791,548,4.4,-127
"Malheur County, OR",OR,2017,12466,11896,570,4.6,21
"Malheur County, OR",OR,2016,12445,11771,674,5.4,485
"Malheur County, OR",OR,2015,11960,11218,742,6.2,-147
"Malheur County, OR",OR,2014,12107,11164,943,7.8,-312
"Malheur County, OR",OR,2013,12419,11379,1040,8.4,-480
"Malheur County, OR",OR,2012,12899,11692,1207,9.4,-486
"Malheur County, OR",OR,2011,13385,12111,1274,9.5,-136
"Malheur County, OR",OR,2010,13521,12206,1315,9.7,0
"Manassas city, VA",VA,2021,20983,20162,821,3.9,-523
"Manassas city, VA",VA,2020,21506,20102,1404,6.5,-583
"Manassas city, VA",VA,2019,22089,21537,552,2.5,99
"Manassas city, VA",VA,2018,21990,21403,587,2.7,146
"Manassas city, VA",VA,2017,21844,21114,730,3.3,218
"Manassas city, VA",VA,2016,21626,20858,768,3.6,-55
"Manassas city, VA",VA,2015,21681,20794,887,4.1,-512
"Manassas city, VA",VA,2014,22193,21102,1091,4.9,-53
"Manassas city, VA",VA,2013,22246,21075,1171,5.3,348
"Manassas city, VA",VA,2012,21898,20695,1203,5.5,521
"Manassas city, VA",VA,2011,21377,20072,1305,6.1,373
"Manassas city, VA",VA,2010,21004,19494,1510,7.2,0
"Manassas Park city, VA",VA,2021,9464,9104,360,3.8,-252
"Manassas Park city, VA",VA,2020,9716,9071,645,6.6,103
"Manassas Park city, VA",VA,2019,9613,9377,236,2.5,258
"Manassas Park city, VA",VA,2018,9355,9103,252,2.7,429
"Manassas Park city, VA",VA,2017,8926,8629,297,3.3,433
"Manassas Park city, VA",VA,2016,8493,8188,305,3.6,126
"Manassas Park city, VA",VA,2015,8367,8022,345,4.1,177
"Manassas Park city, VA",VA,2014,8190,7806,384,4.7,-618
"Manassas Park city, VA",VA,2013,8808,8371,437,5.0,65
"Manassas Park city, VA",VA,2012,8743,8290,453,5.2,122
"Manassas Park city, VA",VA,2011,8621,8140,481,5.6,545
"Manassas Park city, VA",VA,2010,8076,7559,517,6.4,0
"Manatee County, FL",FL,2021,182554,175379,7175,3.9,6869
"Manatee County, FL",FL,2020,175685,162804,12881,7.3,-3501
"Manatee County, FL",FL,2019,179186,173414,5772,3.2,2515
"Manatee County, FL",FL,2018,176671,170437,6234,3.5,3244
"Manatee County, FL",FL,2017,173427,166400,7027,4.1,2279
"Manatee County, FL",FL,2016,171148,163281,7867,4.6,5621
"Manatee County, FL",FL,2015,165527,157051,8476,5.1,5251
"Manatee County, FL",FL,2014,160276,150831,9445,5.9,5376
"Manatee County, FL",FL,2013,154900,144059,10841,7.0,5132
"Manatee County, FL",FL,2012,149768,137215,12553,8.4,2489
"Manatee County, FL",FL,2011,147279,132628,14651,9.9,945
"Manatee County, FL",FL,2010,146334,130121,16213,11.1,0
"Manati Municipio, PR",PR,2021,12005,11097,908,7.6,
"Manati Municipio, PR",PR,2020,N.A.,N.A.,N.A.,N.A.,
"Manati Municipio, PR",PR,2019,11448,10534,914,8.0,67
"Manati Municipio, PR",PR,2018,11381,10401,980,8.6,-124
"Manati Municipio, PR",PR,2017,11505,10282,1223,10.6,-143
"Manati Municipio, PR",PR,2016,11648,10295,1353,11.6,-26
"Manati Municipio, PR",PR,2015,11674,10291,1383,11.8,-118
"Manati Municipio, PR",PR,2014,11792,10169,1623,13.8,-272
"Manati Municipio, PR",PR,2013,12064,10407,1657,13.7,-417
"Manati Municipio, PR",PR,2012,12481,10606,1875,15.0,-352
"Manati Municipio, PR",PR,2011,12833,10595,2238,17.4,-694
"Manati Municipio, PR",PR,2010,13527,10982,2545,18.8,0
"Manistee County, MI",MI,2021,9744,9034,710,7.3,-418
"Manistee County, MI",MI,2020,10162,9012,1150,11.3,-258
"Manistee County, MI",MI,2019,10420,9835,585,5.6,64
"Manistee County, MI",MI,2018,10356,9751,605,5.8,-66
"Manistee County, MI",MI,2017,10422,9753,669,6.4,-143
"Manistee County, MI",MI,2016,10565,9866,699,6.6,107
"Manistee County, MI",MI,2015,10458,9754,704,6.7,77
"Manistee County, MI",MI,2014,10381,9497,884,8.5,-142
"Manistee County, MI",MI,2013,10523,9417,1106,10.5,-10
"Manistee County, MI",MI,2012,10533,9408,1125,10.7,-119
"Manistee County, MI",MI,2011,10652,9428,1224,11.5,-290
"Manistee County, MI",MI,2010,10942,9552,1390,12.7,0
"Manitowoc County, WI",WI,2021,41403,39988,1415,3.4,485
"Manitowoc County, WI",WI,2020,40918,38371,2547,6.2,-170
"Manitowoc County, WI",WI,2019,41088,39761,1327,3.2,-267
"Manitowoc County, WI",WI,2018,41355,40087,1268,3.1,-478
"Manitowoc County, WI",WI,2017,41833,40370,1463,3.5,102
"Manitowoc County, WI",WI,2016,41731,39977,1754,4.2,-58
"Manitowoc County, WI",WI,2015,41789,39741,2048,4.9,-717
"Manitowoc County, WI",WI,2014,42506,39973,2533,6.0,-174
"Manitowoc County, WI",WI,2013,42680,39554,3126,7.3,-954
"Manitowoc County, WI",WI,2012,43634,40297,3337,7.6,-755
"Manitowoc County, WI",WI,2011,44389,40740,3649,8.2,-229
"Manitowoc County, WI",WI,2010,44618,40294,4324,9.7,0
"Marathon County, WI",WI,2021,74339,72132,2207,3.0,1079
"Marathon County, WI",WI,2020,73260,69592,3668,5.0,-458
"Marathon County, WI",WI,2019,73718,71689,2029,2.8,-466
"Marathon County, WI",WI,2018,74184,72236,1948,2.6,86
"Marathon County, WI",WI,2017,74098,71936,2162,2.9,661
"Marathon County, WI",WI,2016,73437,70883,2554,3.5,150
"Marathon County, WI",WI,2015,73287,70401,2886,3.9,211
"Marathon County, WI",WI,2014,73076,69446,3630,5.0,971
"Marathon County, WI",WI,2013,72105,67301,4804,6.7,547
"Marathon County, WI",WI,2012,71558,66398,5160,7.2,-983
"Marathon County, WI",WI,2011,72541,66963,5578,7.7,-1017
"Marathon County, WI",WI,2010,73558,66842,6716,9.1,0
"Marengo County, AL",AL,2021,7709,7384,325,4.2,-155
"Marengo County, AL",AL,2020,7864,7319,545,6.9,62
"Marengo County, AL",AL,2019,7802,7513,289,3.7,111
"Marengo County, AL",AL,2018,7691,7313,378,4.9,-94
"Marengo County, AL",AL,2017,7785,7338,447,5.7,177
"Marengo County, AL",AL,2016,7608,7063,545,7.2,221
"Marengo County, AL",AL,2015,7387,6820,567,7.7,-249
"Marengo County, AL",AL,2014,7636,7031,605,7.9,8
"Marengo County, AL",AL,2013,7628,6940,688,9.0,-33
"Marengo County, AL",AL,2012,7661,6865,796,10.4,-206
"Marengo County, AL",AL,2011,7867,6888,979,12.4,-263
"Marengo County, AL",AL,2010,8130,7036,1094,13.5,0
"Maricao Municipio, PR",PR,2021,2074,1824,250,12.1,
"Maricao Municipio, PR",PR,2020,N.A.,N.A.,N.A.,N.A.,
"Maricao Municipio, PR",PR,2019,1916,1654,262,13.7,12
"Maricao Municipio, PR",PR,2018,1904,1617,287,15.1,-120
"Maricao Municipio, PR",PR,2017,2024,1618,406,20.1,69
"Maricao Municipio, PR",PR,2016,1955,1657,298,15.2,100
"Maricao Municipio, PR",PR,2015,1855,1549,306,16.5,-104
"Maricao Municipio, PR",PR,2014,1959,1549,410,20.9,-170
"Maricao Municipio, PR",PR,2013,2129,1679,450,21.1,-36
"Maricao Municipio, PR",PR,2012,2165,1765,400,18.5,-36
"Maricao Municipio, PR",PR,2011,2201,1794,407,18.5,-123
"Maricao Municipio, PR",PR,2010,2324,1898,426,18.3,0
"Maricopa County, AZ",AZ,2021,2311889,2208858,103031,4.5,54922
"Maricopa County, AZ",AZ,2020,2256967,2094758,162209,7.2,27067
"Maricopa County, AZ",AZ,2019,2229900,2136810,93090,4.2,73919
"Maricopa County, AZ",AZ,2018,2155981,2066973,89008,4.1,67434
"Maricopa County, AZ",AZ,2017,2088547,1999783,88764,4.3,-4
"Maricopa County, AZ",AZ,2016,2088551,1991371,97180,4.7,55063
"Maricopa County, AZ",AZ,2015,2033488,1928852,104636,5.1,59805
"Maricopa County, AZ",AZ,2014,1973683,1858871,114812,5.8,44591
"Maricopa County, AZ",AZ,2013,1929092,1801272,127820,6.6,17563
"Maricopa County, AZ",AZ,2012,1911529,1772341,139188,7.3,7488
"Maricopa County, AZ",AZ,2011,1904041,1742147,161894,8.5,-19628
"Maricopa County, AZ",AZ,2010,1923669,1741749,181920,9.5,0
"Maries County, MO",MO,2021,3898,3748,150,3.8,2
"Maries County, MO",MO,2020,3896,3707,189,4.9,43
"Maries County, MO",MO,2019,3853,3726,127,3.3,-15
"Maries County, MO",MO,2018,3868,3743,125,3.2,-46
"Maries County, MO",MO,2017,3914,3746,168,4.3,8
"Maries County, MO",MO,2016,3906,3710,196,5.0,-7
"Maries County, MO",MO,2015,3913,3701,212,5.4,-45
"Maries County, MO",MO,2014,3958,3711,247,6.2,-208
"Maries County, MO",MO,2013,4166,3889,277,6.6,43
"Maries County, MO",MO,2012,4123,3816,307,7.4,-63
"Maries County, MO",MO,2011,4186,3826,360,8.6,-53
"Maries County, MO",MO,2010,4239,3840,399,9.4,0
"Marin County, CA",CA,2021,128920,123172,5748,4.5,-1494
"Marin County, CA",CA,2020,130414,121476,8938,6.9,-8397
"Marin County, CA",CA,2019,138811,135543,3268,2.4,-870
"Marin County, CA",CA,2018,139681,136256,3425,2.5,49
"Marin County, CA",CA,2017,139632,135584,4048,2.9,0
"Marin County, CA",CA,2016,139632,135040,4592,3.3,955
"Marin County, CA",CA,2015,138677,133718,4959,3.6,219
"Marin County, CA",CA,2014,138458,132477,5981,4.3,651
"Marin County, CA",CA,2013,137807,130592,7215,5.2,1285
"Marin County, CA",CA,2012,136522,127796,8726,6.4,2277
"Marin County, CA",CA,2011,134245,124309,9936,7.4,1274
"Marin County, CA",CA,2010,132971,122259,10712,8.1,0
"Marinette County, WI",WI,2021,19634,18777,857,4.4,-128
"Marinette County, WI",WI,2020,19762,18215,1547,7.8,268
"Marinette County, WI",WI,2019,19494,18645,849,4.4,-176
"Marinette County, WI",WI,2018,19670,18887,783,4.0,-146
"Marinette County, WI",WI,2017,19816,18946,870,4.4,-357
"Marinette County, WI",WI,2016,20173,19094,1079,5.3,-518
"Marinette County, WI",WI,2015,20691,19515,1176,5.7,-376
"Marinette County, WI",WI,2014,21067,19664,1403,6.7,-374
"Marinette County, WI",WI,2013,21441,19754,1687,7.9,22
"Marinette County, WI",WI,2012,21419,19658,1761,8.2,-45
"Marinette County, WI",WI,2011,21464,19434,2030,9.5,81
"Marinette County, WI",WI,2010,21383,19056,2327,10.9,0
"Marion County, AL",AL,2021,13320,12941,379,2.8,29
"Marion County, AL",AL,2020,13291,12545,746,5.6,343
"Marion County, AL",AL,2019,12948,12472,476,3.7,191
"Marion County, AL",AL,2018,12757,12241,516,4.0,94
"Marion County, AL",AL,2017,12663,12041,622,4.9,269
"Marion County, AL",AL,2016,12394,11572,822,6.6,-59
"Marion County, AL",AL,2015,12453,11583,870,7.0,142
"Marion County, AL",AL,2014,12311,11342,969,7.9,-166
"Marion County, AL",AL,2013,12477,11475,1002,8.0,12
"Marion County, AL",AL,2012,12465,11326,1139,9.1,-81
"Marion County, AL",AL,2011,12546,11155,1391,11.1,-657
"Marion County, AL",AL,2010,13203,11448,1755,13.3,0
"Marion County, AR",AR,2021,6089,5829,260,4.3,-176
"Marion County, AR",AR,2020,6265,5860,405,6.5,-403
"Marion County, AR",AR,2019,6668,6407,261,3.9,179
"Marion County, AR",AR,2018,6489,6225,264,4.1,11
"Marion County, AR",AR,2017,6478,6221,257,4.0,-54
"Marion County, AR",AR,2016,6532,6271,261,4.0,-20
"Marion County, AR",AR,2015,6552,6217,335,5.1,-30
"Marion County, AR",AR,2014,6582,6178,404,6.1,33
"Marion County, AR",AR,2013,6549,6059,490,7.5,-84
"Marion County, AR",AR,2012,6633,6109,524,7.9,-88
"Marion County, AR",AR,2011,6721,6118,603,9.0,15
"Marion County, AR",AR,2010,6706,6051,655,9.8,0
"Marion County, FL",FL,2021,141992,135009,6983,4.9,3040
"Marion County, FL",FL,2020,138952,128343,10609,7.6,904
"Marion County, FL",FL,2019,138048,132637,5411,3.9,3311
"Marion County, FL",FL,2018,134737,128740,5997,4.5,2020
"Marion County, FL",FL,2017,132717,125915,6802,5.1,251
"Marion County, FL",FL,2016,132466,124689,7777,5.9,1768
"Marion County, FL",FL,2015,130698,122131,8567,6.6,-744
"Marion County, FL",FL,2014,131442,121579,9863,7.5,659
"Marion County, FL",FL,2013,130783,119141,11642,8.9,1097
"Marion County, FL",FL,2012,129686,116046,13640,10.5,-568
"Marion County, FL",FL,2011,130254,114256,15998,12.3,-814
"Marion County, FL",FL,2010,131068,113748,17320,13.2,0
"Marion County, GA",GA,2021,3257,3139,118,3.6,19
"Marion County, GA",GA,2020,3238,3075,163,5.0,-60
"Marion County, GA",GA,2019,3298,3152,146,4.4,-82
"Marion County, GA",GA,2018,3380,3203,177,5.2,-79
"Marion County, GA",GA,2017,3459,3249,210,6.1,78
"Marion County, GA",GA,2016,3381,3130,251,7.4,-26
"Marion County, GA",GA,2015,3407,3115,292,8.6,-44
"Marion County, GA",GA,2014,3451,3185,266,7.7,2
"Marion County, GA",GA,2013,3449,3146,303,8.8,-150
"Marion County, GA",GA,2012,3599,3244,355,9.9,-75
"Marion County, GA",GA,2011,3674,3294,380,10.3,-59
"Marion County, GA",GA,2010,3733,3330,403,10.8,0
"Marion County, IA",IA,2021,18549,17970,579,3.1,472
"Marion County, IA",IA,2020,18077,17337,740,4.1,-648
"Marion County, IA",IA,2019,18725,18346,379,2.0,590
"Marion County, IA",IA,2018,18135,17764,371,2.0,602
"Marion County, IA",IA,2017,17533,17080,453,2.6,-5
"Marion County, IA",IA,2016,17538,17014,524,3.0,103
"Marion County, IA",IA,2015,17435,16870,565,3.2,-2
"Marion County, IA",IA,2014,17437,16774,663,3.8,95
"Marion County, IA",IA,2013,17342,16570,772,4.5,210
"Marion County, IA",IA,2012,17132,16307,825,4.8,-104
"Marion County, IA",IA,2011,17236,16283,953,5.5,-317
"Marion County, IA",IA,2010,17553,16495,1058,6.0,0
"Marion County, IL",IL,2021,16810,15835,975,5.8,-234
"Marion County, IL",IL,2020,17044,15441,1603,9.4,-662
"Marion County, IL",IL,2019,17706,16958,748,4.2,-194
"Marion County, IL",IL,2018,17900,17028,872,4.9,193
"Marion County, IL",IL,2017,17707,16778,929,5.2,-397
"Marion County, IL",IL,2016,18104,16947,1157,6.4,-21
"Marion County, IL",IL,2015,18125,16898,1227,6.8,81
"Marion County, IL",IL,2014,18044,16658,1386,7.7,-52
"Marion County, IL",IL,2013,18096,16282,1814,10.0,-494
"Marion County, IL",IL,2012,18590,16760,1830,9.8,-527
"Marion County, IL",IL,2011,19117,17196,1921,10.0,-254
"Marion County, IL",IL,2010,19371,17249,2122,11.0,0
"Marion County, IN",IN,2021,497073,474976,22097,4.4,4276
"Marion County, IN",IN,2020,492797,453225,39572,8.0,-3130
"Marion County, IN",IN,2019,495927,479869,16058,3.2,6656
"Marion County, IN",IN,2018,489271,472325,16946,3.5,5798
"Marion County, IN",IN,2017,483473,466168,17305,3.6,1554
"Marion County, IN",IN,2016,481919,460661,21258,4.4,9689
"Marion County, IN",IN,2015,472230,448465,23765,5.0,4537
"Marion County, IN",IN,2014,467693,437320,30373,6.5,3642
"Marion County, IN",IN,2013,464051,425318,38733,8.3,5349
"Marion County, IN",IN,2012,458702,416997,41705,9.1,1806
"Marion County, IN",IN,2011,456896,412726,44170,9.7,3966
"Marion County, IN",IN,2010,452930,406386,46544,10.3,0
"Marion County, KS",KS,2021,6005,5860,145,2.4,55
"Marion County, KS",KS,2020,5950,5717,233,3.9,-107
"Marion County, KS",KS,2019,6057,5881,176,2.9,1
"Marion County, KS",KS,2018,6056,5872,184,3.0,-234
"Marion County, KS",KS,2017,6290,6063,227,3.6,142
"Marion County, KS",KS,2016,6148,5907,241,3.9,-30
"Marion County, KS",KS,2015,6178,5945,233,3.8,28
"Marion County, KS",KS,2014,6150,5901,249,4.0,-75
"Marion County, KS",KS,2013,6225,5934,291,4.7,-144
"Marion County, KS",KS,2012,6369,6043,326,5.1,-134
"Marion County, KS",KS,2011,6503,6140,363,5.6,-239
"Marion County, KS",KS,2010,6742,6347,395,5.9,0
"Marion County, KY",KY,2021,9285,8880,405,4.4,70
"Marion County, KY",KY,2020,9215,8515,700,7.6,-519
"Marion County, KY",KY,2019,9734,9380,354,3.6,102
"Marion County, KY",KY,2018,9632,9281,351,3.6,168
"Marion County, KY",KY,2017,9464,9078,386,4.1,62
"Marion County, KY",KY,2016,9402,9010,392,4.2,284
"Marion County, KY",KY,2015,9118,8674,444,4.9,-76
"Marion County, KY",KY,2014,9194,8610,584,6.4,-103
"Marion County, KY",KY,2013,9297,8548,749,8.1,118
"Marion County, KY",KY,2012,9179,8363,816,8.9,-43
"Marion County, KY",KY,2011,9222,8226,996,10.8,62
"Marion County, KY",KY,2010,9160,7994,1166,12.7,0
"Marion County, MO",MO,2021,14197,13705,492,3.5,-29
"Marion County, MO",MO,2020,14226,13546,680,4.8,-168
"Marion County, MO",MO,2019,14394,13962,432,3.0,-22
"Marion County, MO",MO,2018,14416,13977,439,3.0,-111
"Marion County, MO",MO,2017,14527,14009,518,3.6,-30
"Marion County, MO",MO,2016,14557,13935,622,4.3,-102
"Marion County, MO",MO,2015,14659,13995,664,4.5,83
"Marion County, MO",MO,2014,14576,13767,809,5.6,-16
"Marion County, MO",MO,2013,14592,13706,886,6.1,203
"Marion County, MO",MO,2012,14389,13484,905,6.3,-84
"Marion County, MO",MO,2011,14473,13369,1104,7.6,-234
"Marion County, MO",MO,2010,14707,13380,1327,9.0,0
"Marion County, MS",MS,2021,10268,9725,543,5.3,280
"Marion County, MS",MS,2020,9988,9293,695,7.0,-15
"Marion County, MS",MS,2019,10003,9450,553,5.5,-15
"Marion County, MS",MS,2018,10018,9488,530,5.3,-161
"Marion County, MS",MS,2017,10179,9604,575,5.6,-42
"Marion County, MS",MS,2016,10221,9537,684,6.7,242
"Marion County, MS",MS,2015,9979,9241,738,7.4,117
"Marion County, MS",MS,2014,9862,9044,818,8.3,-78
"Marion County, MS",MS,2013,9940,9008,932,9.4,-500
"Marion County, MS",MS,2012,10440,9391,1049,10.0,-508
"Marion County, MS",MS,2011,10948,9804,1144,10.4,388
"Marion County, MS",MS,2010,10560,9307,1253,11.9,0
"Marion County, OH",OH,2021,27974,26659,1315,4.7,-270
"Marion County, OH",OH,2020,28244,26098,2146,7.6,-504
"Marion County, OH",OH,2019,28748,27577,1171,4.1,134
"Marion County, OH",OH,2018,28614,27353,1261,4.4,382
"Marion County, OH",OH,2017,28232,26811,1421,5.0,383
"Marion County, OH",OH,2016,27849,26425,1424,5.1,-17
"Marion County, OH",OH,2015,27866,26425,1441,5.2,-71
"Marion County, OH",OH,2014,27937,26263,1674,6.0,-175
"Marion County, OH",OH,2013,28112,25897,2215,7.9,-784
"Marion County, OH",OH,2012,28896,26611,2285,7.9,-605
"Marion County, OH",OH,2011,29501,26591,2910,9.9,-800
"Marion County, OH",OH,2010,30301,26970,3331,11.0,0
"Marion County, OR",OR,2021,167425,158910,8515,5.1,4865
"Marion County, OR",OR,2020,162560,151236,11324,7.0,1101
"Marion County, OR",OR,2019,161459,155206,6253,3.9,1714
"Marion County, OR",OR,2018,159745,153093,6652,4.2,656
"Marion County, OR",OR,2017,159089,152304,6785,4.3,2076
"Marion County, OR",OR,2016,157013,149200,7813,5.0,4298
"Marion County, OR",OR,2015,152715,143774,8941,5.9,2571
"Marion County, OR",OR,2014,150144,139301,10843,7.2,1767
"Marion County, OR",OR,2013,148377,135439,12938,8.7,-3038
"Marion County, OR",OR,2012,151415,136344,15071,10.0,-3313
"Marion County, OR",OR,2011,154728,138373,16355,10.6,-1165
"Marion County, OR",OR,2010,155893,138412,17481,11.2,0
"Marion County, SC",SC,2021,12953,12094,859,6.6,16
"Marion County, SC",SC,2020,12937,11953,984,7.6,262
"Marion County, SC",SC,2019,12675,12138,537,4.2,76
"Marion County, SC",SC,2018,12599,11912,687,5.5,400
"Marion County, SC",SC,2017,12199,11311,888,7.3,-433
"Marion County, SC",SC,2016,12632,11553,1079,8.5,-217
"Marion County, SC",SC,2015,12849,11580,1269,9.9,6
"Marion County, SC",SC,2014,12843,11523,1320,10.3,-229
"Marion County, SC",SC,2013,13072,11403,1669,12.8,-437
"Marion County, SC",SC,2012,13509,11403,2106,15.6,-704
"Marion County, SC",SC,2011,14213,11724,2489,17.5,-339
"Marion County, SC",SC,2010,14552,11857,2695,18.5,0
"Marion County, TN",TN,2021,12328,11797,531,4.3,57
"Marion County, TN",TN,2020,12271,11352,919,7.5,-365
"Marion County, TN",TN,2019,12636,12095,541,4.3,291
"Marion County, TN",TN,2018,12345,11769,576,4.7,292
"Marion County, TN",TN,2017,12053,11466,587,4.9,124
"Marion County, TN",TN,2016,11929,11176,753,6.3,192
"Marion County, TN",TN,2015,11737,10950,787,6.7,76
"Marion County, TN",TN,2014,11661,10737,924,7.9,-378
"Marion County, TN",TN,2013,12039,10945,1094,9.1,-227
"Marion County, TN",TN,2012,12266,11130,1136,9.3,-221
"Marion County, TN",TN,2011,12487,11160,1327,10.6,-69
"Marion County, TN",TN,2010,12556,11133,1423,11.3,0
"Marion County, TX",TX,2021,4255,3963,292,6.9,51
"Marion County, TX",TX,2020,4204,3855,349,8.3,19
"Marion County, TX",TX,2019,4185,4009,176,4.2,-27
"Marion County, TX",TX,2018,4212,4021,191,4.5,-92
"Marion County, TX",TX,2017,4304,4058,246,5.7,-39
"Marion County, TX",TX,2016,4343,4038,305,7.0,-74
"Marion County, TX",TX,2015,4417,4128,289,6.5,-58
"Marion County, TX",TX,2014,4475,4182,293,6.5,-57
"Marion County, TX",TX,2013,4532,4164,368,8.1,191
"Marion County, TX",TX,2012,4341,3947,394,9.1,-84
"Marion County, TX",TX,2011,4425,3949,476,10.8,-85
"Marion County, TX",TX,2010,4510,3975,535,11.9,0
"Marion County, WV",WV,2021,25080,23773,1307,5.2,158
"Marion County, WV",WV,2020,24922,22801,2121,8.5,-812
"Marion County, WV",WV,2019,25734,24423,1311,5.1,272
"Marion County, WV",WV,2018,25462,24026,1436,5.6,-40
"Marion County, WV",WV,2017,25502,24153,1349,5.3,-252
"Marion County, WV",WV,2016,25754,24069,1685,6.5,-572
"Marion County, WV",WV,2015,26326,24564,1762,6.7,-361
"Marion County, WV",WV,2014,26687,25118,1569,5.9,-93
"Marion County, WV",WV,2013,26780,25205,1575,5.9,-68
"Marion County, WV",WV,2012,26848,25177,1671,6.2,113
"Marion County, WV",WV,2011,26735,24948,1787,6.7,130
"Marion County, WV",WV,2010,26605,24669,1936,7.3,0
"Mariposa County, CA",CA,2021,7014,6456,558,8.0,-177
"Mariposa County, CA",CA,2020,7191,6385,806,11.2,-444
"Mariposa County, CA",CA,2019,7635,7281,354,4.6,-16
"Mariposa County, CA",CA,2018,7651,7239,412,5.4,-2
"Mariposa County, CA",CA,2017,7653,7203,450,5.9,85
"Mariposa County, CA",CA,2016,7568,7048,520,6.9,-443
"Mariposa County, CA",CA,2015,8011,7436,575,7.2,-66
"Mariposa County, CA",CA,2014,8077,7359,718,8.9,-124
"Mariposa County, CA",CA,2013,8201,7328,873,10.6,-160
"Mariposa County, CA",CA,2012,8361,7323,1038,12.4,-288
"Mariposa County, CA",CA,2011,8649,7490,1159,13.4,-71
"Mariposa County, CA",CA,2010,8720,7563,1157,13.3,0
"Marlboro County, SC",SC,2021,8840,8154,686,7.8,-211
"Marlboro County, SC",SC,2020,9051,8194,857,9.5,138
"Marlboro County, SC",SC,2019,8913,8497,416,4.7,-32
"Marlboro County, SC",SC,2018,8945,8500,445,5.0,-8
"Marlboro County, SC",SC,2017,8953,8376,577,6.4,-325
"Marlboro County, SC",SC,2016,9278,8514,764,8.2,-359
"Marlboro County, SC",SC,2015,9637,8678,959,10.0,-322
"Marlboro County, SC",SC,2014,9959,8930,1029,10.3,-567
"Marlboro County, SC",SC,2013,10526,9109,1417,13.5,-268
"Marlboro County, SC",SC,2012,10794,8933,1861,17.2,13
"Marlboro County, SC",SC,2011,10781,8683,2098,19.5,-202
"Marlboro County, SC",SC,2010,10983,8626,2357,21.5,0
"Marquette County, MI",MI,2021,30639,28995,1644,5.4,-1000
"Marquette County, MI",MI,2020,31639,28905,2734,8.6,-857
"Marquette County, MI",MI,2019,32496,30887,1609,5.0,-42
"Marquette County, MI",MI,2018,32538,30932,1606,4.9,-370
"Marquette County, MI",MI,2017,32908,31097,1811,5.5,-504
"Marquette County, MI",MI,2016,33412,31489,1923,5.8,-134
"Marquette County, MI",MI,2015,33546,31507,2039,6.1,-322
"Marquette County, MI",MI,2014,33868,31488,2380,7.0,-195
"Marquette County, MI",MI,2013,34063,31305,2758,8.1,-56
"Marquette County, MI",MI,2012,34119,31400,2719,8.0,233
"Marquette County, MI",MI,2011,33886,30993,2893,8.5,-756
"Marquette County, MI",MI,2010,34642,31326,3316,9.6,0
"Marquette County, WI",WI,2021,7840,7493,347,4.4,82
"Marquette County, WI",WI,2020,7758,7235,523,6.7,-5
"Marquette County, WI",WI,2019,7763,7473,290,3.7,42
"Marquette County, WI",WI,2018,7721,7450,271,3.5,93
"Marquette County, WI",WI,2017,7628,7338,290,3.8,96
"Marquette County, WI",WI,2016,7532,7159,373,5.0,56
"Marquette County, WI",WI,2015,7476,7028,448,6.0,160
"Marquette County, WI",WI,2014,7316,6799,517,7.1,-189
"Marquette County, WI",WI,2013,7505,6877,628,8.4,-59
"Marquette County, WI",WI,2012,7564,6910,654,8.6,-19
"Marquette County, WI",WI,2011,7583,6850,733,9.7,-102
"Marquette County, WI",WI,2010,7685,6870,815,10.6,0
"Marshall County, AL",AL,2021,44714,43644,1070,2.4,-69
"Marshall County, AL",AL,2020,44783,42700,2083,4.7,53
"Marshall County, AL",AL,2019,44730,43565,1165,2.6,1345
"Marshall County, AL",AL,2018,43385,41930,1455,3.4,828
"Marshall County, AL",AL,2017,42557,40878,1679,3.9,1317
"Marshall County, AL",AL,2016,41240,39034,2206,5.3,950
"Marshall County, AL",AL,2015,40290,37944,2346,5.8,316
"Marshall County, AL",AL,2014,39974,37321,2653,6.6,-599
"Marshall County, AL",AL,2013,40573,37762,2811,6.9,-157
"Marshall County, AL",AL,2012,40730,37477,3253,8.0,-367
"Marshall County, AL",AL,2011,41097,37235,3862,9.4,-591
"Marshall County, AL",AL,2010,41688,37721,3967,9.5,0
"Marshall County, IA",IA,2021,17329,16207,1122,6.5,-330
"Marshall County, IA",IA,2020,17659,16435,1224,6.9,-615
"Marshall County, IA",IA,2019,18274,17491,783,4.3,-11
"Marshall County, IA",IA,2018,18285,17474,811,4.4,-105
"Marshall County, IA",IA,2017,18390,17560,830,4.5,-844
"Marshall County, IA",IA,2016,19234,18300,934,4.9,-201
"Marshall County, IA",IA,2015,19435,18459,976,5.0,-398
"Marshall County, IA",IA,2014,19833,18767,1066,5.4,8
"Marshall County, IA",IA,2013,19825,18633,1192,6.0,-56
"Marshall County, IA",IA,2012,19881,18600,1281,6.4,-257
"Marshall County, IA",IA,2011,20138,18791,1347,6.7,31
"Marshall County, IA",IA,2010,20107,18708,1399,7.0,0
"Marshall County, IL",IL,2021,5092,4806,286,5.6,32
"Marshall County, IL",IL,2020,5060,4680,380,7.5,-286
"Marshall County, IL",IL,2019,5346,5101,245,4.6,-101
"Marshall County, IL",IL,2018,5447,5162,285,5.2,-17
"Marshall County, IL",IL,2017,5464,5169,295,5.4,-192
"Marshall County, IL",IL,2016,5656,5280,376,6.6,-60
"Marshall County, IL",IL,2015,5716,5336,380,6.6,-37
"Marshall County, IL",IL,2014,5753,5344,409,7.1,-146
"Marshall County, IL",IL,2013,5899,5362,537,9.1,-295
"Marshall County, IL",IL,2012,6194,5675,519,8.4,-145
"Marshall County, IL",IL,2011,6339,5774,565,8.9,-74
"Marshall County, IL",IL,2010,6413,5750,663,10.3,0
"Marshall County, IN",IN,2021,22445,21850,595,2.7,-240
"Marshall County, IN",IN,2020,22685,21212,1473,6.5,-690
"Marshall County, IN",IN,2019,23375,22662,713,3.1,-19
"Marshall County, IN",IN,2018,23394,22662,732,3.1,-284
"Marshall County, IN",IN,2017,23678,22959,719,3.0,-673
"Marshall County, IN",IN,2016,24351,23451,900,3.7,345
"Marshall County, IN",IN,2015,24006,23011,995,4.1,277
"Marshall County, IN",IN,2014,23729,22436,1293,5.4,601
"Marshall County, IN",IN,2013,23128,21453,1675,7.2,150
"Marshall County, IN",IN,2012,22978,21120,1858,8.1,-525
"Marshall County, IN",IN,2011,23503,21322,2181,9.3,28
"Marshall County, IN",IN,2010,23475,20890,2585,11.0,0
"Marshall County, KS",KS,2021,5436,5331,105,1.9,-46
"Marshall County, KS",KS,2020,5482,5321,161,2.9,-41
"Marshall County, KS",KS,2019,5523,5368,155,2.8,19
"Marshall County, KS",KS,2018,5504,5364,140,2.5,-1
"Marshall County, KS",KS,2017,5505,5352,153,2.8,-83
"Marshall County, KS",KS,2016,5588,5419,169,3.0,-163
"Marshall County, KS",KS,2015,5751,5583,168,2.9,-135
"Marshall County, KS",KS,2014,5886,5697,189,3.2,-170
"Marshall County, KS",KS,2013,6056,5823,233,3.8,-51
"Marshall County, KS",KS,2012,6107,5853,254,4.2,85
"Marshall County, KS",KS,2011,6022,5746,276,4.6,112
"Marshall County, KS",KS,2010,5910,5613,297,5.0,0
"Marshall County, KY",KY,2021,14446,13774,672,4.7,-352
"Marshall County, KY",KY,2020,14798,13915,883,6.0,-319
"Marshall County, KY",KY,2019,15117,14448,669,4.4,172
"Marshall County, KY",KY,2018,14945,14173,772,5.2,-91
"Marshall County, KY",KY,2017,15036,14159,877,5.8,124
"Marshall County, KY",KY,2016,14912,14058,854,5.7,105
"Marshall County, KY",KY,2015,14807,13986,821,5.5,-158
"Marshall County, KY",KY,2014,14965,13961,1004,6.7,-361
"Marshall County, KY",KY,2013,15326,14093,1233,8.0,-50
"Marshall County, KY",KY,2012,15376,14124,1252,8.1,-104
"Marshall County, KY",KY,2011,15480,14051,1429,9.2,-3
"Marshall County, KY",KY,2010,15483,13840,1643,10.6,0
"Marshall County, MN",MN,2021,5173,4958,215,4.2,-316
"Marshall County, MN",MN,2020,5489,5115,374,6.8,16
"Marshall County, MN",MN,2019,5473,5132,341,6.2,21
"Marshall County, MN",MN,2018,5452,5115,337,6.2,-51
"Marshall County, MN",MN,2017,5503,5118,385,7.0,-112
"Marshall County, MN",MN,2016,5615,5204,411,7.3,-146
"Marshall County, MN",MN,2015,5761,5355,406,7.0,155
"Marshall County, MN",MN,2014,5606,5219,387,6.9,29
"Marshall County, MN",MN,2013,5577,5144,433,7.8,-177
"Marshall County, MN",MN,2012,5754,5310,444,7.7,-46
"Marshall County, MN",MN,2011,5800,5314,486,8.4,97
"Marshall County, MN",MN,2010,5703,5172,531,9.3,0
"Marshall County, MS",MS,2021,14217,13391,826,5.8,253
"Marshall County, MS",MS,2020,13964,12929,1035,7.4,-481
"Marshall County, MS",MS,2019,14445,13610,835,5.8,103
"Marshall County, MS",MS,2018,14342,13604,738,5.1,-8
"Marshall County, MS",MS,2017,14350,13588,762,5.3,-142
"Marshall County, MS",MS,2016,14492,13600,892,6.2,90
"Marshall County, MS",MS,2015,14402,13349,1053,7.3,87
"Marshall County, MS",MS,2014,14315,13059,1256,8.8,-497
"Marshall County, MS",MS,2013,14812,13316,1496,10.1,-741
"Marshall County, MS",MS,2012,15553,13898,1655,10.6,-250
"Marshall County, MS",MS,2011,15803,13995,1808,11.4,284
"Marshall County, MS",MS,2010,15519,13696,1823,11.7,0
"Marshall County, OK",OK,2021,6987,6731,256,3.7,185
"Marshall County, OK",OK,2020,6802,6356,446,6.6,-71
"Marshall County, OK",OK,2019,6873,6645,228,3.3,151
"Marshall County, OK",OK,2018,6722,6479,243,3.6,175
"Marshall County, OK",OK,2017,6547,6258,289,4.4,-60
"Marshall County, OK",OK,2016,6607,6285,322,4.9,-170
"Marshall County, OK",OK,2015,6777,6416,361,5.3,-152
"Marshall County, OK",OK,2014,6929,6607,322,4.6,-16
"Marshall County, OK",OK,2013,6945,6556,389,5.6,160
"Marshall County, OK",OK,2012,6785,6402,383,5.6,120
"Marshall County, OK",OK,2011,6665,6284,381,5.7,165
"Marshall County, OK",OK,2010,6500,6051,449,6.9,0
"Marshall County, SD",SD,2021,2420,2335,85,3.5,14
"Marshall County, SD",SD,2020,2406,2299,107,4.4,61
"Marshall County, SD",SD,2019,2345,2270,75,3.2,-68
"Marshall County, SD",SD,2018,2413,2328,85,3.5,20
"Marshall County, SD",SD,2017,2393,2294,99,4.1,-80
"Marshall County, SD",SD,2016,2473,2377,96,3.9,-45
"Marshall County, SD",SD,2015,2518,2423,95,3.8,-26
"Marshall County, SD",SD,2014,2544,2442,102,4.0,-15
"Marshall County, SD",SD,2013,2559,2449,110,4.3,35
"Marshall County, SD",SD,2012,2524,2410,114,4.5,2
"Marshall County, SD",SD,2011,2522,2385,137,5.4,43
"Marshall County, SD",SD,2010,2479,2348,131,5.3,0
"Marshall County, TN",TN,2021,15495,14798,697,4.5,16
"Marshall County, TN",TN,2020,15479,14074,1405,9.1,-337
"Marshall County, TN",TN,2019,15816,15254,562,3.6,335
"Marshall County, TN",TN,2018,15481,14945,536,3.5,376
"Marshall County, TN",TN,2017,15105,14577,528,3.5,22
"Marshall County, TN",TN,2016,15083,14385,698,4.6,288
"Marshall County, TN",TN,2015,14795,13974,821,5.5,313
"Marshall County, TN",TN,2014,14482,13572,910,6.3,111
"Marshall County, TN",TN,2013,14371,13202,1169,8.1,86
"Marshall County, TN",TN,2012,14285,12922,1363,9.5,-114
"Marshall County, TN",TN,2011,14399,12729,1670,11.6,-25
"Marshall County, TN",TN,2010,14424,12369,2055,14.2,0
"Marshall County, WV",WV,2021,13367,12532,835,6.2,-6
"Marshall County, WV",WV,2020,13373,12071,1302,9.7,-790
"Marshall County, WV",WV,2019,14163,13258,905,6.4,-123
"Marshall County, WV",WV,2018,14286,13467,819,5.7,227
"Marshall County, WV",WV,2017,14059,13221,838,6.0,-52
"Marshall County, WV",WV,2016,14111,12986,1125,8.0,-100
"Marshall County, WV",WV,2015,14211,13035,1176,8.3,-168
"Marshall County, WV",WV,2014,14379,13300,1079,7.5,63
"Marshall County, WV",WV,2013,14316,13283,1033,7.2,-8
"Marshall County, WV",WV,2012,14324,13209,1115,7.8,-2
"Marshall County, WV",WV,2011,14326,13080,1246,8.7,-334
"Marshall County, WV",WV,2010,14660,13242,1418,9.7,0
"Martin County, FL",FL,2021,73492,70878,2614,3.6,2139
"Martin County, FL",FL,2020,71353,66677,4676,6.6,-1384
"Martin County, FL",FL,2019,72737,70373,2364,3.3,440
"Martin County, FL",FL,2018,72297,69650,2647,3.7,796
"Martin County, FL",FL,2017,71501,68459,3042,4.3,376
"Martin County, FL",FL,2016,71125,67646,3479,4.9,1356
"Martin County, FL",FL,2015,69769,65987,3782,5.4,1197
"Martin County, FL",FL,2014,68572,64296,4276,6.2,1256
"Martin County, FL",FL,2013,67316,62256,5060,7.5,611
"Martin County, FL",FL,2012,66705,60993,5712,8.6,295
"Martin County, FL",FL,2011,66410,59867,6543,9.9,354
"Martin County, FL",FL,2010,66056,59186,6870,10.4,0
"Martin County, IN",IN,2021,5389,5252,137,2.5,-18
"Martin County, IN",IN,2020,5407,5173,234,4.3,8
"Martin County, IN",IN,2019,5399,5259,140,2.6,175
"Martin County, IN",IN,2018,5224,5082,142,2.7,87
"Martin County, IN",IN,2017,5137,4985,152,3.0,-18
"Martin County, IN",IN,2016,5155,4947,208,4.0,109
"Martin County, IN",IN,2015,5046,4835,211,4.2,88
"Martin County, IN",IN,2014,4958,4694,264,5.3,-2
"Martin County, IN",IN,2013,4960,4652,308,6.2,-125
"Martin County, IN",IN,2012,5085,4728,357,7.0,-276
"Martin County, IN",IN,2011,5361,4965,396,7.4,92
"Martin County, IN",IN,2010,5269,4881,388,7.4,0
"Martin County, KY",KY,2021,2350,2132,218,9.3,-124
"Martin County, KY",KY,2020,2474,2196,278,11.2,-203
"Martin County, KY",KY,2019,2677,2498,179,6.7,-116
"Martin County, KY",KY,2018,2793,2620,173,6.2,-282
"Martin County, KY",KY,2017,3075,2844,231,7.5,-8
"Martin County, KY",KY,2016,3083,2769,314,10.2,-2
"Martin County, KY",KY,2015,3085,2779,306,9.9,-353
"Martin County, KY",KY,2014,3438,3126,312,9.1,-204
"Martin County, KY",KY,2013,3642,3290,352,9.7,-127
"Martin County, KY",KY,2012,3769,3424,345,9.2,-108
"Martin County, KY",KY,2011,3877,3531,346,8.9,-140
"Martin County, KY",KY,2010,4017,3600,417,10.4,0
"Martin County, MN",MN,2021,9468,9164,304,3.2,-631
"Martin County, MN",MN,2020,10099,9546,553,5.5,-67
"Martin County, MN",MN,2019,10166,9758,408,4.0,-143
"Martin County, MN",MN,2018,10309,9961,348,3.4,-150
"Martin County, MN",MN,2017,10459,10094,365,3.5,4
"Martin County, MN",MN,2016,10455,10025,430,4.1,-18
"Martin County, MN",MN,2015,10473,10038,435,4.2,228
"Martin County, MN",MN,2014,10245,9751,494,4.8,-101
"Martin County, MN",MN,2013,10346,9793,553,5.3,-540
"Martin County, MN",MN,2012,10886,10271,615,5.6,-350
"Martin County, MN",MN,2011,11236,10488,748,6.7,-277
"Martin County, MN",MN,2010,11513,10670,843,7.3,0
"Martin County, NC",NC,2021,8617,8140,477,5.5,-6
"Martin County, NC",NC,2020,8623,8047,576,6.7,-359
"Martin County, NC",NC,2019,8982,8541,441,4.9,-175
"Martin County, NC",NC,2018,9157,8695,462,5.0,-295
"Martin County, NC",NC,2017,9452,8922,530,5.6,-332
"Martin County, NC",NC,2016,9784,9122,662,6.8,79
"Martin County, NC",NC,2015,9705,8968,737,7.6,-174
"Martin County, NC",NC,2014,9879,9129,750,7.6,-237
"Martin County, NC",NC,2013,10116,9087,1029,10.2,-412
"Martin County, NC",NC,2012,10528,9234,1294,12.3,-170
"Martin County, NC",NC,2011,10698,9366,1332,12.5,179
"Martin County, NC",NC,2010,10519,9189,1330,12.6,0
"Martin County, TX",TX,2021,2605,2480,125,4.8,66
"Martin County, TX",TX,2020,2539,2384,155,6.1,-241
"Martin County, TX",TX,2019,2780,2707,73,2.6,36
"Martin County, TX",TX,2018,2744,2675,69,2.5,237
"Martin County, TX",TX,2017,2507,2424,83,3.3,24
"Martin County, TX",TX,2016,2483,2374,109,4.4,-101
"Martin County, TX",TX,2015,2584,2493,91,3.5,-99
"Martin County, TX",TX,2014,2683,2591,92,3.4,137
"Martin County, TX",TX,2013,2546,2437,109,4.3,136
"Martin County, TX",TX,2012,2410,2302,108,4.5,62
"Martin County, TX",TX,2011,2348,2213,135,5.7,149
"Martin County, TX",TX,2010,2199,2066,133,6.0,0
"Martinsville city, VA",VA,2021,5531,5115,416,7.5,-118
"Martinsville city, VA",VA,2020,5649,5034,615,10.9,111
"Martinsville city, VA",VA,2019,5538,5314,224,4.0,15
"Martinsville city, VA",VA,2018,5523,5272,251,4.5,-37
"Martinsville city, VA",VA,2017,5560,5214,346,6.2,393
"Martinsville city, VA",VA,2016,5167,4807,360,7.0,-208
"Martinsville city, VA",VA,2015,5375,4909,466,8.7,-184
"Martinsville city, VA",VA,2014,5559,5017,542,9.7,-134
"Martinsville city, VA",VA,2013,5693,5067,626,11.0,-36
"Martinsville city, VA",VA,2012,5729,5009,720,12.6,-163
"Martinsville city, VA",VA,2011,5892,4998,894,15.2,-269
"Martinsville city, VA",VA,2010,6161,5063,1098,17.8,0
"Mason County, IL",IL,2021,5904,5584,320,5.4,-4
"Mason County, IL",IL,2020,5908,5428,480,8.1,-388
"Mason County, IL",IL,2019,6296,5976,320,5.1,-32
"Mason County, IL",IL,2018,6328,5954,374,5.9,-105
"Mason County, IL",IL,2017,6433,6042,391,6.1,-33
"Mason County, IL",IL,2016,6466,6005,461,7.1,-154
"Mason County, IL",IL,2015,6620,6147,473,7.1,-16
"Mason County, IL",IL,2014,6636,6061,575,8.7,-92
"Mason County, IL",IL,2013,6728,5994,734,10.9,-254
"Mason County, IL",IL,2012,6982,6278,704,10.1,-186
"Mason County, IL",IL,2011,7168,6404,764,10.7,-251
"Mason County, IL",IL,2010,7419,6505,914,12.3,0
"Mason County, KY",KY,2021,6796,6421,375,5.5,-57
"Mason County, KY",KY,2020,6853,6324,529,7.7,-263
"Mason County, KY",KY,2019,7116,6730,386,5.4,-58
"Mason County, KY",KY,2018,7174,6788,386,5.4,-48
"Mason County, KY",KY,2017,7222,6782,440,6.1,85
"Mason County, KY",KY,2016,7137,6687,450,6.3,-149
"Mason County, KY",KY,2015,7286,6842,444,6.1,-458
"Mason County, KY",KY,2014,7744,7134,610,7.9,-49
"Mason County, KY",KY,2013,7793,7020,773,9.9,167
"Mason County, KY",KY,2012,7626,6901,725,9.5,-59
"Mason County, KY",KY,2011,7685,6890,795,10.3,-252
"Mason County, KY",KY,2010,7937,7033,904,11.4,0
"Mason County, MI",MI,2021,13009,12171,838,6.4,-261
"Mason County, MI",MI,2020,13270,11986,1284,9.7,-388
"Mason County, MI",MI,2019,13658,12975,683,5.0,-135
"Mason County, MI",MI,2018,13793,13113,680,4.9,-243
"Mason County, MI",MI,2017,14036,13239,797,5.7,-280
"Mason County, MI",MI,2016,14316,13476,840,5.9,-169
"Mason County, MI",MI,2015,14485,13589,896,6.2,-230
"Mason County, MI",MI,2014,14715,13607,1108,7.5,193
"Mason County, MI",MI,2013,14522,13204,1318,9.1,127
"Mason County, MI",MI,2012,14395,13020,1375,9.6,169
"Mason County, MI",MI,2011,14226,12723,1503,10.6,-198
"Mason County, MI",MI,2010,14424,12662,1762,12.2,0
"Mason County, TX",TX,2021,1789,1705,84,4.7,75
"Mason County, TX",TX,2020,1714,1619,95,5.5,-26
"Mason County, TX",TX,2019,1740,1684,56,3.2,-17
"Mason County, TX",TX,2018,1757,1702,55,3.1,-43
"Mason County, TX",TX,2017,1800,1739,61,3.4,9
"Mason County, TX",TX,2016,1791,1726,65,3.6,-14
"Mason County, TX",TX,2015,1805,1735,70,3.9,-89
"Mason County, TX",TX,2014,1894,1806,88,4.6,-62
"Mason County, TX",TX,2013,1956,1848,108,5.5,-9
"Mason County, TX",TX,2012,1965,1863,102,5.2,2
"Mason County, TX",TX,2011,1963,1841,122,6.2,-31
"Mason County, TX",TX,2010,1994,1868,126,6.3,0
"Mason County, WA",WA,2021,25112,23362,1750,7.0,-323
"Mason County, WA",WA,2020,25435,22935,2500,9.8,-55
"Mason County, WA",WA,2019,25490,23846,1644,6.4,903
"Mason County, WA",WA,2018,24587,23041,1546,6.3,695
"Mason County, WA",WA,2017,23892,22345,1547,6.5,373
"Mason County, WA",WA,2016,23519,21769,1750,7.4,512
"Mason County, WA",WA,2015,23007,21259,1748,7.6,-83
"Mason County, WA",WA,2014,23090,21213,1877,8.1,-245
"Mason County, WA",WA,2013,23335,21048,2287,9.8,-78
"Mason County, WA",WA,2012,23413,21067,2346,10.0,-95
"Mason County, WA",WA,2011,23508,21022,2486,10.6,-884
"Mason County, WA",WA,2010,24392,21748,2644,10.8,0
"Mason County, WV",WV,2021,10171,9609,562,5.5,-74
"Mason County, WV",WV,2020,10245,9397,848,8.3,-46
"Mason County, WV",WV,2019,10291,9676,615,6.0,269
"Mason County, WV",WV,2018,10022,9332,690,6.9,-39
"Mason County, WV",WV,2017,10061,9384,677,6.7,-2
"Mason County, WV",WV,2016,10063,9345,718,7.1,-15
"Mason County, WV",WV,2015,10078,9241,837,8.3,-139
"Mason County, WV",WV,2014,10217,9273,944,9.2,-356
"Mason County, WV",WV,2013,10573,9593,980,9.3,-321
"Mason County, WV",WV,2012,10894,9855,1039,9.5,-140
"Mason County, WV",WV,2011,11034,9864,1170,10.6,-232
"Mason County, WV",WV,2010,11266,9966,1300,11.5,0
"Massac County, IL",IL,2021,5368,5059,309,5.8,-45
"Massac County, IL",IL,2020,5413,4866,547,10.1,-197
"Massac County, IL",IL,2019,5610,5311,299,5.3,-121
"Massac County, IL",IL,2018,5731,5335,396,6.9,-124
"Massac County, IL",IL,2017,5855,5476,379,6.5,-163
"Massac County, IL",IL,2016,6018,5588,430,7.1,-72
"Massac County, IL",IL,2015,6090,5645,445,7.3,-228
"Massac County, IL",IL,2014,6318,5810,508,8.0,-83
"Massac County, IL",IL,2013,6401,5776,625,9.8,-144
"Massac County, IL",IL,2012,6545,5913,632,9.7,-573
"Massac County, IL",IL,2011,7118,6486,632,8.9,59
"Massac County, IL",IL,2010,7059,6384,675,9.6,0
"Matagorda County, TX",TX,2021,16489,15114,1375,8.3,120
"Matagorda County, TX",TX,2020,16369,14647,1722,10.5,-141
"Matagorda County, TX",TX,2019,16510,15574,936,5.7,-135
"Matagorda County, TX",TX,2018,16645,15619,1026,6.2,-138
"Matagorda County, TX",TX,2017,16783,15549,1234,7.4,-107
"Matagorda County, TX",TX,2016,16890,15653,1237,7.3,-297
"Matagorda County, TX",TX,2015,17187,16020,1167,6.8,524
"Matagorda County, TX",TX,2014,16663,15338,1325,8.0,-159
"Matagorda County, TX",TX,2013,16822,15177,1645,9.8,-240
"Matagorda County, TX",TX,2012,17062,15343,1719,10.1,-751
"Matagorda County, TX",TX,2011,17813,15683,2130,12.0,-373
"Matagorda County, TX",TX,2010,18186,16091,2095,11.5,0
"Matanuska-Susitna Borough, AK",AK,2021,49487,46130,3357,6.8,1099
"Matanuska-Susitna Borough, AK",AK,2020,48388,44183,4205,8.7,153
"Matanuska-Susitna Borough, AK",AK,2019,48235,45267,2968,6.2,164
"Matanuska-Susitna Borough, AK",AK,2018,48071,44766,3305,6.9,-191
"Matanuska-Susitna Borough, AK",AK,2017,48262,44526,3736,7.7,909
"Matanuska-Susitna Borough, AK",AK,2016,47353,43613,3740,7.9,1296
"Matanuska-Susitna Borough, AK",AK,2015,46057,42633,3424,7.4,1313
"Matanuska-Susitna Borough, AK",AK,2014,44744,41199,3545,7.9,1026
"Matanuska-Susitna Borough, AK",AK,2013,43718,40053,3665,8.4,108
"Matanuska-Susitna Borough, AK",AK,2012,43610,39776,3834,8.8,372
"Matanuska-Susitna Borough, AK",AK,2011,43238,39177,4061,9.4,914
"Matanuska-Susitna Borough, AK",AK,2010,42324,38178,4146,9.8,0
"Mathews County, VA",VA,2021,3936,3811,125,3.2,-83
"Mathews County, VA",VA,2020,4019,3821,198,4.9,-204
"Mathews County, VA",VA,2019,4223,4103,120,2.8,59
"Mathews County, VA",VA,2018,4164,4040,124,3.0,32
"Mathews County, VA",VA,2017,4132,3980,152,3.7,87
"Mathews County, VA",VA,2016,4045,3885,160,4.0,-45
"Mathews County, VA",VA,2015,4090,3920,170,4.2,-49
"Mathews County, VA",VA,2014,4139,3951,188,4.5,-26
"Mathews County, VA",VA,2013,4165,3959,206,4.9,-5
"Mathews County, VA",VA,2012,4170,3937,233,5.6,-68
"Mathews County, VA",VA,2011,4238,3962,276,6.5,9
"Mathews County, VA",VA,2010,4229,3954,275,6.5,0
"Maui County, HI",HI,2021,86954,80575,6379,7.3,1832
"Maui County, HI",HI,2020,85122,69603,15519,18.2,-4391
"Maui County, HI",HI,2019,89513,87393,2120,2.4,-763
"Maui County, HI",HI,2018,90276,88198,2078,2.3,500
"Maui County, HI",HI,2017,89776,87671,2105,2.3,3086
"Maui County, HI",HI,2016,86690,84117,2573,3.0,1954
"Maui County, HI",HI,2015,84736,81762,2974,3.5,1536
"Maui County, HI",HI,2014,83200,79587,3613,4.3,2466
"Maui County, HI",HI,2013,80734,76704,4030,5.0,333
"Maui County, HI",HI,2012,80401,75371,5030,6.3,-919
"Maui County, HI",HI,2011,81320,74896,6424,7.9,1400
"Maui County, HI",HI,2010,79920,73258,6662,8.3,0
"Maunabo Municipio, PR",PR,2021,2997,2651,346,11.5,
"Maunabo Municipio, PR",PR,2020,N.A.,N.A.,N.A.,N.A.,
"Maunabo Municipio, PR",PR,2019,2929,2487,442,15.1,34
"Maunabo Municipio, PR",PR,2018,2895,2454,441,15.2,-54
"Maunabo Municipio, PR",PR,2017,2949,2439,510,17.3,-71
"Maunabo Municipio, PR",PR,2016,3020,2466,554,18.3,-18
"Maunabo Municipio, PR",PR,2015,3038,2478,560,18.4,-81
"Maunabo Municipio, PR",PR,2014,3119,2452,667,21.4,-102
"Maunabo Municipio, PR",PR,2013,3221,2524,697,21.6,-118
"Maunabo Municipio, PR",PR,2012,3339,2574,765,22.9,-105
"Maunabo Municipio, PR",PR,2011,3444,2577,867,25.2,-102
"Maunabo Municipio, PR",PR,2010,3546,2671,875,24.7,0
"Maury County, TN",TN,2021,52080,49615,2465,4.7,1006
"Maury County, TN",TN,2020,51074,46981,4093,8.0,673
"Maury County, TN",TN,2019,50401,48796,1605,3.2,2127
"Maury County, TN",TN,2018,48274,46719,1555,3.2,2212
"Maury County, TN",TN,2017,46062,44566,1496,3.2,1947
"Maury County, TN",TN,2016,44115,42327,1788,4.1,1667
"Maury County, TN",TN,2015,42448,40289,2159,5.1,1242
"Maury County, TN",TN,2014,41206,38749,2457,6.0,278
"Maury County, TN",TN,2013,40928,38029,2899,7.1,311
"Maury County, TN",TN,2012,40617,37379,3238,8.0,-602
"Maury County, TN",TN,2011,41219,36932,4287,10.4,-305
"Maury County, TN",TN,2010,41524,36334,5190,12.5,0
"Maverick County, TX",TX,2021,23752,20739,3013,12.7,-351
"Maverick County, TX",TX,2020,24103,20457,3646,15.1,740
"Maverick County, TX",TX,2019,23363,21589,1774,7.6,-59
"Maverick County, TX",TX,2018,23422,21498,1924,8.2,-336
"Maverick County, TX",TX,2017,23758,21520,2238,9.4,-491
"Maverick County, TX",TX,2016,24249,21519,2730,11.3,583
"Maverick County, TX",TX,2015,23666,21126,2540,10.7,283
"Maverick County, TX",TX,2014,23383,20789,2594,11.1,-249
"Maverick County, TX",TX,2013,23632,20659,2973,12.6,327
"Maverick County, TX",TX,2012,23305,20404,2901,12.4,-650
"Maverick County, TX",TX,2011,23955,20495,3460,14.4,389
"Maverick County, TX",TX,2010,23566,19979,3587,15.2,0
"Mayaguez Municipio, PR",PR,2021,23566,21510,2056,8.7,
"Mayaguez Municipio, PR",PR,2020,N.A.,N.A.,N.A.,N.A.,
"Mayaguez Municipio, PR",PR,2019,21768,19462,2306,10.6,-190
"Mayaguez Municipio, PR",PR,2018,21958,19459,2499,11.4,-621
"Mayaguez Municipio, PR",PR,2017,22579,19422,3157,14.0,-646
"Mayaguez Municipio, PR",PR,2016,23225,20039,3186,13.7,-186
"Mayaguez Municipio, PR",PR,2015,23411,20248,3163,13.5,-812
"Mayaguez Municipio, PR",PR,2014,24223,20082,4141,17.1,-974
"Mayaguez Municipio, PR",PR,2013,25197,20390,4807,19.1,-488
"Mayaguez Municipio, PR",PR,2012,25685,21396,4289,16.7,-723
"Mayaguez Municipio, PR",PR,2011,26408,21525,4883,18.5,-1431
"Mayaguez Municipio, PR",PR,2010,27839,22633,5206,18.7,0
"Mayes County, OK",OK,2021,19364,18639,725,3.7,123
"Mayes County, OK",OK,2020,19241,18247,994,5.2,-88
"Mayes County, OK",OK,2019,19329,18757,572,3.0,-418
"Mayes County, OK",OK,2018,19747,19113,634,3.2,592
"Mayes County, OK",OK,2017,19155,18299,856,4.5,-263
"Mayes County, OK",OK,2016,19418,18464,954,4.9,29
"Mayes County, OK",OK,2015,19389,18572,817,4.2,625
"Mayes County, OK",OK,2014,18764,17880,884,4.7,-60
"Mayes County, OK",OK,2013,18824,17768,1056,5.6,427
"Mayes County, OK",OK,2012,18397,17310,1087,5.9,329
"Mayes County, OK",OK,2011,18068,16766,1302,7.2,-1
"Mayes County, OK",OK,2010,18069,16540,1529,8.5,0
"McClain County, OK",OK,2021,20387,19754,633,3.1,388
"McClain County, OK",OK,2020,19999,18886,1113,5.6,274
"McClain County, OK",OK,2019,19725,19212,513,2.6,259
"McClain County, OK",OK,2018,19466,18947,519,2.7,305
"McClain County, OK",OK,2017,19161,18520,641,3.3,217
"McClain County, OK",OK,2016,18944,18192,752,4.0,198
"McClain County, OK",OK,2015,18746,18067,679,3.6,633
"McClain County, OK",OK,2014,18113,17468,645,3.6,304
"McClain County, OK",OK,2013,17809,17054,755,4.2,301
"McClain County, OK",OK,2012,17508,16797,711,4.1,295
"McClain County, OK",OK,2011,17213,16440,773,4.5,48
"McClain County, OK",OK,2010,17165,16246,919,5.4,0
"McCone County, MT",MT,2021,968,951,17,1.8,9
"McCone County, MT",MT,2020,959,932,27,2.8,-3
"McCone County, MT",MT,2019,962,943,19,2.0,-13
"McCone County, MT",MT,2018,975,957,18,1.8,-53
"McCone County, MT",MT,2017,1028,1006,22,2.1,-14
"McCone County, MT",MT,2016,1042,1021,21,2.0,-20
"McCone County, MT",MT,2015,1062,1038,24,2.3,-27
"McCone County, MT",MT,2014,1089,1064,25,2.3,-8
"McCone County, MT",MT,2013,1097,1071,26,2.4,7
"McCone County, MT",MT,2012,1090,1059,31,2.8,-10
"McCone County, MT",MT,2011,1100,1068,32,2.9,-32
"McCone County, MT",MT,2010,1132,1100,32,2.8,0
"McCook County, SD",SD,2021,3045,2961,84,2.8,67
"McCook County, SD",SD,2020,2978,2874,104,3.5,-88
"McCook County, SD",SD,2019,3066,2990,76,2.5,37
"McCook County, SD",SD,2018,3029,2959,70,2.3,-26
"McCook County, SD",SD,2017,3055,2976,79,2.6,-94
"McCook County, SD",SD,2016,3149,3070,79,2.5,-2
"McCook County, SD",SD,2015,3151,3077,74,2.3,-30
"McCook County, SD",SD,2014,3181,3098,83,2.6,-12
"McCook County, SD",SD,2013,3193,3092,101,3.2,-10
"McCook County, SD",SD,2012,3203,3088,115,3.6,-11
"McCook County, SD",SD,2011,3214,3076,138,4.3,-43
"McCook County, SD",SD,2010,3257,3099,158,4.9,0
"McCormick County, SC",SC,2021,3334,3174,160,4.8,61
"McCormick County, SC",SC,2020,3273,3061,212,6.5,-31
"McCormick County, SC",SC,2019,3304,3205,99,3.0,-14
"McCormick County, SC",SC,2018,3318,3204,114,3.4,19
"McCormick County, SC",SC,2017,3299,3152,147,4.5,-84
"McCormick County, SC",SC,2016,3383,3198,185,5.5,-56
"McCormick County, SC",SC,2015,3439,3196,243,7.1,-47
"McCormick County, SC",SC,2014,3486,3219,267,7.7,-29
"McCormick County, SC",SC,2013,3515,3178,337,9.6,-59
"McCormick County, SC",SC,2012,3574,3162,412,11.5,-73
"McCormick County, SC",SC,2011,3647,3156,491,13.5,-11
"McCormick County, SC",SC,2010,3658,3137,521,14.2,0
"McCracken County, KY",KY,2021,29655,28160,1495,5.0,912
"McCracken County, KY",KY,2020,28743,26768,1975,6.9,-513
"McCracken County, KY",KY,2019,29256,27885,1371,4.7,98
"McCracken County, KY",KY,2018,29158,27569,1589,5.4,-512
"McCracken County, KY",KY,2017,29670,27903,1767,6.0,664
"McCracken County, KY",KY,2016,29006,27354,1652,5.7,274
"McCracken County, KY",KY,2015,28732,27102,1630,5.7,-761
"McCracken County, KY",KY,2014,29493,27433,2060,7.0,-794
"McCracken County, KY",KY,2013,30287,27920,2367,7.8,-639
"McCracken County, KY",KY,2012,30926,28450,2476,8.0,-130
"McCracken County, KY",KY,2011,31056,28378,2678,8.6,243
"McCracken County, KY",KY,2010,30813,27992,2821,9.2,0
"McCreary County, KY",KY,2021,4886,4606,280,5.7,64
"McCreary County, KY",KY,2020,4822,4485,337,7.0,102
"McCreary County, KY",KY,2019,4720,4453,267,5.7,93
"McCreary County, KY",KY,2018,4627,4344,283,6.1,-64
"McCreary County, KY",KY,2017,4691,4374,317,6.8,91
"McCreary County, KY",KY,2016,4600,4234,366,8.0,-33
"McCreary County, KY",KY,2015,4633,4243,390,8.4,-413
"McCreary County, KY",KY,2014,5046,4516,530,10.5,-295
"McCreary County, KY",KY,2013,5341,4648,693,13.0,-138
"McCreary County, KY",KY,2012,5479,4753,726,13.3,-225
"McCreary County, KY",KY,2011,5704,4872,832,14.6,-51
"McCreary County, KY",KY,2010,5755,4917,838,14.6,0
"McCulloch County, TX",TX,2021,3157,2953,204,6.5,-29
"McCulloch County, TX",TX,2020,3186,2946,240,7.5,-249
"McCulloch County, TX",TX,2019,3435,3257,178,5.2,-278
"McCulloch County, TX",TX,2018,3713,3590,123,3.3,56
"McCulloch County, TX",TX,2017,3657,3527,130,3.6,-55
"McCulloch County, TX",TX,2016,3712,3545,167,4.5,-213
"McCulloch County, TX",TX,2015,3925,3735,190,4.8,-181
"McCulloch County, TX",TX,2014,4106,3931,175,4.3,-158
"McCulloch County, TX",TX,2013,4264,4037,227,5.3,-128
"McCulloch County, TX",TX,2012,4392,4157,235,5.4,36
"McCulloch County, TX",TX,2011,4356,4089,267,6.1,254
"McCulloch County, TX",TX,2010,4102,3813,289,7.0,0
"McCurtain County, OK",OK,2021,15662,14969,693,4.4,718
"McCurtain County, OK",OK,2020,14944,13932,1012,6.8,594
"McCurtain County, OK",OK,2019,14350,13575,775,5.4,265
"McCurtain County, OK",OK,2018,14085,13343,742,5.3,-599
"McCurtain County, OK",OK,2017,14684,13808,876,6.0,-96
"McCurtain County, OK",OK,2016,14780,13760,1020,6.9,67
"McCurtain County, OK",OK,2015,14713,13575,1138,7.7,582
"McCurtain County, OK",OK,2014,14131,13026,1105,7.8,-169
"McCurtain County, OK",OK,2013,14300,12995,1305,9.1,-80
"McCurtain County, OK",OK,2012,14380,13053,1327,9.2,-296
"McCurtain County, OK",OK,2011,14676,13245,1431,9.8,181
"McCurtain County, OK",OK,2010,14495,12901,1594,11.0,0
"McDonald County, MO",MO,2021,10608,10199,409,3.9,287
"McDonald County, MO",MO,2020,10321,9794,527,5.1,-69
"McDonald County, MO",MO,2019,10390,10058,332,3.2,-45
"McDonald County, MO",MO,2018,10435,10120,315,3.0,56
"McDonald County, MO",MO,2017,10379,10003,376,3.6,-83
"McDonald County, MO",MO,2016,10462,10010,452,4.3,115
"McDonald County, MO",MO,2015,10347,9847,500,4.8,94
"McDonald County, MO",MO,2014,10253,9656,597,5.8,304
"McDonald County, MO",MO,2013,9949,9304,645,6.5,-166
"McDonald County, MO",MO,2012,10115,9418,697,6.9,-74
"McDonald County, MO",MO,2011,10189,9322,867,8.5,-127
"McDonald County, MO",MO,2010,10316,9378,938,9.1,0
"McDonough County, IL",IL,2021,12693,12069,624,4.9,-81
"McDonough County, IL",IL,2020,12774,11844,930,7.3,-674
"McDonough County, IL",IL,2019,13448,12852,596,4.4,46
"McDonough County, IL",IL,2018,13402,12742,660,4.9,-139
"McDonough County, IL",IL,2017,13541,12862,679,5.0,-545
"McDonough County, IL",IL,2016,14086,13203,883,6.3,-10
"McDonough County, IL",IL,2015,14096,13236,860,6.1,-195
"McDonough County, IL",IL,2014,14291,13307,984,6.9,-331
"McDonough County, IL",IL,2013,14622,13414,1208,8.3,-326
"McDonough County, IL",IL,2012,14948,13797,1151,7.7,-191
"McDonough County, IL",IL,2011,15139,13940,1199,7.9,-472
"McDonough County, IL",IL,2010,15611,14270,1341,8.6,0
"McDowell County, NC",NC,2021,19903,19006,897,4.5,-26
"McDowell County, NC",NC,2020,19929,18581,1348,6.8,-788
"McDowell County, NC",NC,2019,20717,19939,778,3.8,-102
"McDowell County, NC",NC,2018,20819,20102,717,3.4,144
"McDowell County, NC",NC,2017,20675,19837,838,4.1,-275
"McDowell County, NC",NC,2016,20950,19943,1007,4.8,-289
"McDowell County, NC",NC,2015,21239,20085,1154,5.4,436
"McDowell County, NC",NC,2014,20803,19506,1297,6.2,344
"McDowell County, NC",NC,2013,20459,18672,1787,8.7,-323
"McDowell County, NC",NC,2012,20782,18478,2304,11.1,79
"McDowell County, NC",NC,2011,20703,18146,2557,12.4,23
"McDowell County, NC",NC,2010,20680,17952,2728,13.2,0
"McDowell County, WV",WV,2021,4289,3936,353,8.2,-119
"McDowell County, WV",WV,2020,4408,3869,539,12.2,-53
"McDowell County, WV",WV,2019,4461,4052,409,9.2,-42
"McDowell County, WV",WV,2018,4503,4086,417,9.3,-198
"McDowell County, WV",WV,2017,4701,4280,421,9.0,-401
"McDowell County, WV",WV,2016,5102,4481,621,12.2,-297
"McDowell County, WV",WV,2015,5399,4726,673,12.5,-420
"McDowell County, WV",WV,2014,5819,5070,749,12.9,-378
"McDowell County, WV",WV,2013,6197,5416,781,12.6,-392
"McDowell County, WV",WV,2012,6589,5819,770,11.7,-74
"McDowell County, WV",WV,2011,6663,5886,777,11.7,310
"McDowell County, WV",WV,2010,6353,5513,840,13.2,0
"McDuffie County, GA",GA,2021,8554,8107,447,5.2,4
"McDuffie County, GA",GA,2020,8550,7877,673,7.9,-216
"McDuffie County, GA",GA,2019,8766,8295,471,5.4,-180
"McDuffie County, GA",GA,2018,8946,8441,505,5.6,-36
"McDuffie County, GA",GA,2017,8982,8417,565,6.3,180
"McDuffie County, GA",GA,2016,8802,8150,652,7.4,112
"McDuffie County, GA",GA,2015,8690,7954,736,8.5,-97
"McDuffie County, GA",GA,2014,8787,7906,881,10.0,-278
"McDuffie County, GA",GA,2013,9065,8047,1018,11.2,-228
"McDuffie County, GA",GA,2012,9293,8137,1156,12.4,-91
"McDuffie County, GA",GA,2011,9384,8142,1242,13.2,-93
"McDuffie County, GA",GA,2010,9477,8214,1263,13.3,0
"McHenry County, IL",IL,2021,163096,155389,7707,4.7,-1658
"McHenry County, IL",IL,2020,164754,151528,13226,8.0,-7056
"McHenry County, IL",IL,2019,171810,165911,5899,3.4,1392
"McHenry County, IL",IL,2018,170418,164248,6170,3.6,-143
"McHenry County, IL",IL,2017,170561,163010,7551,4.4,2689
"McHenry County, IL",IL,2016,167872,158890,8982,5.4,2018
"McHenry County, IL",IL,2015,165854,156760,9094,5.5,-87
"McHenry County, IL",IL,2014,165941,154933,11008,6.6,-1374
"McHenry County, IL",IL,2013,167315,152728,14587,8.7,-346
"McHenry County, IL",IL,2012,167661,152545,15116,9.0,1772
"McHenry County, IL",IL,2011,165889,149281,16608,10.0,-2700
"McHenry County, IL",IL,2010,168589,150630,17959,10.7,0
"McHenry County, ND",ND,2021,3135,2999,136,4.3,13
"McHenry County, ND",ND,2020,3122,2953,169,5.4,10
"McHenry County, ND",ND,2019,3112,3013,99,3.2,-59
"McHenry County, ND",ND,2018,3171,3056,115,3.6,-161
"McHenry County, ND",ND,2017,3332,3191,141,4.2,-37
"McHenry County, ND",ND,2016,3369,3204,165,4.9,115
"McHenry County, ND",ND,2015,3254,3117,137,4.2,-10
"McHenry County, ND",ND,2014,3264,3131,133,4.1,11
"McHenry County, ND",ND,2013,3253,3119,134,4.1,-9
"McHenry County, ND",ND,2012,3262,3128,134,4.1,-51
"McHenry County, ND",ND,2011,3313,3166,147,4.4,25
"McHenry County, ND",ND,2010,3288,3133,155,4.7,0
"McIntosh County, GA",GA,2021,6129,5904,225,3.7,183
"McIntosh County, GA",GA,2020,5946,5611,335,5.6,-162
"McIntosh County, GA",GA,2019,6108,5878,230,3.8,-162
"McIntosh County, GA",GA,2018,6270,6017,253,4.0,73
"McIntosh County, GA",GA,2017,6197,5881,316,5.1,193
"McIntosh County, GA",GA,2016,6004,5649,355,5.9,251
"McIntosh County, GA",GA,2015,5753,5373,380,6.6,-105
"McIntosh County, GA",GA,2014,5858,5395,463,7.9,-65
"McIntosh County, GA",GA,2013,5923,5395,528,8.9,-87
"McIntosh County, GA",GA,2012,6010,5433,577,9.6,-165
"McIntosh County, GA",GA,2011,6175,5525,650,10.5,-130
"McIntosh County, GA",GA,2010,6305,5632,673,10.7,0
"McIntosh County, ND",ND,2021,1093,1055,38,3.5,-9
"McIntosh County, ND",ND,2020,1102,1066,36,3.3,-20
"McIntosh County, ND",ND,2019,1122,1091,31,2.8,-42
"McIntosh County, ND",ND,2018,1164,1136,28,2.4,-76
"McIntosh County, ND",ND,2017,1240,1208,32,2.6,2
"McIntosh County, ND",ND,2016,1238,1200,38,3.1,4
"McIntosh County, ND",ND,2015,1234,1195,39,3.2,2
"McIntosh County, ND",ND,2014,1232,1196,36,2.9,-4
"McIntosh County, ND",ND,2013,1236,1199,37,3.0,-4
"McIntosh County, ND",ND,2012,1240,1202,38,3.1,-65
"McIntosh County, ND",ND,2011,1305,1258,47,3.6,-40
"McIntosh County, ND",ND,2010,1345,1287,58,4.3,0
"McIntosh County, OK",OK,2021,7106,6674,432,6.1,1
"McIntosh County, OK",OK,2020,7105,6496,609,8.6,38
"McIntosh County, OK",OK,2019,7067,6675,392,5.5,236
"McIntosh County, OK",OK,2018,6831,6444,387,5.7,-74
"McIntosh County, OK",OK,2017,6905,6400,505,7.3,-137
"McIntosh County, OK",OK,2016,7042,6435,607,8.6,-30
"McIntosh County, OK",OK,2015,7072,6476,596,8.4,48
"McIntosh County, OK",OK,2014,7024,6398,626,8.9,-351
"McIntosh County, OK",OK,2013,7375,6671,704,9.5,-10
"McIntosh County, OK",OK,2012,7385,6656,729,9.9,30
"McIntosh County, OK",OK,2011,7355,6610,745,10.1,-23
"McIntosh County, OK",OK,2010,7378,6602,776,10.5,0
"McKean County, PA",PA,2021,16882,15711,1171,6.9,-441
"McKean County, PA",PA,2020,17323,15621,1702,9.8,-194
"McKean County, PA",PA,2019,17517,16571,946,5.4,-498
"McKean County, PA",PA,2018,18015,17115,900,5.0,-322
"McKean County, PA",PA,2017,18337,17200,1137,6.2,-178
"McKean County, PA",PA,2016,18515,17303,1212,6.5,-474
"McKean County, PA",PA,2015,18989,17814,1175,6.2,-308
"McKean County, PA",PA,2014,19297,18047,1250,6.5,-323
"McKean County, PA",PA,2013,19620,18069,1551,7.9,-603
"McKean County, PA",PA,2012,20223,18564,1659,8.2,156
"McKean County, PA",PA,2011,20067,18350,1717,8.6,88
"McKean County, PA",PA,2010,19979,18024,1955,9.8,0
"McKenzie County, ND",ND,2021,8620,8144,476,5.5,-917
"McKenzie County, ND",ND,2020,9537,8811,726,7.6,-1082
"McKenzie County, ND",ND,2019,10619,10466,153,1.4,1387
"McKenzie County, ND",ND,2018,9232,9090,142,1.5,976
"McKenzie County, ND",ND,2017,8256,8052,204,2.5,326
"McKenzie County, ND",ND,2016,7930,7631,299,3.8,-1202
"McKenzie County, ND",ND,2015,9132,8905,227,2.5,43
"McKenzie County, ND",ND,2014,9089,8955,134,1.5,1616
"McKenzie County, ND",ND,2013,7473,7362,111,1.5,1409
"McKenzie County, ND",ND,2012,6064,5976,88,1.5,1458
"McKenzie County, ND",ND,2011,4606,4527,79,1.7,1012
"McKenzie County, ND",ND,2010,3594,3517,77,2.1,0
"McKinley County, NM",NM,2021,23454,21209,2245,9.6,-159
"McKinley County, NM",NM,2020,23613,21250,2363,10.0,-831
"McKinley County, NM",NM,2019,24444,22710,1734,7.1,398
"McKinley County, NM",NM,2018,24046,22354,1692,7.0,-510
"McKinley County, NM",NM,2017,24556,22468,2088,8.5,-31
"McKinley County, NM",NM,2016,24587,22260,2327,9.5,112
"McKinley County, NM",NM,2015,24475,22055,2420,9.9,411
"McKinley County, NM",NM,2014,24064,21657,2407,10.0,-383
"McKinley County, NM",NM,2013,24447,21984,2463,10.1,-482
"McKinley County, NM",NM,2012,24929,22584,2345,9.4,119
"McKinley County, NM",NM,2011,24810,22440,2370,9.6,-411
"McKinley County, NM",NM,2010,25221,22834,2387,9.5,0
"McLean County, IL",IL,2021,85656,81746,3910,4.6,875
"McLean County, IL",IL,2020,84781,78925,5856,6.9,-3422
"McLean County, IL",IL,2019,88203,85039,3164,3.6,-999
"McLean County, IL",IL,2018,89202,85542,3660,4.1,-233
"McLean County, IL",IL,2017,89435,85748,3687,4.1,-1473
"McLean County, IL",IL,2016,90908,86313,4595,5.1,-498
"McLean County, IL",IL,2015,91406,87031,4375,4.8,259
"McLean County, IL",IL,2014,91147,86138,5009,5.5,-1517
"McLean County, IL",IL,2013,92664,86595,6069,6.5,-1829
"McLean County, IL",IL,2012,94493,88452,6041,6.4,-1272
"McLean County, IL",IL,2011,95765,89448,6317,6.6,-160
"McLean County, IL",IL,2010,95925,89107,6818,7.1,0
"McLean County, KY",KY,2021,4021,3849,172,4.3,56
"McLean County, KY",KY,2020,3965,3746,219,5.5,-203
"McLean County, KY",KY,2019,4168,3991,177,4.2,-62
"McLean County, KY",KY,2018,4230,4025,205,4.8,-72
"McLean County, KY",KY,2017,4302,4076,226,5.3,-31
"McLean County, KY",KY,2016,4333,4127,206,4.8,78
"McLean County, KY",KY,2015,4255,4049,206,4.8,-63
"McLean County, KY",KY,2014,4318,4044,274,6.3,-163
"McLean County, KY",KY,2013,4481,4141,340,7.6,-81
"McLean County, KY",KY,2012,4562,4212,350,7.7,-14
"McLean County, KY",KY,2011,4576,4170,406,8.9,27
"McLean County, KY",KY,2010,4549,4079,470,10.3,0
"McLean County, ND",ND,2021,4698,4525,173,3.7,-152
"McLean County, ND",ND,2020,4850,4632,218,4.5,67
"McLean County, ND",ND,2019,4783,4647,136,2.8,-48
"McLean County, ND",ND,2018,4831,4685,146,3.0,-242
"McLean County, ND",ND,2017,5073,4914,159,3.1,15
"McLean County, ND",ND,2016,5058,4882,176,3.5,174
"McLean County, ND",ND,2015,4884,4701,183,3.7,53
"McLean County, ND",ND,2014,4831,4643,188,3.9,62
"McLean County, ND",ND,2013,4769,4570,199,4.2,45
"McLean County, ND",ND,2012,4724,4525,199,4.2,-239
"McLean County, ND",ND,2011,4963,4737,226,4.6,-147
"McLean County, ND",ND,2010,5110,4857,253,5.0,0
"McLennan County, TX",TX,2021,122192,116247,5945,4.9,3801
"McLennan County, TX",TX,2020,118391,111020,7371,6.2,606
"McLennan County, TX",TX,2019,117785,113863,3922,3.3,714
"McLennan County, TX",TX,2018,117071,112839,4232,3.6,-117
"McLennan County, TX",TX,2017,117188,112605,4583,3.9,1038
"McLennan County, TX",TX,2016,116150,111548,4602,4.0,3534
"McLennan County, TX",TX,2015,112616,107995,4621,4.1,-135
"McLennan County, TX",TX,2014,112751,106974,5777,5.1,781
"McLennan County, TX",TX,2013,111970,104994,6976,6.2,-128
"McLennan County, TX",TX,2012,112098,104700,7398,6.6,-1223
"McLennan County, TX",TX,2011,113321,104616,8705,7.7,259
"McLennan County, TX",TX,2010,113062,104694,8368,7.4,0
"McLeod County, MN",MN,2021,18763,18118,645,3.4,-666
"McLeod County, MN",MN,2020,19429,18289,1140,5.9,-118
"McLeod County, MN",MN,2019,19547,18778,769,3.9,-65
"McLeod County, MN",MN,2018,19612,18955,657,3.3,18
"McLeod County, MN",MN,2017,19594,18844,750,3.8,-171
"McLeod County, MN",MN,2016,19765,18893,872,4.4,-486
"McLeod County, MN",MN,2015,20251,19438,813,4.0,382
"McLeod County, MN",MN,2014,19869,18930,939,4.7,-172
"McLeod County, MN",MN,2013,20041,18903,1138,5.7,87
"McLeod County, MN",MN,2012,19954,18593,1361,6.8,-432
"McLeod County, MN",MN,2011,20386,18824,1562,7.7,66
"McLeod County, MN",MN,2010,20320,18497,1823,9.0,0
"McMinn County, TN",TN,2021,22540,21517,1023,4.5,-779
"McMinn County, TN",TN,2020,23319,21510,1809,7.8,-326
"McMinn County, TN",TN,2019,23645,22747,898,3.8,883
"McMinn County, TN",TN,2018,22762,21831,931,4.1,74
"McMinn County, TN",TN,2017,22688,21694,994,4.4,-88
"McMinn County, TN",TN,2016,22776,21535,1241,5.4,82
"McMinn County, TN",TN,2015,22694,21269,1425,6.3,257
"McMinn County, TN",TN,2014,22437,20740,1697,7.6,-491
"McMinn County, TN",TN,2013,22928,20860,2068,9.0,-667
"McMinn County, TN",TN,2012,23595,21400,2195,9.3,578
"McMinn County, TN",TN,2011,23017,20409,2608,11.3,146
"McMinn County, TN",TN,2010,22871,19957,2914,12.7,0
"McMullen County, TX",TX,2021,734,717,17,2.3,22
"McMullen County, TX",TX,2020,712,692,20,2.8,-93
"McMullen County, TX",TX,2019,805,792,13,1.6,96
"McMullen County, TX",TX,2018,709,696,13,1.8,-34
"McMullen County, TX",TX,2017,743,729,14,1.9,-119
"McMullen County, TX",TX,2016,862,844,18,2.1,-107
"McMullen County, TX",TX,2015,969,949,20,2.1,-89
"McMullen County, TX",TX,2014,1058,1037,21,2.0,177
"McMullen County, TX",TX,2013,881,857,24,2.7,139
"McMullen County, TX",TX,2012,742,725,17,2.3,83
"McMullen County, TX",TX,2011,659,638,21,3.2,171
"McMullen County, TX",TX,2010,488,467,21,4.3,0
"McNairy County, TN",TN,2021,8335,7890,445,5.3,-20
"McNairy County, TN",TN,2020,8355,7660,695,8.3,-129
"McNairy County, TN",TN,2019,8484,8034,450,5.3,182
"McNairy County, TN",TN,2018,8302,7847,455,5.5,-248
"McNairy County, TN",TN,2017,8550,8067,483,5.6,-222
"McNairy County, TN",TN,2016,8772,8154,618,7.0,-4
"McNairy County, TN",TN,2015,8776,8036,740,8.4,-192
"McNairy County, TN",TN,2014,8968,8013,955,10.6,-392
"McNairy County, TN",TN,2013,9360,8267,1093,11.7,-398
"McNairy County, TN",TN,2012,9758,8740,1018,10.4,-623
"McNairy County, TN",TN,2011,10381,9189,1192,11.5,-132
"McNairy County, TN",TN,2010,10513,9140,1373,13.1,0
"McPherson County, KS",KS,2021,17164,16802,362,2.1,3
"McPherson County, KS",KS,2020,17161,16596,565,3.3,-128
"McPherson County, KS",KS,2019,17289,16909,380,2.2,707
"McPherson County, KS",KS,2018,16582,16172,410,2.5,202
"McPherson County, KS",KS,2017,16380,15930,450,2.7,-33
"McPherson County, KS",KS,2016,16413,15897,516,3.1,-815
"McPherson County, KS",KS,2015,17228,16714,514,3.0,375
"McPherson County, KS",KS,2014,16853,16310,543,3.2,235
"McPherson County, KS",KS,2013,16618,15974,644,3.9,-100
"McPherson County, KS",KS,2012,16718,16032,686,4.1,-19
"McPherson County, KS",KS,2011,16737,15985,752,4.5,257
"McPherson County, KS",KS,2010,16480,15641,839,5.1,0
"McPherson County, NE",NE,2021,433,426,7,1.6,-10
"McPherson County, NE",NE,2020,443,432,11,2.5,-7
"McPherson County, NE",NE,2019,450,439,11,2.4,3
"McPherson County, NE",NE,2018,447,435,12,2.7,-9
"McPherson County, NE",NE,2017,456,446,10,2.2,-10
"McPherson County, NE",NE,2016,466,455,11,2.4,4
"McPherson County, NE",NE,2015,462,453,9,1.9,23
"McPherson County, NE",NE,2014,439,429,10,2.3,68
"McPherson County, NE",NE,2013,371,357,14,3.8,12
"McPherson County, NE",NE,2012,359,347,12,3.3,-7
"McPherson County, NE",NE,2011,366,357,9,2.5,14
"McPherson County, NE",NE,2010,352,342,10,2.8,0
"McPherson County, SD",SD,2021,962,922,40,4.2,-28
"McPherson County, SD",SD,2020,990,942,48,4.8,-1
"McPherson County, SD",SD,2019,991,955,36,3.6,-27
"McPherson County, SD",SD,2018,1018,982,36,3.5,-29
"McPherson County, SD",SD,2017,1047,1014,33,3.2,-47
"McPherson County, SD",SD,2016,1094,1056,38,3.5,-26
"McPherson County, SD",SD,2015,1120,1083,37,3.3,-16
"McPherson County, SD",SD,2014,1136,1093,43,3.8,-6
"McPherson County, SD",SD,2013,1142,1100,42,3.7,-14
"McPherson County, SD",SD,2012,1156,1105,51,4.4,-19
"McPherson County, SD",SD,2011,1175,1124,51,4.3,-39
"McPherson County, SD",SD,2010,1214,1155,59,4.9,0
"Meade County, KS",KS,2021,2187,2139,48,2.2,39
"Meade County, KS",KS,2020,2148,2091,57,2.7,-12
"Meade County, KS",KS,2019,2160,2111,49,2.3,-127
"Meade County, KS",KS,2018,2287,2241,46,2.0,0
"Meade County, KS",KS,2017,2287,2231,56,2.4,-101
"Meade County, KS",KS,2016,2388,2324,64,2.7,-37
"Meade County, KS",KS,2015,2425,2353,72,3.0,41
"Meade County, KS",KS,2014,2384,2321,63,2.6,28
"Meade County, KS",KS,2013,2356,2282,74,3.1,-124
"Meade County, KS",KS,2012,2480,2397,83,3.3,-67
"Meade County, KS",KS,2011,2547,2454,93,3.7,-21
"Meade County, KS",KS,2010,2568,2461,107,4.2,0
"Meade County, KY",KY,2021,11679,11061,618,5.3,-70
"Meade County, KY",KY,2020,11749,10939,810,6.9,-453
"Meade County, KY",KY,2019,12202,11662,540,4.4,-39
"Meade County, KY",KY,2018,12241,11685,556,4.5,5
"Meade County, KY",KY,2017,12236,11617,619,5.1,144
"Meade County, KY",KY,2016,12092,11477,615,5.1,307
"Meade County, KY",KY,2015,11785,11136,649,5.5,-341
"Meade County, KY",KY,2014,12126,11274,852,7.0,-409
"Meade County, KY",KY,2013,12535,11420,1115,8.9,-104
"Meade County, KY",KY,2012,12639,11398,1241,9.8,-206
"Meade County, KY",KY,2011,12845,11402,1443,11.2,442
"Meade County, KY",KY,2010,12403,10927,1476,11.9,0
"Meade County, SD",SD,2021,14140,13712,428,3.0,351
"Meade County, SD",SD,2020,13789,13146,643,4.7,-109
"Meade County, SD",SD,2019,13898,13468,430,3.1,-51
"Meade County, SD",SD,2018,13949,13522,427,3.1,12
"Meade County, SD",SD,2017,13937,13497,440,3.2,191
"Meade County, SD",SD,2016,13746,13310,436,3.2,325
"Meade County, SD",SD,2015,13421,13004,417,3.1,32
"Meade County, SD",SD,2014,13389,12951,438,3.3,-264
"Meade County, SD",SD,2013,13653,13143,510,3.7,343
"Meade County, SD",SD,2012,13310,12757,553,4.2,88
"Meade County, SD",SD,2011,13222,12598,624,4.7,7
"Meade County, SD",SD,2010,13215,12530,685,5.2,0
"Meagher County, MT",MT,2021,988,963,25,2.5,29
"Meagher County, MT",MT,2020,959,915,44,4.6,-11
"Meagher County, MT",MT,2019,970,936,34,3.5,6
"Meagher County, MT",MT,2018,964,927,37,3.8,29
"Meagher County, MT",MT,2017,935,894,41,4.4,20
"Meagher County, MT",MT,2016,915,877,38,4.2,-21
"Meagher County, MT",MT,2015,936,901,35,3.7,28
"Meagher County, MT",MT,2014,908,869,39,4.3,-25
"Meagher County, MT",MT,2013,933,884,49,5.3,3
"Meagher County, MT",MT,2012,930,881,49,5.3,20
"Meagher County, MT",MT,2011,910,845,65,7.1,-27
"Meagher County, MT",MT,2010,937,862,75,8.0,0
"Mecklenburg County, NC",NC,2021,618847,588559,30288,4.9,12562
"Mecklenburg County, NC",NC,2020,606285,561076,45209,7.5,-9767
"Mecklenburg County, NC",NC,2019,616052,593752,22300,3.6,13617
"Mecklenburg County, NC",NC,2018,602435,579347,23088,3.8,10385
"Mecklenburg County, NC",NC,2017,592050,566533,25517,4.3,10420
"Mecklenburg County, NC",NC,2016,581630,554067,27563,4.7,16947
"Mecklenburg County, NC",NC,2015,564683,534833,29850,5.3,16599
"Mecklenburg County, NC",NC,2014,548084,516183,31901,5.8,9920
"Mecklenburg County, NC",NC,2013,538164,498854,39310,7.3,5933
"Mecklenburg County, NC",NC,2012,532231,484538,47693,9.0,15745
"Mecklenburg County, NC",NC,2011,516486,465317,51169,9.9,12140
"Mecklenburg County, NC",NC,2010,504346,451042,53304,10.6,0
"Mecklenburg County, VA",VA,2021,12429,11842,587,4.7,-245
"Mecklenburg County, VA",VA,2020,12674,11818,856,6.8,-160
"Mecklenburg County, VA",VA,2019,12834,12327,507,4.0,42
"Mecklenburg County, VA",VA,2018,12792,12277,515,4.0,-67
"Mecklenburg County, VA",VA,2017,12859,12236,623,4.8,386
"Mecklenburg County, VA",VA,2016,12473,11783,690,5.5,-88
"Mecklenburg County, VA",VA,2015,12561,11803,758,6.0,-102
"Mecklenburg County, VA",VA,2014,12663,11705,958,7.6,-108
"Mecklenburg County, VA",VA,2013,12771,11608,1163,9.1,-737
"Mecklenburg County, VA",VA,2012,13508,12260,1248,9.2,-523
"Mecklenburg County, VA",VA,2011,14031,12582,1449,10.3,-152
"Mecklenburg County, VA",VA,2010,14183,12546,1637,11.5,0
"Mecosta County, MI",MI,2021,17735,16605,1130,6.4,-565
"Mecosta County, MI",MI,2020,18300,16555,1745,9.5,-140
"Mecosta County, MI",MI,2019,18440,17566,874,4.7,-57
"Mecosta County, MI",MI,2018,18497,17566,931,5.0,-301
"Mecosta County, MI",MI,2017,18798,17740,1058,5.6,-362
"Mecosta County, MI",MI,2016,19160,18071,1089,5.7,-75
"Mecosta County, MI",MI,2015,19235,18036,1199,6.2,13
"Mecosta County, MI",MI,2014,19222,17694,1528,7.9,447
"Mecosta County, MI",MI,2013,18775,16912,1863,9.9,-117
"Mecosta County, MI",MI,2012,18892,17002,1890,10.0,-191
"Mecosta County, MI",MI,2011,19083,17012,2071,10.9,-33
"Mecosta County, MI",MI,2010,19116,16778,2338,12.2,0
"Medina County, OH",OH,2021,95616,91488,4128,4.3,627
"Medina County, OH",OH,2020,94989,87686,7303,7.7,-5703
"Medina County, OH",OH,2019,100692,97148,3544,3.5,1698
"Medina County, OH",OH,2018,98994,95071,3923,4.0,707
"Medina County, OH",OH,2017,98287,93717,4570,4.6,2398
"Medina County, OH",OH,2016,95889,91657,4232,4.4,1364
"Medina County, OH",OH,2015,94525,90591,3934,4.2,-317
"Medina County, OH",OH,2014,94842,90047,4795,5.1,451
"Medina County, OH",OH,2013,94391,88883,5508,5.8,380
"Medina County, OH",OH,2012,94011,88817,5194,5.5,-1152
"Medina County, OH",OH,2011,95163,89095,6068,6.4,-378
"Medina County, OH",OH,2010,95541,88416,7125,7.5,0
"Medina County, TX",TX,2021,21832,20744,1088,5.0,640
"Medina County, TX",TX,2020,21192,19850,1342,6.3,-336
"Medina County, TX",TX,2019,21528,20844,684,3.2,178
"Medina County, TX",TX,2018,21350,20601,749,3.5,227
"Medina County, TX",TX,2017,21123,20297,826,3.9,124
"Medina County, TX",TX,2016,20999,20073,926,4.4,568
"Medina County, TX",TX,2015,20431,19531,900,4.4,58
"Medina County, TX",TX,2014,20373,19359,1014,5.0,87
"Medina County, TX",TX,2013,20286,19043,1243,6.1,128
"Medina County, TX",TX,2012,20158,18846,1312,6.5,-77
"Medina County, TX",TX,2011,20235,18674,1561,7.7,190
"Medina County, TX",TX,2010,20045,18526,1519,7.6,0
"Meeker County, MN",MN,2021,12907,12470,437,3.4,-465
"Meeker County, MN",MN,2020,13372,12642,730,5.5,-127
"Meeker County, MN",MN,2019,13499,12945,554,4.1,276
"Meeker County, MN",MN,2018,13223,12731,492,3.7,-80
"Meeker County, MN",MN,2017,13303,12760,543,4.1,49
"Meeker County, MN",MN,2016,13254,12659,595,4.5,-119
"Meeker County, MN",MN,2015,13373,12800,573,4.3,483
"Meeker County, MN",MN,2014,12890,12284,606,4.7,134
"Meeker County, MN",MN,2013,12756,12039,717,5.6,4
"Meeker County, MN",MN,2012,12752,11906,846,6.6,-121
"Meeker County, MN",MN,2011,12873,11875,998,7.8,52
"Meeker County, MN",MN,2010,12821,11690,1131,8.8,0
"Meigs County, OH",OH,2021,8744,8164,580,6.6,-224
"Meigs County, OH",OH,2020,8968,8095,873,9.7,-229
"Meigs County, OH",OH,2019,9197,8559,638,6.9,187
"Meigs County, OH",OH,2018,9010,8361,649,7.2,-6
"Meigs County, OH",OH,2017,9016,8283,733,8.1,26
"Meigs County, OH",OH,2016,8990,8218,772,8.6,-137
"Meigs County, OH",OH,2015,9127,8368,759,8.3,-81
"Meigs County, OH",OH,2014,9208,8379,829,9.0,-199
"Meigs County, OH",OH,2013,9407,8293,1114,11.8,-98
"Meigs County, OH",OH,2012,9505,8409,1096,11.5,-280
"Meigs County, OH",OH,2011,9785,8502,1283,13.1,-280
"Meigs County, OH",OH,2010,10065,8590,1475,14.7,0
"Meigs County, TN",TN,2021,5162,4911,251,4.9,-31
"Meigs County, TN",TN,2020,5193,4745,448,8.6,-17
"Meigs County, TN",TN,2019,5210,4974,236,4.5,136
"Meigs County, TN",TN,2018,5074,4842,232,4.6,71
"Meigs County, TN",TN,2017,5003,4741,262,5.2,102
"Meigs County, TN",TN,2016,4901,4565,336,6.9,35
"Meigs County, TN",TN,2015,4866,4498,368,7.6,-17
"Meigs County, TN",TN,2014,4883,4457,426,8.7,-164
"Meigs County, TN",TN,2013,5047,4532,515,10.2,-11
"Meigs County, TN",TN,2012,5058,4529,529,10.5,84
"Meigs County, TN",TN,2011,4974,4371,603,12.1,-5
"Meigs County, TN",TN,2010,4979,4316,663,13.3,0
"Mellette County, SD",SD,2021,729,696,33,4.5,21
"Mellette County, SD",SD,2020,708,666,42,5.9,-29
"Mellette County, SD",SD,2019,737,701,36,4.9,-7
"Mellette County, SD",SD,2018,744,711,33,4.4,-19
"Mellette County, SD",SD,2017,763,728,35,4.6,-11
"Mellette County, SD",SD,2016,774,741,33,4.3,-29
"Mellette County, SD",SD,2015,803,762,41,5.1,-29
"Mellette County, SD",SD,2014,832,783,49,5.9,-7
"Mellette County, SD",SD,2013,839,777,62,7.4,-24
"Mellette County, SD",SD,2012,863,799,64,7.4,-8
"Mellette County, SD",SD,2011,871,817,54,6.2,-6
"Mellette County, SD",SD,2010,877,822,55,6.3,0
"Menard County, IL",IL,2021,6145,5893,252,4.1,102
"Menard County, IL",IL,2020,6043,5647,396,6.6,-367
"Menard County, IL",IL,2019,6410,6174,236,3.7,-131
"Menard County, IL",IL,2018,6541,6275,266,4.1,25
"Menard County, IL",IL,2017,6516,6240,276,4.2,-256
"Menard County, IL",IL,2016,6772,6454,318,4.7,148
"Menard County, IL",IL,2015,6624,6306,318,4.8,0
"Menard County, IL",IL,2014,6624,6239,385,5.8,36
"Menard County, IL",IL,2013,6588,6115,473,7.2,-263
"Menard County, IL",IL,2012,6851,6359,492,7.2,-188
"Menard County, IL",IL,2011,7039,6524,515,7.3,2
"Menard County, IL",IL,2010,7037,6498,539,7.7,0
"Menard County, TX",TX,2021,837,797,40,4.8,-20
"Menard County, TX",TX,2020,857,813,44,5.1,3
"Menard County, TX",TX,2019,854,825,29,3.4,34
"Menard County, TX",TX,2018,820,786,34,4.1,20
"Menard County, TX",TX,2017,800,761,39,4.9,-18
"Menard County, TX",TX,2016,818,781,37,4.5,-39
"Menard County, TX",TX,2015,857,812,45,5.3,-27
"Menard County, TX",TX,2014,884,842,42,4.8,-33
"Menard County, TX",TX,2013,917,863,54,5.9,-53
"Menard County, TX",TX,2012,970,909,61,6.3,26
"Menard County, TX",TX,2011,944,874,70,7.4,-62
"Menard County, TX",TX,2010,1006,931,75,7.5,0
"Mendocino County, CA",CA,2021,36920,34622,2298,6.2,-179
"Mendocino County, CA",CA,2020,37099,33698,3401,9.2,-1626
"Mendocino County, CA",CA,2019,38725,37159,1566,4.0,-728
"Mendocino County, CA",CA,2018,39453,37864,1589,4.0,-81
"Mendocino County, CA",CA,2017,39534,37735,1799,4.6,-83
"Mendocino County, CA",CA,2016,39617,37521,2096,5.3,-214
"Mendocino County, CA",CA,2015,39831,37500,2331,5.9,-470
"Mendocino County, CA",CA,2014,40301,37446,2855,7.1,-389
"Mendocino County, CA",CA,2013,40690,37246,3444,8.5,-170
"Mendocino County, CA",CA,2012,40860,36693,4167,10.2,-14
"Mendocino County, CA",CA,2011,40874,36141,4733,11.6,-740
"Mendocino County, CA",CA,2010,41614,36679,4935,11.9,0
"Menifee County, KY",KY,2021,2309,2150,159,6.9,59
"Menifee County, KY",KY,2020,2250,2056,194,8.6,-79
"Menifee County, KY",KY,2019,2329,2175,154,6.6,14
"Menifee County, KY",KY,2018,2315,2143,172,7.4,-52
"Menifee County, KY",KY,2017,2367,2164,203,8.6,-26
"Menifee County, KY",KY,2016,2393,2188,205,8.6,40
"Menifee County, KY",KY,2015,2353,2152,201,8.5,-4
"Menifee County, KY",KY,2014,2357,2127,230,9.8,-132
"Menifee County, KY",KY,2013,2489,2191,298,12.0,-58
"Menifee County, KY",KY,2012,2547,2249,298,11.7,-1
"Menifee County, KY",KY,2011,2548,2191,357,14.0,-27
"Menifee County, KY",KY,2010,2575,2172,403,15.7,0
"Menominee County, MI",MI,2021,10438,9966,472,4.5,-195
"Menominee County, MI",MI,2020,10633,9917,716,6.7,-378
"Menominee County, MI",MI,2019,11011,10561,450,4.1,5
"Menominee County, MI",MI,2018,11006,10557,449,4.1,5
"Menominee County, MI",MI,2017,11001,10475,526,4.8,-280
"Menominee County, MI",MI,2016,11281,10693,588,5.2,-302
"Menominee County, MI",MI,2015,11583,10951,632,5.5,-169
"Menominee County, MI",MI,2014,11752,10943,809,6.9,-40
"Menominee County, MI",MI,2013,11792,10887,905,7.7,-8
"Menominee County, MI",MI,2012,11800,10864,936,7.9,7
"Menominee County, MI",MI,2011,11793,10760,1033,8.8,-54
"Menominee County, MI",MI,2010,11847,10508,1339,11.3,0
"Menominee County, WI",WI,2021,1593,1456,137,8.6,-73
"Menominee County, WI",WI,2020,1666,1407,259,15.5,68
"Menominee County, WI",WI,2019,1598,1473,125,7.8,-33
"Menominee County, WI",WI,2018,1631,1537,94,5.8,19
"Menominee County, WI",WI,2017,1612,1517,95,5.9,43
"Menominee County, WI",WI,2016,1569,1452,117,7.5,-29
"Menominee County, WI",WI,2015,1598,1447,151,9.4,2
"Menominee County, WI",WI,2014,1596,1401,195,12.2,25
"Menominee County, WI",WI,2013,1571,1324,247,15.7,-14
"Menominee County, WI",WI,2012,1585,1330,255,16.1,-10
"Menominee County, WI",WI,2011,1595,1327,268,16.8,47
"Menominee County, WI",WI,2010,1548,1282,266,17.2,0
"Merced County, CA",CA,2021,115158,103223,11935,10.4,-174
"Merced County, CA",CA,2020,115332,100761,14571,12.6,-632
"Merced County, CA",CA,2019,115964,106423,9541,8.2,713
"Merced County, CA",CA,2018,115251,105501,9750,8.5,41
"Merced County, CA",CA,2017,115210,104330,10880,9.4,871
"Merced County, CA",CA,2016,114339,102211,12128,10.6,278
"Merced County, CA",CA,2015,114061,101031,13030,11.4,-108
"Merced County, CA",CA,2014,114169,99355,14814,13.0,-142
"Merced County, CA",CA,2013,114311,97543,16768,14.7,-590
"Merced County, CA",CA,2012,114901,95852,19049,16.6,208
"Merced County, CA",CA,2011,114693,94128,20565,17.9,819
"Merced County, CA",CA,2010,113874,92954,20920,18.4,0
"Mercer County, IL",IL,2021,7555,7184,371,4.9,-42
"Mercer County, IL",IL,2020,7597,6971,626,8.2,-471
"Mercer County, IL",IL,2019,8068,7681,387,4.8,-66
"Mercer County, IL",IL,2018,8134,7710,424,5.2,54
"Mercer County, IL",IL,2017,8080,7666,414,5.1,-178
"Mercer County, IL",IL,2016,8258,7744,514,6.2,15
"Mercer County, IL",IL,2015,8243,7728,515,6.2,-73
"Mercer County, IL",IL,2014,8316,7730,586,7.0,-104
"Mercer County, IL",IL,2013,8420,7763,657,7.8,-212
"Mercer County, IL",IL,2012,8632,7961,671,7.8,-236
"Mercer County, IL",IL,2011,8868,8125,743,8.4,-102
"Mercer County, IL",IL,2010,8970,8071,899,10.0,0
"Mercer County, KY",KY,2021,9932,9480,452,4.6,69
"Mercer County, KY",KY,2020,9863,9168,695,7.0,-208
"Mercer County, KY",KY,2019,10071,9629,442,4.4,176
"Mercer County, KY",KY,2018,9895,9470,425,4.3,-84
"Mercer County, KY",KY,2017,9979,9498,481,4.8,88
"Mercer County, KY",KY,2016,9891,9418,473,4.8,216
"Mercer County, KY",KY,2015,9675,9192,483,5.0,-228
"Mercer County, KY",KY,2014,9903,9294,609,6.1,-289
"Mercer County, KY",KY,2013,10192,9399,793,7.8,-57
"Mercer County, KY",KY,2012,10249,9400,849,8.3,-8
"Mercer County, KY",KY,2011,10257,9199,1058,10.3,-330
"Mercer County, KY",KY,2010,10587,9391,1196,11.3,0
"Mercer County, MO",MO,2021,1805,1752,53,2.9,-57
"Mercer County, MO",MO,2020,1862,1797,65,3.5,21
"Mercer County, MO",MO,2019,1841,1786,55,3.0,-63
"Mercer County, MO",MO,2018,1904,1846,58,3.0,-39
"Mercer County, MO",MO,2017,1943,1871,72,3.7,17
"Mercer County, MO",MO,2016,1926,1838,88,4.6,50
"Mercer County, MO",MO,2015,1876,1791,85,4.5,13
"Mercer County, MO",MO,2014,1863,1768,95,5.1,60
"Mercer County, MO",MO,2013,1803,1704,99,5.5,-18
"Mercer County, MO",MO,2012,1821,1724,97,5.3,-7
"Mercer County, MO",MO,2011,1828,1703,125,6.8,40
"Mercer County, MO",MO,2010,1788,1640,148,8.3,0
"Mercer County, ND",ND,2021,3670,3498,172,4.7,17
"Mercer County, ND",ND,2020,3653,3443,210,5.7,-30
"Mercer County, ND",ND,2019,3683,3546,137,3.7,-320
"Mercer County, ND",ND,2018,4003,3849,154,3.8,-494
"Mercer County, ND",ND,2017,4497,4318,179,4.0,-146
"Mercer County, ND",ND,2016,4643,4439,204,4.4,368
"Mercer County, ND",ND,2015,4275,4095,180,4.2,174
"Mercer County, ND",ND,2014,4101,3943,158,3.9,-21
"Mercer County, ND",ND,2013,4122,3933,189,4.6,114
"Mercer County, ND",ND,2012,4008,3804,204,5.1,-117
"Mercer County, ND",ND,2011,4125,3910,215,5.2,-207
"Mercer County, ND",ND,2010,4332,4109,223,5.1,0
"Mercer County, NJ",NJ,2021,212752,201755,10997,5.2,1329
"Mercer County, NJ",NJ,2020,211423,196139,15284,7.2,-385
"Mercer County, NJ",NJ,2019,211808,205453,6355,3.0,5103
"Mercer County, NJ",NJ,2018,206705,199513,7192,3.5,2663
"Mercer County, NJ",NJ,2017,204042,195887,8155,4.0,5195
"Mercer County, NJ",NJ,2016,198847,190295,8552,4.3,1219
"Mercer County, NJ",NJ,2015,197628,187904,9724,4.9,2502
"Mercer County, NJ",NJ,2014,195126,183732,11394,5.8,1403
"Mercer County, NJ",NJ,2013,193723,179370,14353,7.4,-643
"Mercer County, NJ",NJ,2012,194366,178269,16097,8.3,511
"Mercer County, NJ",NJ,2011,193855,177808,16047,8.3,467
"Mercer County, NJ",NJ,2010,193388,177008,16380,8.5,0
"Mercer County, OH",OH,2021,22895,22181,714,3.1,-485
"Mercer County, OH",OH,2020,23380,22124,1256,5.4,-245
"Mercer County, OH",OH,2019,23625,23004,621,2.6,-120
"Mercer County, OH",OH,2018,23745,23094,651,2.7,111
"Mercer County, OH",OH,2017,23634,22911,723,3.1,118
"Mercer County, OH",OH,2016,23516,22743,773,3.3,439
"Mercer County, OH",OH,2015,23077,22312,765,3.3,360
"Mercer County, OH",OH,2014,22717,21852,865,3.8,337
"Mercer County, OH",OH,2013,22380,21238,1142,5.1,236
"Mercer County, OH",OH,2012,22144,21013,1131,5.1,22
"Mercer County, OH",OH,2011,22122,20628,1494,6.8,-236
"Mercer County, OH",OH,2010,22358,20460,1898,8.5,0
"Mercer County, PA",PA,2021,47850,44435,3415,7.1,-860
"Mercer County, PA",PA,2020,48710,43991,4719,9.7,-844
"Mercer County, PA",PA,2019,49554,47078,2476,5.0,-927
"Mercer County, PA",PA,2018,50481,48012,2469,4.9,-681
"Mercer County, PA",PA,2017,51162,48322,2840,5.6,-1445
"Mercer County, PA",PA,2016,52607,49502,3105,5.9,-415
"Mercer County, PA",PA,2015,53022,50077,2945,5.6,8
"Mercer County, PA",PA,2014,53014,49867,3147,5.9,-537
"Mercer County, PA",PA,2013,53551,49806,3745,7.0,-274
"Mercer County, PA",PA,2012,53825,49847,3978,7.4,598
"Mercer County, PA",PA,2011,53227,49126,4101,7.7,-205
"Mercer County, PA",PA,2010,53432,48497,4935,9.2,0
"Mercer County, WV",WV,2021,20622,19377,1245,6.0,-123
"Mercer County, WV",WV,2020,20745,18854,1891,9.1,-237
"Mercer County, WV",WV,2019,20982,19784,1198,5.7,-212
"Mercer County, WV",WV,2018,21194,19881,1313,6.2,-259
"Mercer County, WV",WV,2017,21453,20200,1253,5.8,-307
"Mercer County, WV",WV,2016,21760,20302,1458,6.7,-465
"Mercer County, WV",WV,2015,22225,20650,1575,7.1,-204
"Mercer County, WV",WV,2014,22429,20748,1681,7.5,-721
"Mercer County, WV",WV,2013,23150,21400,1750,7.6,-277
"Mercer County, WV",WV,2012,23427,21534,1893,8.1,-288
"Mercer County, WV",WV,2011,23715,21734,1981,8.4,-326
"Mercer County, WV",WV,2010,24041,22003,2038,8.5,0
"Meriwether County, GA",GA,2021,8897,8429,468,5.3,156
"Meriwether County, GA",GA,2020,8741,7991,750,8.6,-166
"Meriwether County, GA",GA,2019,8907,8484,423,4.7,19
"Meriwether County, GA",GA,2018,8888,8437,451,5.1,-63
"Meriwether County, GA",GA,2017,8951,8418,533,6.0,192
"Meriwether County, GA",GA,2016,8759,8150,609,7.0,183
"Meriwether County, GA",GA,2015,8576,7877,699,8.2,-158
"Meriwether County, GA",GA,2014,8734,7878,856,9.8,-68
"Meriwether County, GA",GA,2013,8802,7861,941,10.7,-193
"Meriwether County, GA",GA,2012,8995,7930,1065,11.8,-226
"Meriwether County, GA",GA,2011,9221,8001,1220,13.2,-146
"Meriwether County, GA",GA,2010,9367,8065,1302,13.9,0
"Merrick County, NE",NE,2021,4148,4051,97,2.3,66
"Merrick County, NE",NE,2020,4082,3925,157,3.8,-7
"Merrick County, NE",NE,2019,4089,3958,131,3.2,48
"Merrick County, NE",NE,2018,4041,3925,116,2.9,-51
"Merrick County, NE",NE,2017,4092,3977,115,2.8,36
"Merrick County, NE",NE,2016,4056,3910,146,3.6,13
"Merrick County, NE",NE,2015,4043,3893,150,3.7,-73
"Merrick County, NE",NE,2014,4116,3961,155,3.8,-79
"Merrick County, NE",NE,2013,4195,4043,152,3.6,-29
"Merrick County, NE",NE,2012,4224,4073,151,3.6,49
"Merrick County, NE",NE,2011,4175,3997,178,4.3,-18
"Merrick County, NE",NE,2010,4193,4001,192,4.6,0
"Merrimack County, NH",NH,2021,81221,78615,2606,3.2,-1152
"Merrimack County, NH",NH,2020,82373,77539,4834,5.9,-1768
"Merrimack County, NH",NH,2019,84141,82202,1939,2.3,639
"Merrimack County, NH",NH,2018,83502,81575,1927,2.3,1043
"Merrimack County, NH",NH,2017,82459,80429,2030,2.5,422
"Merrimack County, NH",NH,2016,82037,79943,2094,2.6,603
"Merrimack County, NH",NH,2015,81434,78901,2533,3.1,337
"Merrimack County, NH",NH,2014,81097,77975,3122,3.8,37
"Merrimack County, NH",NH,2013,81060,77196,3864,4.8,-72
"Merrimack County, NH",NH,2012,81132,77154,3978,4.9,-15
"Merrimack County, NH",NH,2011,81147,77111,4036,5.0,-359
"Merrimack County, NH",NH,2010,81506,76943,4563,5.6,0
"Mesa County, CO",CO,2021,77219,72798,4421,5.7,2494
"Mesa County, CO",CO,2020,74725,69424,5301,7.1,-646
"Mesa County, CO",CO,2019,75371,72931,2440,3.2,548
"Mesa County, CO",CO,2018,74823,72024,2799,3.7,1850
"Mesa County, CO",CO,2017,72973,70295,2678,3.7,929
"Mesa County, CO",CO,2016,72044,68374,3670,5.1,286
"Mesa County, CO",CO,2015,71758,67929,3829,5.3,-1421
"Mesa County, CO",CO,2014,73179,68640,4539,6.2,-302
"Mesa County, CO",CO,2013,73481,67161,6320,8.6,-1247
"Mesa County, CO",CO,2012,74728,67409,7319,9.8,-619
"Mesa County, CO",CO,2011,75347,67366,7981,10.6,-546
"Mesa County, CO",CO,2010,75893,67247,8646,11.4,0
"Metcalfe County, KY",KY,2021,3980,3764,216,5.4,-2
"Metcalfe County, KY",KY,2020,3982,3680,302,7.6,-130
"Metcalfe County, KY",KY,2019,4112,3925,187,4.5,-2
"Metcalfe County, KY",KY,2018,4114,3946,168,4.1,-68
"Metcalfe County, KY",KY,2017,4182,4014,168,4.0,62
"Metcalfe County, KY",KY,2016,4120,3934,186,4.5,100
"Metcalfe County, KY",KY,2015,4020,3813,207,5.1,-113
"Metcalfe County, KY",KY,2014,4133,3882,251,6.1,-201
"Metcalfe County, KY",KY,2013,4334,3999,335,7.7,-94
"Metcalfe County, KY",KY,2012,4428,4074,354,8.0,-193
"Metcalfe County, KY",KY,2011,4621,4104,517,11.2,-79
"Metcalfe County, KY",KY,2010,4700,4068,632,13.4,0
"Miami County, IN",IN,2021,14721,14076,645,4.4,-459
"Miami County, IN",IN,2020,15180,13928,1252,8.2,-181
"Miami County, IN",IN,2019,15361,14764,597,3.9,-487
"Miami County, IN",IN,2018,15848,15221,627,4.0,-14
"Miami County, IN",IN,2017,15862,15246,616,3.9,-241
"Miami County, IN",IN,2016,16103,15351,752,4.7,354
"Miami County, IN",IN,2015,15749,14934,815,5.2,72
"Miami County, IN",IN,2014,15677,14646,1031,6.6,49
"Miami County, IN",IN,2013,15628,14296,1332,8.5,-17
"Miami County, IN",IN,2012,15645,14145,1500,9.6,-323
"Miami County, IN",IN,2011,15968,14334,1634,10.2,26
"Miami County, IN",IN,2010,15942,14002,1940,12.2,0
"Miami County, KS",KS,2021,17750,17231,519,2.9,180
"Miami County, KS",KS,2020,17570,16720,850,4.8,-202
"Miami County, KS",KS,2019,17772,17193,579,3.3,312
"Miami County, KS",KS,2018,17460,16844,616,3.5,58
"Miami County, KS",KS,2017,17402,16755,647,3.7,304
"Miami County, KS",KS,2016,17098,16389,709,4.1,296
"Miami County, KS",KS,2015,16802,16075,727,4.3,-78
"Miami County, KS",KS,2014,16880,16090,790,4.7,58
"Miami County, KS",KS,2013,16822,15884,938,5.6,6
"Miami County, KS",KS,2012,16816,15756,1060,6.3,-177
"Miami County, KS",KS,2011,16993,15788,1205,7.1,-116
"Miami County, KS",KS,2010,17109,15829,1280,7.5,0
"Miami County, OH",OH,2021,53518,51238,2280,4.3,-376
"Miami County, OH",OH,2020,53894,50121,3773,7.0,-966
"Miami County, OH",OH,2019,54860,52819,2041,3.7,863
"Miami County, OH",OH,2018,53997,51892,2105,3.9,201
"Miami County, OH",OH,2017,53796,51518,2278,4.2,576
"Miami County, OH",OH,2016,53220,50887,2333,4.4,652
"Miami County, OH",OH,2015,52568,50231,2337,4.4,367
"Miami County, OH",OH,2014,52201,49386,2815,5.4,374
"Miami County, OH",OH,2013,51827,48099,3728,7.2,-515
"Miami County, OH",OH,2012,52342,48540,3802,7.3,-976
"Miami County, OH",OH,2011,53318,48455,4863,9.1,-1160
"Miami County, OH",OH,2010,54478,48423,6055,11.1,0
"Miami-Dade County, FL",FL,2021,1307815,1239474,68341,5.2,36169
"Miami-Dade County, FL",FL,2020,1271646,1177701,93945,7.4,-105803
"Miami-Dade County, FL",FL,2019,1377449,1340491,36958,2.7,23141
"Miami-Dade County, FL",FL,2018,1354308,1302089,52219,3.9,5388
"Miami-Dade County, FL",FL,2017,1348920,1284543,64377,4.8,43661
"Miami-Dade County, FL",FL,2016,1305259,1233029,72230,5.5,9986
"Miami-Dade County, FL",FL,2015,1295273,1215857,79416,6.1,-2922
"Miami-Dade County, FL",FL,2014,1298195,1210346,87849,6.8,25378
"Miami-Dade County, FL",FL,2013,1272817,1176128,96689,7.6,-14496
"Miami-Dade County, FL",FL,2012,1287313,1185974,101339,7.9,25358
"Miami-Dade County, FL",FL,2011,1261955,1140476,121479,9.6,32574
"Miami-Dade County, FL",FL,2010,1229381,1085051,144330,11.7,0
"Middlesex County, CT",CT,2021,91071,86362,4709,5.2,-2138
"Middlesex County, CT",CT,2020,93209,87216,5993,6.4,-2531
"Middlesex County, CT",CT,2019,95740,92857,2883,3.0,1254
"Middlesex County, CT",CT,2018,94486,91324,3162,3.3,464
"Middlesex County, CT",CT,2017,94022,90439,3583,3.8,1533
"Middlesex County, CT",CT,2016,92489,88623,3866,4.2,112
"Middlesex County, CT",CT,2015,92377,87905,4472,4.8,46
"Middlesex County, CT",CT,2014,92331,87058,5273,5.7,1154
"Middlesex County, CT",CT,2013,91177,84956,6221,6.8,-864
"Middlesex County, CT",CT,2012,92041,85447,6594,7.2,-1576
"Middlesex County, CT",CT,2011,93617,86316,7301,7.8,383
"Middlesex County, CT",CT,2010,93234,85502,7732,8.3,0
"Middlesex County, MA",MA,2021,906656,864759,41897,4.6,5678
"Middlesex County, MA",MA,2020,900978,831412,69566,7.7,-31682
"Middlesex County, MA",MA,2019,932660,909939,22721,2.4,8419
"Middlesex County, MA",MA,2018,924241,898422,25819,2.8,23160
"Middlesex County, MA",MA,2017,901081,872853,28228,3.1,27511
"Middlesex County, MA",MA,2016,873570,844884,28686,3.3,10096
"Middlesex County, MA",MA,2015,863474,829704,33770,3.9,7999
"Middlesex County, MA",MA,2014,855475,815591,39884,4.7,14747
"Middlesex County, MA",MA,2013,840728,795217,45511,5.4,3901
"Middlesex County, MA",MA,2012,836827,791299,45528,5.4,9196
"Middlesex County, MA",MA,2011,827631,778977,48654,5.9,1773
"Middlesex County, MA",MA,2010,825858,770355,55503,6.7,0
"Middlesex County, NJ",NJ,2021,453161,427204,25957,5.7,5689
"Middlesex County, NJ",NJ,2020,447472,409364,38108,8.5,-8815
"Middlesex County, NJ",NJ,2019,456287,442757,13530,3.0,5738
"Middlesex County, NJ",NJ,2018,450549,434819,15730,3.5,-1859
"Middlesex County, NJ",NJ,2017,452408,434331,18077,4.0,14669
"Middlesex County, NJ",NJ,2016,437739,418503,19236,4.4,1839
"Middlesex County, NJ",NJ,2015,435900,413742,22158,5.1,3703
"Middlesex County, NJ",NJ,2014,432197,405922,26275,6.1,2764
"Middlesex County, NJ",NJ,2013,429433,396365,33068,7.7,-205
"Middlesex County, NJ",NJ,2012,429638,392361,37277,8.7,3822
"Middlesex County, NJ",NJ,2011,425816,388452,37364,8.8,2193
"Middlesex County, NJ",NJ,2010,423623,385060,38563,9.1,0
"Middlesex County, VA",VA,2021,5085,4914,171,3.4,-69
"Middlesex County, VA",VA,2020,5154,4893,261,5.1,-175
"Middlesex County, VA",VA,2019,5329,5194,135,2.5,46
"Middlesex County, VA",VA,2018,5283,5142,141,2.7,-84
"Middlesex County, VA",VA,2017,5367,5194,173,3.2,332
"Middlesex County, VA",VA,2016,5035,4845,190,3.8,35
"Middlesex County, VA",VA,2015,5000,4791,209,4.2,-45
"Middlesex County, VA",VA,2014,5045,4795,250,5.0,-70
"Middlesex County, VA",VA,2013,5115,4839,276,5.4,-13
"Middlesex County, VA",VA,2012,5128,4823,305,5.9,-3
"Middlesex County, VA",VA,2011,5131,4799,332,6.5,-36
"Middlesex County, VA",VA,2010,5167,4787,380,7.4,0
"Midland County, MI",MI,2021,38276,36396,1880,4.9,-932
"Midland County, MI",MI,2020,39208,36115,3093,7.9,-973
"Midland County, MI",MI,2019,40181,38644,1537,3.8,-547
"Midland County, MI",MI,2018,40728,39099,1629,4.0,182
"Midland County, MI",MI,2017,40546,38697,1849,4.6,-590
"Midland County, MI",MI,2016,41136,39179,1957,4.8,-492
"Midland County, MI",MI,2015,41628,39575,2053,4.9,-79
"Midland County, MI",MI,2014,41707,39163,2544,6.1,765
"Midland County, MI",MI,2013,40942,37814,3128,7.6,104
"Midland County, MI",MI,2012,40838,37700,3138,7.7,17
"Midland County, MI",MI,2011,40821,37535,3286,8.0,-60
"Midland County, MI",MI,2010,40881,36989,3892,9.5,0
"Midland County, TX",TX,2021,99301,93631,5670,5.7,1453
"Midland County, TX",TX,2020,97848,89972,7876,8.0,-7601
"Midland County, TX",TX,2019,105449,103242,2207,2.1,3506
"Midland County, TX",TX,2018,101943,99757,2186,2.1,11870
"Midland County, TX",TX,2017,90073,87358,2715,3.0,4993
"Midland County, TX",TX,2016,85080,81326,3754,4.4,-3327
"Midland County, TX",TX,2015,88407,85325,3082,3.5,-2380
"Midland County, TX",TX,2014,90787,88143,2644,2.9,4913
"Midland County, TX",TX,2013,85874,82706,3168,3.7,3843
"Midland County, TX",TX,2012,82031,78867,3164,3.9,5469
"Midland County, TX",TX,2011,76562,72801,3761,4.9,5142
"Midland County, TX",TX,2010,71420,67219,4201,5.9,0
"Mifflin County, PA",PA,2021,20860,19593,1267,6.1,-471
"Mifflin County, PA",PA,2020,21331,19526,1805,8.5,53
"Mifflin County, PA",PA,2019,21278,20261,1017,4.8,274
"Mifflin County, PA",PA,2018,21004,19983,1021,4.9,136
"Mifflin County, PA",PA,2017,20868,19740,1128,5.4,32
"Mifflin County, PA",PA,2016,20836,19657,1179,5.7,-88
"Mifflin County, PA",PA,2015,20924,19693,1231,5.9,-152
"Mifflin County, PA",PA,2014,21076,19708,1368,6.5,-233
"Mifflin County, PA",PA,2013,21309,19625,1684,7.9,226
"Mifflin County, PA",PA,2012,21083,19296,1787,8.5,131
"Mifflin County, PA",PA,2011,20952,19122,1830,8.7,-234
"Mifflin County, PA",PA,2010,21186,19079,2107,9.9,0
"Milam County, TX",TX,2021,10199,9606,593,5.8,583
"Milam County, TX",TX,2020,9616,8926,690,7.2,-25
"Milam County, TX",TX,2019,9641,9160,481,5.0,-154
"Milam County, TX",TX,2018,9795,9252,543,5.5,-225
"Milam County, TX",TX,2017,10020,9511,509,5.1,-252
"Milam County, TX",TX,2016,10272,9742,530,5.2,146
"Milam County, TX",TX,2015,10126,9591,535,5.3,-90
"Milam County, TX",TX,2014,10216,9573,643,6.3,107
"Milam County, TX",TX,2013,10109,9311,798,7.9,-146
"Milam County, TX",TX,2012,10255,9380,875,8.5,-161
"Milam County, TX",TX,2011,10416,9321,1095,10.5,-145
"Milam County, TX",TX,2010,10561,9372,1189,11.3,0
"Millard County, UT",UT,2021,6018,5875,143,2.4,-11
"Millard County, UT",UT,2020,6029,5833,196,3.3,-45
"Millard County, UT",UT,2019,6074,5913,161,2.7,-181
"Millard County, UT",UT,2018,6255,6062,193,3.1,-206
"Millard County, UT",UT,2017,6461,6257,204,3.2,271
"Millard County, UT",UT,2016,6190,5990,200,3.2,96
"Millard County, UT",UT,2015,6094,5884,210,3.4,179
"Millard County, UT",UT,2014,5915,5718,197,3.3,93
"Millard County, UT",UT,2013,5822,5603,219,3.8,-15
"Millard County, UT",UT,2012,5837,5596,241,4.1,-287
"Millard County, UT",UT,2011,6124,5784,340,5.6,-268
"Millard County, UT",UT,2010,6392,5989,403,6.3,0
"Mille Lacs County, MN",MN,2021,12462,11820,642,5.2,-507
"Mille Lacs County, MN",MN,2020,12969,11833,1136,8.8,-170
"Mille Lacs County, MN",MN,2019,13139,12385,754,5.7,231
"Mille Lacs County, MN",MN,2018,12908,12244,664,5.1,119
"Mille Lacs County, MN",MN,2017,12789,12071,718,5.6,72
"Mille Lacs County, MN",MN,2016,12717,11958,759,6.0,67
"Mille Lacs County, MN",MN,2015,12650,11901,749,5.9,-69
"Mille Lacs County, MN",MN,2014,12719,11846,873,6.9,24
"Mille Lacs County, MN",MN,2013,12695,11730,965,7.6,-14
"Mille Lacs County, MN",MN,2012,12709,11643,1066,8.4,-246
"Mille Lacs County, MN",MN,2011,12955,11705,1250,9.6,-210
"Mille Lacs County, MN",MN,2010,13165,11701,1464,11.1,0
"Miller County, AR",AR,2021,18987,18074,913,4.8,-356
"Miller County, AR",AR,2020,19343,18003,1340,6.9,-408
"Miller County, AR",AR,2019,19751,18959,792,4.0,240
"Miller County, AR",AR,2018,19511,18583,928,4.8,-247
"Miller County, AR",AR,2017,19758,18894,864,4.4,-146
"Miller County, AR",AR,2016,19904,19067,837,4.2,-89
"Miller County, AR",AR,2015,19993,19007,986,4.9,471
"Miller County, AR",AR,2014,19522,18411,1111,5.7,-151
"Miller County, AR",AR,2013,19673,18441,1232,6.3,-685
"Miller County, AR",AR,2012,20358,19195,1163,5.7,-365
"Miller County, AR",AR,2011,20723,19468,1255,6.1,169
"Miller County, AR",AR,2010,20554,19406,1148,5.6,0
"Miller County, GA",GA,2021,2782,2698,84,3.0,12
"Miller County, GA",GA,2020,2770,2660,110,4.0,-37
"Miller County, GA",GA,2019,2807,2712,95,3.4,30
"Miller County, GA",GA,2018,2777,2674,103,3.7,-72
"Miller County, GA",GA,2017,2849,2721,128,4.5,96
"Miller County, GA",GA,2016,2753,2602,151,5.5,114
"Miller County, GA",GA,2015,2639,2494,145,5.5,-30
"Miller County, GA",GA,2014,2669,2500,169,6.3,18
"Miller County, GA",GA,2013,2651,2460,191,7.2,-40
"Miller County, GA",GA,2012,2691,2474,217,8.1,-44
"Miller County, GA",GA,2011,2735,2484,251,9.2,-76
"Miller County, GA",GA,2010,2811,2515,296,10.5,0
"Miller County, MO",MO,2021,12593,12076,517,4.1,325
"Miller County, MO",MO,2020,12268,11528,740,6.0,61
"Miller County, MO",MO,2019,12207,11772,435,3.6,102
"Miller County, MO",MO,2018,12105,11670,435,3.6,100
"Miller County, MO",MO,2017,12005,11475,530,4.4,134
"Miller County, MO",MO,2016,11871,11257,614,5.2,287
"Miller County, MO",MO,2015,11584,10873,711,6.1,-20
"Miller County, MO",MO,2014,11604,10704,900,7.8,138
"Miller County, MO",MO,2013,11466,10454,1012,8.8,164
"Miller County, MO",MO,2012,11302,10249,1053,9.3,-31
"Miller County, MO",MO,2011,11333,10010,1323,11.7,-471
"Miller County, MO",MO,2010,11804,10295,1509,12.8,0
"Mills County, IA",IA,2021,6992,6749,243,3.5,-21
"Mills County, IA",IA,2020,7013,6738,275,3.9,-512
"Mills County, IA",IA,2019,7525,7358,167,2.2,151
"Mills County, IA",IA,2018,7374,7220,154,2.1,-8
"Mills County, IA",IA,2017,7382,7182,200,2.7,-63
"Mills County, IA",IA,2016,7445,7176,269,3.6,20
"Mills County, IA",IA,2015,7425,7125,300,4.0,27
"Mills County, IA",IA,2014,7398,7075,323,4.4,62
"Mills County, IA",IA,2013,7336,7014,322,4.4,42
"Mills County, IA",IA,2012,7294,6957,337,4.6,-184
"Mills County, IA",IA,2011,7478,7102,376,5.0,-111
"Mills County, IA",IA,2010,7589,7184,405,5.3,0
"Mills County, TX",TX,2021,1905,1822,83,4.4,40
"Mills County, TX",TX,2020,1865,1789,76,4.1,-2
"Mills County, TX",TX,2019,1867,1806,61,3.3,16
"Mills County, TX",TX,2018,1851,1786,65,3.5,-47
"Mills County, TX",TX,2017,1898,1830,68,3.6,-27
"Mills County, TX",TX,2016,1925,1845,80,4.2,-66
"Mills County, TX",TX,2015,1991,1917,74,3.7,-54
"Mills County, TX",TX,2014,2045,1955,90,4.4,-22
"Mills County, TX",TX,2013,2067,1957,110,5.3,-29
"Mills County, TX",TX,2012,2096,1983,113,5.4,-74
"Mills County, TX",TX,2011,2170,2029,141,6.5,-23
"Mills County, TX",TX,2010,2193,2053,140,6.4,0
"Milwaukee County, WI",WI,2021,469201,443758,25443,5.4,291
"Milwaukee County, WI",WI,2020,468910,429967,38943,8.3,1356
"Milwaukee County, WI",WI,2019,467554,449725,17829,3.8,-2654
"Milwaukee County, WI",WI,2018,470208,453165,17043,3.6,-6205
"Milwaukee County, WI",WI,2017,476413,457332,19081,4.0,1093
"Milwaukee County, WI",WI,2016,475320,452193,23127,4.9,-415
"Milwaukee County, WI",WI,2015,475735,448993,26742,5.6,-2266
"Milwaukee County, WI",WI,2014,478001,445584,32417,6.8,-783
"Milwaukee County, WI",WI,2013,478784,438862,39922,8.3,3026
"Milwaukee County, WI",WI,2012,475758,435411,40347,8.5,-543
"Milwaukee County, WI",WI,2011,476301,433145,43156,9.1,-298
"Milwaukee County, WI",WI,2010,476599,429808,46791,9.8,0
"Miner County, SD",SD,2021,1167,1131,36,3.1,26
"Miner County, SD",SD,2020,1141,1090,51,4.5,-27
"Miner County, SD",SD,2019,1168,1137,31,2.7,-21
"Miner County, SD",SD,2018,1189,1159,30,2.5,-5
"Miner County, SD",SD,2017,1194,1161,33,2.8,-12
"Miner County, SD",SD,2016,1206,1174,32,2.7,-14
"Miner County, SD",SD,2015,1220,1191,29,2.4,-29
"Miner County, SD",SD,2014,1249,1210,39,3.1,6
"Miner County, SD",SD,2013,1243,1199,44,3.5,-29
"Miner County, SD",SD,2012,1272,1229,43,3.4,-35
"Miner County, SD",SD,2011,1307,1251,56,4.3,-72
"Miner County, SD",SD,2010,1379,1310,69,5.0,0
"Mineral County, CO",CO,2021,463,440,23,5.0,-1
"Mineral County, CO",CO,2020,464,438,26,5.6,-52
"Mineral County, CO",CO,2019,516,504,12,2.3,9
"Mineral County, CO",CO,2018,507,494,13,2.6,46
"Mineral County, CO",CO,2017,461,453,8,1.7,-3
"Mineral County, CO",CO,2016,464,454,10,2.2,20
"Mineral County, CO",CO,2015,444,429,15,3.4,20
"Mineral County, CO",CO,2014,424,403,21,5.0,-1
"Mineral County, CO",CO,2013,425,400,25,5.9,-18
"Mineral County, CO",CO,2012,443,419,24,5.4,18
"Mineral County, CO",CO,2011,425,401,24,5.6,11
"Mineral County, CO",CO,2010,414,384,30,7.2,0
"Mineral County, MT",MT,2021,1871,1772,99,5.3,83
"Mineral County, MT",MT,2020,1788,1609,179,10.0,-4
"Mineral County, MT",MT,2019,1792,1688,104,5.8,58
"Mineral County, MT",MT,2018,1734,1609,125,7.2,36
"Mineral County, MT",MT,2017,1698,1569,129,7.6,10
"Mineral County, MT",MT,2016,1688,1556,132,7.8,-43
"Mineral County, MT",MT,2015,1731,1582,149,8.6,-16
"Mineral County, MT",MT,2014,1747,1588,159,9.1,-34
"Mineral County, MT",MT,2013,1781,1597,184,10.3,15
"Mineral County, MT",MT,2012,1766,1578,188,10.6,-20
"Mineral County, MT",MT,2011,1786,1578,208,11.6,-6
"Mineral County, MT",MT,2010,1792,1569,223,12.4,0
"Mineral County, NV",NV,2021,2078,1999,79,3.8,-29
"Mineral County, NV",NV,2020,2107,1985,122,5.8,20
"Mineral County, NV",NV,2019,2087,2004,83,4.0,131
"Mineral County, NV",NV,2018,1956,1856,100,5.1,-7
"Mineral County, NV",NV,2017,1963,1856,107,5.5,-31
"Mineral County, NV",NV,2016,1994,1866,128,6.4,381
"Mineral County, NV",NV,2015,1613,1448,165,10.2,-85
"Mineral County, NV",NV,2014,1698,1508,190,11.2,-131
"Mineral County, NV",NV,2013,1829,1592,237,13.0,-64
"Mineral County, NV",NV,2012,1893,1627,266,14.1,-281
"Mineral County, NV",NV,2011,2174,1860,314,14.4,-32
"Mineral County, NV",NV,2010,2206,1866,340,15.4,0
"Mineral County, WV",WV,2021,12215,11645,570,4.7,144
"Mineral County, WV",WV,2020,12071,11178,893,7.4,-558
"Mineral County, WV",WV,2019,12629,11904,725,5.7,217
"Mineral County, WV",WV,2018,12412,11738,674,5.4,127
"Mineral County, WV",WV,2017,12285,11636,649,5.3,338
"Mineral County, WV",WV,2016,11947,11235,712,6.0,190
"Mineral County, WV",WV,2015,11757,10915,842,7.2,-142
"Mineral County, WV",WV,2014,11899,10970,929,7.8,-9
"Mineral County, WV",WV,2013,11908,10984,924,7.8,-185
"Mineral County, WV",WV,2012,12093,11104,989,8.2,-85
"Mineral County, WV",WV,2011,12178,11126,1052,8.6,-171
"Mineral County, WV",WV,2010,12349,11192,1157,9.4,0
"Mingo County, WV",WV,2021,6220,5663,557,9.0,-502
"Mingo County, WV",WV,2020,6722,5779,943,14.0,-179
"Mingo County, WV",WV,2019,6901,6432,469,6.8,-8
"Mingo County, WV",WV,2018,6909,6392,517,7.5,110
"Mingo County, WV",WV,2017,6799,6212,587,8.6,48
"Mingo County, WV",WV,2016,6751,5899,852,12.6,-552
"Mingo County, WV",WV,2015,7303,6362,941,12.9,-472
"Mingo County, WV",WV,2014,7775,6859,916,11.8,-712
"Mingo County, WV",WV,2013,8487,7547,940,11.1,-496
"Mingo County, WV",WV,2012,8983,8139,844,9.4,-212
"Mingo County, WV",WV,2011,9195,8426,769,8.4,38
"Mingo County, WV",WV,2010,9157,8255,902,9.9,0
"Minidoka County, ID",ID,2021,11852,11480,372,3.1,166
"Minidoka County, ID",ID,2020,11686,11226,460,3.9,187
"Minidoka County, ID",ID,2019,11499,11205,294,2.6,398
"Minidoka County, ID",ID,2018,11101,10819,282,2.5,34
"Minidoka County, ID",ID,2017,11067,10769,298,2.7,196
"Minidoka County, ID",ID,2016,10871,10535,336,3.1,173
"Minidoka County, ID",ID,2015,10698,10333,365,3.4,331
"Minidoka County, ID",ID,2014,10367,9938,429,4.1,-99
"Minidoka County, ID",ID,2013,10466,9821,645,6.2,50
"Minidoka County, ID",ID,2012,10416,9769,647,6.2,-133
"Minidoka County, ID",ID,2011,10549,9834,715,6.8,71
"Minidoka County, ID",ID,2010,10478,9725,753,7.2,0
"Minnehaha County, SD",SD,2021,114373,111108,3265,2.9,1662
"Minnehaha County, SD",SD,2020,112711,107919,4792,4.3,895
"Minnehaha County, SD",SD,2019,111816,109061,2755,2.5,1588
"Minnehaha County, SD",SD,2018,110228,107551,2677,2.4,1101
"Minnehaha County, SD",SD,2017,109127,106265,2862,2.6,878
"Minnehaha County, SD",SD,2016,108249,105446,2803,2.6,1264
"Minnehaha County, SD",SD,2015,106985,104148,2837,2.7,1637
"Minnehaha County, SD",SD,2014,105348,102263,3085,2.9,1882
"Minnehaha County, SD",SD,2013,103466,100107,3359,3.2,1492
"Minnehaha County, SD",SD,2012,101974,98148,3826,3.8,1495
"Minnehaha County, SD",SD,2011,100479,96100,4379,4.4,793
"Minnehaha County, SD",SD,2010,99686,94792,4894,4.9,0
"Missaukee County, MI",MI,2021,6800,6421,379,5.6,-98
"Missaukee County, MI",MI,2020,6898,6241,657,9.5,-40
"Missaukee County, MI",MI,2019,6938,6600,338,4.9,56
"Missaukee County, MI",MI,2018,6882,6527,355,5.2,-38
"Missaukee County, MI",MI,2017,6920,6521,399,5.8,-125
"Missaukee County, MI",MI,2016,7045,6622,423,6.0,24
"Missaukee County, MI",MI,2015,7021,6557,464,6.6,-57
"Missaukee County, MI",MI,2014,7078,6528,550,7.8,114
"Missaukee County, MI",MI,2013,6964,6327,637,9.1,27
"Missaukee County, MI",MI,2012,6937,6275,662,9.5,-81
"Missaukee County, MI",MI,2011,7018,6286,732,10.4,-58
"Missaukee County, MI",MI,2010,7076,6206,870,12.3,0
"Mississippi County, AR",AR,2021,16310,15141,1169,7.2,-959
"Mississippi County, AR",AR,2020,17269,15704,1565,9.1,-115
"Mississippi County, AR",AR,2019,17384,16518,866,5.0,48
"Mississippi County, AR",AR,2018,17336,16369,967,5.6,-446
"Mississippi County, AR",AR,2017,17782,16718,1064,6.0,-317
"Mississippi County, AR",AR,2016,18099,16869,1230,6.8,-313
"Mississippi County, AR",AR,2015,18412,16774,1638,8.9,-793
"Mississippi County, AR",AR,2014,19205,17473,1732,9.0,117
"Mississippi County, AR",AR,2013,19088,16978,2110,11.1,-1231
"Mississippi County, AR",AR,2012,20319,18179,2140,10.5,-533
"Mississippi County, AR",AR,2011,20852,18453,2399,11.5,483
"Mississippi County, AR",AR,2010,20369,17940,2429,11.9,0
"Mississippi County, MO",MO,2021,5440,5186,254,4.7,-189
"Mississippi County, MO",MO,2020,5629,5329,300,5.3,-89
"Mississippi County, MO",MO,2019,5718,5498,220,3.8,-212
"Mississippi County, MO",MO,2018,5930,5708,222,3.7,-115
"Mississippi County, MO",MO,2017,6045,5743,302,5.0,-163
"Mississippi County, MO",MO,2016,6208,5797,411,6.6,-38
"Mississippi County, MO",MO,2015,6246,5877,369,5.9,2
"Mississippi County, MO",MO,2014,6244,5788,456,7.3,-41
"Mississippi County, MO",MO,2013,6285,5790,495,7.9,171
"Mississippi County, MO",MO,2012,6114,5614,500,8.2,70
"Mississippi County, MO",MO,2011,6044,5451,593,9.8,-37
"Mississippi County, MO",MO,2010,6081,5498,583,9.6,0
"Missoula County, MT",MT,2021,65104,62920,2184,3.4,579
"Missoula County, MT",MT,2020,64525,60562,3963,6.1,-326
"Missoula County, MT",MT,2019,64851,62715,2136,3.3,1114
"Missoula County, MT",MT,2018,63737,61603,2134,3.3,1003
"Missoula County, MT",MT,2017,62734,60431,2303,3.7,1373
"Missoula County, MT",MT,2016,61361,58972,2389,3.9,819
"Missoula County, MT",MT,2015,60542,58102,2440,4.0,572
"Missoula County, MT",MT,2014,59970,57311,2659,4.4,523
"Missoula County, MT",MT,2013,59447,56397,3050,5.1,309
"Missoula County, MT",MT,2012,59138,55772,3366,5.7,362
"Missoula County, MT",MT,2011,58776,54980,3796,6.5,210
"Missoula County, MT",MT,2010,58566,54339,4227,7.2,0
"Mitchell County, GA",GA,2021,8228,7813,415,5.0,-59
"Mitchell County, GA",GA,2020,8287,7746,541,6.5,-213
"Mitchell County, GA",GA,2019,8500,8100,400,4.7,107
"Mitchell County, GA",GA,2018,8393,7934,459,5.5,-188
"Mitchell County, GA",GA,2017,8581,8040,541,6.3,12
"Mitchell County, GA",GA,2016,8569,7999,570,6.7,-50
"Mitchell County, GA",GA,2015,8619,8029,590,6.8,-132
"Mitchell County, GA",GA,2014,8751,8061,690,7.9,-254
"Mitchell County, GA",GA,2013,9005,8236,769,8.5,-576
"Mitchell County, GA",GA,2012,9581,8743,838,8.7,79
"Mitchell County, GA",GA,2011,9502,8559,943,9.9,-171
"Mitchell County, GA",GA,2010,9673,8613,1060,11.0,0
"Mitchell County, IA",IA,2021,5812,5636,176,3.0,-286
"Mitchell County, IA",IA,2020,6098,5896,202,3.3,-790
"Mitchell County, IA",IA,2019,6888,6775,113,1.6,883
"Mitchell County, IA",IA,2018,6005,5898,107,1.8,177
"Mitchell County, IA",IA,2017,5828,5706,122,2.1,-83
"Mitchell County, IA",IA,2016,5911,5757,154,2.6,315
"Mitchell County, IA",IA,2015,5596,5440,156,2.8,135
"Mitchell County, IA",IA,2014,5461,5267,194,3.6,-54
"Mitchell County, IA",IA,2013,5515,5278,237,4.3,-60
"Mitchell County, IA",IA,2012,5575,5320,255,4.6,-101
"Mitchell County, IA",IA,2011,5676,5402,274,4.8,-42
"Mitchell County, IA",IA,2010,5718,5417,301,5.3,0
"Mitchell County, KS",KS,2021,3434,3367,67,2.0,8
"Mitchell County, KS",KS,2020,3426,3339,87,2.5,43
"Mitchell County, KS",KS,2019,3383,3305,78,2.3,-81
"Mitchell County, KS",KS,2018,3464,3389,75,2.2,5
"Mitchell County, KS",KS,2017,3459,3365,94,2.7,-253
"Mitchell County, KS",KS,2016,3712,3590,122,3.3,-73
"Mitchell County, KS",KS,2015,3785,3660,125,3.3,-55
"Mitchell County, KS",KS,2014,3840,3716,124,3.2,-45
"Mitchell County, KS",KS,2013,3885,3772,113,2.9,2
"Mitchell County, KS",KS,2012,3883,3767,116,3.0,-30
"Mitchell County, KS",KS,2011,3913,3774,139,3.6,38
"Mitchell County, KS",KS,2010,3875,3692,183,4.7,0
"Mitchell County, NC",NC,2021,5928,5623,305,5.1,184
"Mitchell County, NC",NC,2020,5744,5311,433,7.5,-269
"Mitchell County, NC",NC,2019,6013,5743,270,4.5,71
"Mitchell County, NC",NC,2018,5942,5672,270,4.5,-69
"Mitchell County, NC",NC,2017,6011,5698,313,5.2,-158
"Mitchell County, NC",NC,2016,6169,5791,378,6.1,-134
"Mitchell County, NC",NC,2015,6303,5877,426,6.8,-230
"Mitchell County, NC",NC,2014,6533,6042,491,7.5,-146
"Mitchell County, NC",NC,2013,6679,5961,718,10.8,-32
"Mitchell County, NC",NC,2012,6711,5871,840,12.5,-63
"Mitchell County, NC",NC,2011,6774,5970,804,11.9,-57
"Mitchell County, NC",NC,2010,6831,5993,838,12.3,0
"Mitchell County, TX",TX,2021,2346,2179,167,7.1,20
"Mitchell County, TX",TX,2020,2326,2142,184,7.9,18
"Mitchell County, TX",TX,2019,2308,2222,86,3.7,4
"Mitchell County, TX",TX,2018,2304,2207,97,4.2,-175
"Mitchell County, TX",TX,2017,2479,2343,136,5.5,-131
"Mitchell County, TX",TX,2016,2610,2427,183,7.0,-136
"Mitchell County, TX",TX,2015,2746,2590,156,5.7,-154
"Mitchell County, TX",TX,2014,2900,2775,125,4.3,27
"Mitchell County, TX",TX,2013,2873,2713,160,5.6,3
"Mitchell County, TX",TX,2012,2870,2700,170,5.9,-71
"Mitchell County, TX",TX,2011,2941,2713,228,7.8,-35
"Mitchell County, TX",TX,2010,2976,2729,247,8.3,0
"Mobile County, AL",AL,2021,191711,182672,9039,4.7,-3378
"Mobile County, AL",AL,2020,195089,178158,16931,8.7,3367
"Mobile County, AL",AL,2019,191722,184234,7488,3.9,672
"Mobile County, AL",AL,2018,191050,182174,8876,4.6,2033
"Mobile County, AL",AL,2017,189017,178966,10051,5.3,2787
"Mobile County, AL",AL,2016,186230,173856,12374,6.6,-253
"Mobile County, AL",AL,2015,186483,173586,12897,6.9,843
"Mobile County, AL",AL,2014,185640,171332,14308,7.7,-1292
"Mobile County, AL",AL,2013,186932,170729,16203,8.7,-1958
"Mobile County, AL",AL,2012,188890,171102,17788,9.4,-4955
"Mobile County, AL",AL,2011,193845,173055,20790,10.7,1045
"Mobile County, AL",AL,2010,192800,171314,21486,11.1,0
"Moca Municipio, PR",PR,2021,11323,10258,1065,9.4,
"Moca Municipio, PR",PR,2020,N.A.,N.A.,N.A.,N.A.,
"Moca Municipio, PR",PR,2019,10498,9401,1097,10.4,-18
"Moca Municipio, PR",PR,2018,10516,9280,1236,11.8,-191
"Moca Municipio, PR",PR,2017,10707,9133,1574,14.7,-38
"Moca Municipio, PR",PR,2016,10745,9073,1672,15.6,104
"Moca Municipio, PR",PR,2015,10641,8981,1660,15.6,-121
"Moca Municipio, PR",PR,2014,10762,8778,1984,18.4,-370
"Moca Municipio, PR",PR,2013,11132,8933,2199,19.8,-270
"Moca Municipio, PR",PR,2012,11402,9200,2202,19.3,-284
"Moca Municipio, PR",PR,2011,11686,9294,2392,20.5,-365
"Moca Municipio, PR",PR,2010,12051,9598,2453,20.4,0
"Modoc County, CA",CA,2021,3187,2962,225,7.1,13
"Modoc County, CA",CA,2020,3174,2893,281,8.9,-5
"Modoc County, CA",CA,2019,3179,2950,229,7.2,23
"Modoc County, CA",CA,2018,3156,2915,241,7.6,-37
"Modoc County, CA",CA,2017,3193,2932,261,8.2,-99
"Modoc County, CA",CA,2016,3292,3034,258,7.8,-11
"Modoc County, CA",CA,2015,3303,3019,284,8.6,-58
"Modoc County, CA",CA,2014,3361,3012,349,10.4,-131
"Modoc County, CA",CA,2013,3492,3058,434,12.4,-115
"Modoc County, CA",CA,2012,3607,3080,527,14.6,-10
"Modoc County, CA",CA,2011,3617,3030,587,16.2,-204
"Modoc County, CA",CA,2010,3821,3228,593,15.5,0
"Moffat County, CO",CO,2021,7286,6939,347,4.8,124
"Moffat County, CO",CO,2020,7162,6749,413,5.8,-174
"Moffat County, CO",CO,2019,7336,7100,236,3.2,-21
"Moffat County, CO",CO,2018,7357,7109,248,3.4,97
"Moffat County, CO",CO,2017,7260,7036,224,3.1,80
"Moffat County, CO",CO,2016,7180,6908,272,3.8,76
"Moffat County, CO",CO,2015,7104,6793,311,4.4,-199
"Moffat County, CO",CO,2014,7303,6884,419,5.7,-229
"Moffat County, CO",CO,2013,7532,7019,513,6.8,-191
"Moffat County, CO",CO,2012,7723,7076,647,8.4,-128
"Moffat County, CO",CO,2011,7851,7091,760,9.7,-212
"Moffat County, CO",CO,2010,8063,7220,843,10.5,0
"Mohave County, AZ",AZ,2021,87215,82382,4833,5.5,1285
"Mohave County, AZ",AZ,2020,85930,77556,8374,9.7,1348
"Mohave County, AZ",AZ,2019,84582,79636,4946,5.8,1989
"Mohave County, AZ",AZ,2018,82593,77910,4683,5.7,2247
"Mohave County, AZ",AZ,2017,80346,75565,4781,6.0,-497
"Mohave County, AZ",AZ,2016,80843,75410,5433,6.7,839
"Mohave County, AZ",AZ,2015,80004,73633,6371,8.0,1169
"Mohave County, AZ",AZ,2014,78835,71947,6888,8.7,1087
"Mohave County, AZ",AZ,2013,77748,69643,8105,10.4,-479
"Mohave County, AZ",AZ,2012,78227,69600,8627,11.0,-1742
"Mohave County, AZ",AZ,2011,79969,70211,9758,12.2,-2911
"Mohave County, AZ",AZ,2010,82880,72206,10674,12.9,0
"Moniteau County, MO",MO,2021,7049,6810,239,3.4,-51
"Moniteau County, MO",MO,2020,7100,6796,304,4.3,-210
"Moniteau County, MO",MO,2019,7310,7107,203,2.8,38
"Moniteau County, MO",MO,2018,7272,7059,213,2.9,-81
"Moniteau County, MO",MO,2017,7353,7088,265,3.6,-110
"Moniteau County, MO",MO,2016,7463,7140,323,4.3,109
"Moniteau County, MO",MO,2015,7354,6987,367,5.0,-2
"Moniteau County, MO",MO,2014,7356,6914,442,6.0,60
"Moniteau County, MO",MO,2013,7296,6828,468,6.4,23
"Moniteau County, MO",MO,2012,7273,6777,496,6.8,-64
"Moniteau County, MO",MO,2011,7337,6764,573,7.8,-29
"Moniteau County, MO",MO,2010,7366,6749,617,8.4,0
"Monmouth County, NJ",NJ,2021,340535,321712,18823,5.5,3627
"Monmouth County, NJ",NJ,2020,336908,308005,28903,8.6,-5072
"Monmouth County, NJ",NJ,2019,341980,331651,10329,3.0,4842
"Monmouth County, NJ",NJ,2018,337138,325256,11882,3.5,966
"Monmouth County, NJ",NJ,2017,336172,322602,13570,4.0,8531
"Monmouth County, NJ",NJ,2016,327641,313165,14476,4.4,1274
"Monmouth County, NJ",NJ,2015,326367,309683,16684,5.1,678
"Monmouth County, NJ",NJ,2014,325689,305977,19712,6.1,-1066
"Monmouth County, NJ",NJ,2013,326755,301616,25139,7.7,-3299
"Monmouth County, NJ",NJ,2012,330054,301087,28967,8.8,1049
"Monmouth County, NJ",NJ,2011,329005,300711,28294,8.6,-765
"Monmouth County, NJ",NJ,2010,329770,300440,29330,8.9,0
"Mono County, CA",CA,2021,8340,7771,569,6.8,465
"Mono County, CA",CA,2020,7875,6917,958,12.2,-644
"Mono County, CA",CA,2019,8519,8198,321,3.8,95
"Mono County, CA",CA,2018,8424,8081,343,4.1,-61
"Mono County, CA",CA,2017,8485,8106,379,4.5,120
"Mono County, CA",CA,2016,8365,7915,450,5.4,126
"Mono County, CA",CA,2015,8239,7731,508,6.2,15
"Mono County, CA",CA,2014,8224,7637,587,7.1,-114
"Mono County, CA",CA,2013,8338,7619,719,8.6,-45
"Mono County, CA",CA,2012,8383,7502,881,10.5,-431
"Mono County, CA",CA,2011,8814,7913,901,10.2,-76
"Mono County, CA",CA,2010,8890,7963,927,10.4,0
"Monona County, IA",IA,2021,4416,4222,194,4.4,15
"Monona County, IA",IA,2020,4401,4197,204,4.6,-130
"Monona County, IA",IA,2019,4531,4404,127,2.8,14
"Monona County, IA",IA,2018,4517,4393,124,2.7,-41
"Monona County, IA",IA,2017,4558,4395,163,3.6,-192
"Monona County, IA",IA,2016,4750,4558,192,4.0,-12
"Monona County, IA",IA,2015,4762,4555,207,4.3,6
"Monona County, IA",IA,2014,4756,4520,236,5.0,126
"Monona County, IA",IA,2013,4630,4365,265,5.7,77
"Monona County, IA",IA,2012,4553,4261,292,6.4,-243
"Monona County, IA",IA,2011,4796,4458,338,7.0,-81
"Monona County, IA",IA,2010,4877,4519,358,7.3,0
"Monongalia County, WV",WV,2021,55827,53636,2191,3.9,1605
"Monongalia County, WV",WV,2020,54222,50857,3365,6.2,-566
"Monongalia County, WV",WV,2019,54788,52791,1997,3.6,560
"Monongalia County, WV",WV,2018,54228,52038,2190,4.0,1057
"Monongalia County, WV",WV,2017,53171,51190,1981,3.7,1719
"Monongalia County, WV",WV,2016,51452,49222,2230,4.3,368
"Monongalia County, WV",WV,2015,51084,48736,2348,4.6,282
"Monongalia County, WV",WV,2014,50802,48594,2208,4.3,704
"Monongalia County, WV",WV,2013,50098,47855,2243,4.5,352
"Monongalia County, WV",WV,2012,49746,47253,2493,5.0,1187
"Monongalia County, WV",WV,2011,48559,45935,2624,5.4,273
"Monongalia County, WV",WV,2010,48286,45590,2696,5.6,0
"Monroe County, AL",AL,2021,7356,6942,414,5.6,-270
"Monroe County, AL",AL,2020,7626,6943,683,9.0,186
"Monroe County, AL",AL,2019,7440,7064,376,5.1,175
"Monroe County, AL",AL,2018,7265,6823,442,6.1,-37
"Monroe County, AL",AL,2017,7302,6800,502,6.9,47
"Monroe County, AL",AL,2016,7255,6596,659,9.1,-69
"Monroe County, AL",AL,2015,7324,6583,741,10.1,-301
"Monroe County, AL",AL,2014,7625,6787,838,11.0,-139
"Monroe County, AL",AL,2013,7764,6829,935,12.0,-224
"Monroe County, AL",AL,2012,7988,6963,1025,12.8,-324
"Monroe County, AL",AL,2011,8312,7020,1292,15.5,-382
"Monroe County, AL",AL,2010,8694,7147,1547,17.8,0
"Monroe County, AR",AR,2021,2621,2482,139,5.3,-101
"Monroe County, AR",AR,2020,2722,2541,181,6.6,-33
"Monroe County, AR",AR,2019,2755,2640,115,4.2,14
"Monroe County, AR",AR,2018,2741,2626,115,4.2,-57
"Monroe County, AR",AR,2017,2798,2678,120,4.3,-88
"Monroe County, AR",AR,2016,2886,2747,139,4.8,-100
"Monroe County, AR",AR,2015,2986,2808,178,6.0,-130
"Monroe County, AR",AR,2014,3116,2911,205,6.6,-25
"Monroe County, AR",AR,2013,3141,2873,268,8.5,-143
"Monroe County, AR",AR,2012,3284,3000,284,8.6,-97
"Monroe County, AR",AR,2011,3381,3075,306,9.1,-29
"Monroe County, AR",AR,2010,3410,3107,303,8.9,0
"Monroe County, FL",FL,2021,45926,44558,1368,3.0,1482
"Monroe County, FL",FL,2020,44444,40725,3719,8.4,-1727
"Monroe County, FL",FL,2019,46171,45205,966,2.1,1408
"Monroe County, FL",FL,2018,44763,43582,1181,2.6,-548
"Monroe County, FL",FL,2017,45311,43809,1502,3.3,-1281
"Monroe County, FL",FL,2016,46592,45095,1497,3.2,644
"Monroe County, FL",FL,2015,45948,44332,1616,3.5,1007
"Monroe County, FL",FL,2014,44941,43038,1903,4.2,788
"Monroe County, FL",FL,2013,44153,41922,2231,5.1,550
"Monroe County, FL",FL,2012,43603,41044,2559,5.9,1068
"Monroe County, FL",FL,2011,42535,39566,2969,7.0,673
"Monroe County, FL",FL,2010,41862,38716,3146,7.5,0
"Monroe County, GA",GA,2021,13124,12714,410,3.1,225
"Monroe County, GA",GA,2020,12899,12254,645,5.0,-140
"Monroe County, GA",GA,2019,13039,12596,443,3.4,-186
"Monroe County, GA",GA,2018,13225,12736,489,3.7,-9
"Monroe County, GA",GA,2017,13234,12638,596,4.5,216
"Monroe County, GA",GA,2016,13018,12336,682,5.2,492
"Monroe County, GA",GA,2015,12526,11784,742,5.9,-184
"Monroe County, GA",GA,2014,12710,11855,855,6.7,-41
"Monroe County, GA",GA,2013,12751,11733,1018,8.0,-28
"Monroe County, GA",GA,2012,12779,11689,1090,8.5,61
"Monroe County, GA",GA,2011,12718,11490,1228,9.7,131
"Monroe County, GA",GA,2010,12587,11287,1300,10.3,0
"Monroe County, IA",IA,2021,3946,3784,162,4.1,-29
"Monroe County, IA",IA,2020,3975,3774,201,5.1,-125
"Monroe County, IA",IA,2019,4100,3982,118,2.9,144
"Monroe County, IA",IA,2018,3956,3840,116,2.9,26
"Monroe County, IA",IA,2017,3930,3783,147,3.7,-48
"Monroe County, IA",IA,2016,3978,3796,182,4.6,-60
"Monroe County, IA",IA,2015,4038,3860,178,4.4,-38
"Monroe County, IA",IA,2014,4076,3870,206,5.1,44
"Monroe County, IA",IA,2013,4032,3801,231,5.7,36
"Monroe County, IA",IA,2012,3996,3764,232,5.8,-56
"Monroe County, IA",IA,2011,4052,3775,277,6.8,-35
"Monroe County, IA",IA,2010,4087,3787,300,7.3,0
"Monroe County, IL",IL,2021,18465,17886,579,3.1,94
"Monroe County, IL",IL,2020,18371,17334,1037,5.6,-809
"Monroe County, IL",IL,2019,19180,18619,561,2.9,371
"Monroe County, IL",IL,2018,18809,18168,641,3.4,303
"Monroe County, IL",IL,2017,18506,17877,629,3.4,-59
"Monroe County, IL",IL,2016,18565,17810,755,4.1,437
"Monroe County, IL",IL,2015,18128,17333,795,4.4,255
"Monroe County, IL",IL,2014,17873,16906,967,5.4,158
"Monroe County, IL",IL,2013,17715,16536,1179,6.7,-140
"Monroe County, IL",IL,2012,17855,16650,1205,6.7,-256
"Monroe County, IL",IL,2011,18111,16892,1219,6.7,141
"Monroe County, IL",IL,2010,17970,16647,1323,7.4,0
"Monroe County, IN",IN,2021,69181,67166,2015,2.9,1264
"Monroe County, IN",IN,2020,67917,64099,3818,5.6,-2688
"Monroe County, IN",IN,2019,70605,68277,2328,3.3,965
"Monroe County, IN",IN,2018,69640,67160,2480,3.6,1144
"Monroe County, IN",IN,2017,68496,66031,2465,3.6,443
"Monroe County, IN",IN,2016,68053,64931,3122,4.6,692
"Monroe County, IN",IN,2015,67361,64069,3292,4.9,-167
"Monroe County, IN",IN,2014,67528,63675,3853,5.7,749
"Monroe County, IN",IN,2013,66779,62293,4486,6.7,-44
"Monroe County, IN",IN,2012,66823,62036,4787,7.2,-915
"Monroe County, IN",IN,2011,67738,62739,4999,7.4,-66
"Monroe County, IN",IN,2010,67804,62576,5228,7.7,0
"Monroe County, KY",KY,2021,4637,4452,185,4.0,79
"Monroe County, KY",KY,2020,4558,4321,237,5.2,-113
"Monroe County, KY",KY,2019,4671,4497,174,3.7,-24
"Monroe County, KY",KY,2018,4695,4504,191,4.1,-34
"Monroe County, KY",KY,2017,4729,4547,182,3.8,126
"Monroe County, KY",KY,2016,4603,4411,192,4.2,112
"Monroe County, KY",KY,2015,4491,4295,196,4.4,-112
"Monroe County, KY",KY,2014,4603,4350,253,5.5,-142
"Monroe County, KY",KY,2013,4745,4409,336,7.1,-57
"Monroe County, KY",KY,2012,4802,4453,349,7.3,-44
"Monroe County, KY",KY,2011,4846,4411,435,9.0,-29
"Monroe County, KY",KY,2010,4875,4349,526,10.8,0
"Monroe County, MI",MI,2021,72149,67809,4340,6.0,-1997
"Monroe County, MI",MI,2020,74146,67313,6833,9.2,-1626
"Monroe County, MI",MI,2019,75772,72770,3002,4.0,-268
"Monroe County, MI",MI,2018,76040,72832,3208,4.2,-47
"Monroe County, MI",MI,2017,76087,72521,3566,4.7,-527
"Monroe County, MI",MI,2016,76614,73276,3338,4.4,29
"Monroe County, MI",MI,2015,76585,73051,3534,4.6,363
"Monroe County, MI",MI,2014,76222,71563,4659,6.1,1556
"Monroe County, MI",MI,2013,74666,69210,5456,7.3,769
"Monroe County, MI",MI,2012,73897,68251,5646,7.6,385
"Monroe County, MI",MI,2011,73512,66833,6679,9.1,-1413
"Monroe County, MI",MI,2010,74925,66399,8526,11.4,0
"Monroe County, MO",MO,2021,3783,3618,165,4.4,8
"Monroe County, MO",MO,2020,3775,3554,221,5.9,-37
"Monroe County, MO",MO,2019,3812,3660,152,4.0,-141
"Monroe County, MO",MO,2018,3953,3814,139,3.5,-111
"Monroe County, MO",MO,2017,4064,3891,173,4.3,-93
"Monroe County, MO",MO,2016,4157,3956,201,4.8,-27
"Monroe County, MO",MO,2015,4184,3962,222,5.3,13
"Monroe County, MO",MO,2014,4171,3902,269,6.4,71
"Monroe County, MO",MO,2013,4100,3796,304,7.4,68
"Monroe County, MO",MO,2012,4032,3714,318,7.9,-42
"Monroe County, MO",MO,2011,4074,3664,410,10.1,-25
"Monroe County, MO",MO,2010,4099,3600,499,12.2,0
"Monroe County, MS",MS,2021,15758,14938,820,5.2,294
"Monroe County, MS",MS,2020,15464,14118,1346,8.7,-163
"Monroe County, MS",MS,2019,15627,14777,850,5.4,218
"Monroe County, MS",MS,2018,15409,14634,775,5.0,-135
"Monroe County, MS",MS,2017,15544,14720,824,5.3,-25
"Monroe County, MS",MS,2016,15569,14567,1002,6.4,130
"Monroe County, MS",MS,2015,15439,14285,1154,7.5,21
"Monroe County, MS",MS,2014,15418,13848,1570,10.2,-92
"Monroe County, MS",MS,2013,15510,13693,1817,11.7,-795
"Monroe County, MS",MS,2012,16305,14536,1769,10.8,-302
"Monroe County, MS",MS,2011,16607,14651,1956,11.8,288
"Monroe County, MS",MS,2010,16319,14231,2088,12.8,0
"Monroe County, NY",NY,2021,360379,341760,18619,5.2,-5334
"Monroe County, NY",NY,2020,365713,335839,29874,8.2,-4836
"Monroe County, NY",NY,2019,370549,355735,14814,4.0,791
"Monroe County, NY",NY,2018,369758,354079,15679,4.2,1057
"Monroe County, NY",NY,2017,368701,350616,18085,4.9,5280
"Monroe County, NY",NY,2016,363421,346044,17377,4.8,-1406
"Monroe County, NY",NY,2015,364827,346195,18632,5.1,804
"Monroe County, NY",NY,2014,364023,342750,21273,5.8,-10179
"Monroe County, NY",NY,2013,374202,347423,26779,7.2,-1533
"Monroe County, NY",NY,2012,375735,345696,30039,8.0,1433
"Monroe County, NY",NY,2011,374302,345365,28937,7.7,-4246
"Monroe County, NY",NY,2010,378548,347553,30995,8.2,0
"Monroe County, OH",OH,2021,5312,4923,389,7.3,-344
"Monroe County, OH",OH,2020,5656,5051,605,10.7,265
"Monroe County, OH",OH,2019,5391,4942,449,8.3,177
"Monroe County, OH",OH,2018,5214,4811,403,7.7,27
"Monroe County, OH",OH,2017,5187,4752,435,8.4,-157
"Monroe County, OH",OH,2016,5344,4745,599,11.2,-219
"Monroe County, OH",OH,2015,5563,5004,559,10.0,-328
"Monroe County, OH",OH,2014,5891,5242,649,11.0,-589
"Monroe County, OH",OH,2013,6480,5833,647,10.0,-15
"Monroe County, OH",OH,2012,6495,5951,544,8.4,-84
"Monroe County, OH",OH,2011,6579,5932,647,9.8,-107
"Monroe County, OH",OH,2010,6686,5865,821,12.3,0
"Monroe County, PA",PA,2021,81973,75678,6295,7.7,-810
"Monroe County, PA",PA,2020,82783,73276,9507,11.5,-1482
"Monroe County, PA",PA,2019,84265,79615,4650,5.5,1006
"Monroe County, PA",PA,2018,83259,78631,4628,5.6,257
"Monroe County, PA",PA,2017,83002,78056,4946,6.0,999
"Monroe County, PA",PA,2016,82003,76939,5064,6.2,1186
"Monroe County, PA",PA,2015,80817,75512,5305,6.6,1031
"Monroe County, PA",PA,2014,79786,73695,6091,7.6,-1462
"Monroe County, PA",PA,2013,81248,73888,7360,9.1,-959
"Monroe County, PA",PA,2012,82207,74353,7854,9.6,210
"Monroe County, PA",PA,2011,81997,74214,7783,9.5,-417
"Monroe County, PA",PA,2010,82414,74649,7765,9.4,0
"Monroe County, TN",TN,2021,20635,19850,785,3.8,478
"Monroe County, TN",TN,2020,20157,18549,1608,8.0,-204
"Monroe County, TN",TN,2019,20361,19619,742,3.6,347
"Monroe County, TN",TN,2018,20014,19275,739,3.7,346
"Monroe County, TN",TN,2017,19668,18877,791,4.0,251
"Monroe County, TN",TN,2016,19417,18388,1029,5.3,332
"Monroe County, TN",TN,2015,19085,17895,1190,6.2,13
"Monroe County, TN",TN,2014,19072,17616,1456,7.6,-233
"Monroe County, TN",TN,2013,19305,17423,1882,9.7,-153
"Monroe County, TN",TN,2012,19458,17489,1969,10.1,-91
"Monroe County, TN",TN,2011,19549,17276,2273,11.6,29
"Monroe County, TN",TN,2010,19520,16996,2524,12.9,0
"Monroe County, WI",WI,2021,23783,23013,770,3.2,143
"Monroe County, WI",WI,2020,23640,22318,1322,5.6,172
"Monroe County, WI",WI,2019,23468,22798,670,2.9,-159
"Monroe County, WI",WI,2018,23627,22985,642,2.7,36
"Monroe County, WI",WI,2017,23591,22903,688,2.9,626
"Monroe County, WI",WI,2016,22965,22110,855,3.7,187
"Monroe County, WI",WI,2015,22778,21787,991,4.4,258
"Monroe County, WI",WI,2014,22520,21321,1199,5.3,-236
"Monroe County, WI",WI,2013,22756,21199,1557,6.8,-3
"Monroe County, WI",WI,2012,22759,21126,1633,7.2,-373
"Monroe County, WI",WI,2011,23132,21473,1659,7.2,-8
"Monroe County, WI",WI,2010,23140,21330,1810,7.8,0
"Monroe County, WV",WV,2021,6090,5869,221,3.6,96
"Monroe County, WV",WV,2020,5994,5578,416,6.9,-7
"Monroe County, WV",WV,2019,6001,5738,263,4.4,151
"Monroe County, WV",WV,2018,5850,5572,278,4.8,-82
"Monroe County, WV",WV,2017,5932,5670,262,4.4,-66
"Monroe County, WV",WV,2016,5998,5725,273,4.6,180
"Monroe County, WV",WV,2015,5818,5502,316,5.4,201
"Monroe County, WV",WV,2014,5617,5294,323,5.8,-68
"Monroe County, WV",WV,2013,5685,5331,354,6.2,-50
"Monroe County, WV",WV,2012,5735,5334,401,7.0,-43
"Monroe County, WV",WV,2011,5778,5332,446,7.7,21
"Monroe County, WV",WV,2010,5757,5296,461,8.0,0
"Montague County, TX",TX,2021,9265,8789,476,5.1,264
"Montague County, TX",TX,2020,9001,8404,597,6.6,-181
"Montague County, TX",TX,2019,9182,8918,264,2.9,131
"Montague County, TX",TX,2018,9051,8760,291,3.2,30
"Montague County, TX",TX,2017,9021,8657,364,4.0,-14
"Montague County, TX",TX,2016,9035,8587,448,5.0,-672
"Montague County, TX",TX,2015,9707,9292,415,4.3,-413
"Montague County, TX",TX,2014,10120,9713,407,4.0,-225
"Montague County, TX",TX,2013,10345,9832,513,5.0,517
"Montague County, TX",TX,2012,9828,9300,528,5.4,232
"Montague County, TX",TX,2011,9596,8950,646,6.7,157
"Montague County, TX",TX,2010,9439,8678,761,8.1,0
"Montcalm County, MI",MI,2021,27073,25561,1512,5.6,-730
"Montcalm County, MI",MI,2020,27803,25157,2646,9.5,-525
"Montcalm County, MI",MI,2019,28328,27151,1177,4.2,-34
"Montcalm County, MI",MI,2018,28362,27145,1217,4.3,195
"Montcalm County, MI",MI,2017,28167,26778,1389,4.9,167
"Montcalm County, MI",MI,2016,28000,26501,1499,5.4,180
"Montcalm County, MI",MI,2015,27820,26205,1615,5.8,104
"Montcalm County, MI",MI,2014,27716,25615,2101,7.6,159
"Montcalm County, MI",MI,2013,27557,24940,2617,9.5,205
"Montcalm County, MI",MI,2012,27352,24598,2754,10.1,132
"Montcalm County, MI",MI,2011,27220,24195,3025,11.1,-304
"Montcalm County, MI",MI,2010,27524,23755,3769,13.7,0
"Monterey County, CA",CA,2021,211858,194310,17548,8.3,-1979
"Monterey County, CA",CA,2020,213837,189830,24007,11.2,-7699
"Monterey County, CA",CA,2019,221536,207458,14078,6.4,-378
"Monterey County, CA",CA,2018,221914,207648,14266,6.4,2427
"Monterey County, CA",CA,2017,219487,203630,15857,7.2,685
"Monterey County, CA",CA,2016,218802,201971,16831,7.7,528
"Monterey County, CA",CA,2015,218274,200452,17822,8.2,920
"Monterey County, CA",CA,2014,217354,197439,19915,9.2,1678
"Monterey County, CA",CA,2013,215676,193153,22523,10.4,-1723
"Monterey County, CA",CA,2012,217399,191832,25567,11.8,1142
"Monterey County, CA",CA,2011,216257,188401,27856,12.9,219
"Monterey County, CA",CA,2010,216038,187860,28178,13.0,0
"Montezuma County, CO",CO,2021,13215,12480,735,5.6,589
"Montezuma County, CO",CO,2020,12626,11760,866,6.9,-123
"Montezuma County, CO",CO,2019,12749,12239,510,4.0,-90
"Montezuma County, CO",CO,2018,12839,12271,568,4.4,113
"Montezuma County, CO",CO,2017,12726,12260,466,3.7,11
"Montezuma County, CO",CO,2016,12715,12112,603,4.7,385
"Montezuma County, CO",CO,2015,12330,11655,675,5.5,-320
"Montezuma County, CO",CO,2014,12650,11883,767,6.1,-55
"Montezuma County, CO",CO,2013,12705,11739,966,7.6,-176
"Montezuma County, CO",CO,2012,12881,11766,1115,8.7,-81
"Montezuma County, CO",CO,2011,12962,11785,1177,9.1,-56
"Montezuma County, CO",CO,2010,13018,11774,1244,9.6,0
"Montgomery County, AL",AL,2021,106663,101486,5177,4.9,-1666
"Montgomery County, AL",AL,2020,108329,99047,9282,8.6,608
"Montgomery County, AL",AL,2019,107721,104224,3497,3.2,625
"Montgomery County, AL",AL,2018,107096,102844,4252,4.0,140
"Montgomery County, AL",AL,2017,106956,102209,4747,4.4,2073
"Montgomery County, AL",AL,2016,104883,98929,5954,5.7,84
"Montgomery County, AL",AL,2015,104799,98376,6423,6.1,-394
"Montgomery County, AL",AL,2014,105193,98012,7181,6.8,-1081
"Montgomery County, AL",AL,2013,106274,98405,7869,7.4,-1162
"Montgomery County, AL",AL,2012,107436,98546,8890,8.3,-1662
"Montgomery County, AL",AL,2011,109098,98539,10559,9.7,230
"Montgomery County, AL",AL,2010,108868,98105,10763,9.9,0
"Montgomery County, AR",AR,2021,2876,2737,139,4.8,-82
"Montgomery County, AR",AR,2020,2958,2752,206,7.0,-22
"Montgomery County, AR",AR,2019,2980,2845,135,4.5,-71
"Montgomery County, AR",AR,2018,3051,2908,143,4.7,-41
"Montgomery County, AR",AR,2017,3092,2943,149,4.8,-41
"Montgomery County, AR",AR,2016,3133,2972,161,5.1,-138
"Montgomery County, AR",AR,2015,3271,3054,217,6.6,-129
"Montgomery County, AR",AR,2014,3400,3137,263,7.7,-59
"Montgomery County, AR",AR,2013,3459,3177,282,8.2,-161
"Montgomery County, AR",AR,2012,3620,3326,294,8.1,-212
"Montgomery County, AR",AR,2011,3832,3493,339,8.8,-99
"Montgomery County, AR",AR,2010,3931,3602,329,8.4,0
"Montgomery County, GA",GA,2021,3858,3699,159,4.1,27
"Montgomery County, GA",GA,2020,3831,3625,206,5.4,-100
"Montgomery County, GA",GA,2019,3931,3722,209,5.3,62
"Montgomery County, GA",GA,2018,3869,3644,225,5.8,68
"Montgomery County, GA",GA,2017,3801,3549,252,6.6,76
"Montgomery County, GA",GA,2016,3725,3444,281,7.5,54
"Montgomery County, GA",GA,2015,3671,3347,324,8.8,-182
"Montgomery County, GA",GA,2014,3853,3454,399,10.4,-190
"Montgomery County, GA",GA,2013,4043,3584,459,11.4,157
"Montgomery County, GA",GA,2012,3886,3440,446,11.5,-19
"Montgomery County, GA",GA,2011,3905,3393,512,13.1,16
"Montgomery County, GA",GA,2010,3889,3415,474,12.2,0
"Montgomery County, IA",IA,2021,4880,4679,201,4.1,-10
"Montgomery County, IA",IA,2020,4890,4667,223,4.6,-201
"Montgomery County, IA",IA,2019,5091,4963,128,2.5,93
"Montgomery County, IA",IA,2018,4998,4877,121,2.4,-2
"Montgomery County, IA",IA,2017,5000,4845,155,3.1,-139
"Montgomery County, IA",IA,2016,5139,4959,180,3.5,-32
"Montgomery County, IA",IA,2015,5171,4989,182,3.5,9
"Montgomery County, IA",IA,2014,5162,4950,212,4.1,33
"Montgomery County, IA",IA,2013,5129,4878,251,4.9,77
"Montgomery County, IA",IA,2012,5052,4794,258,5.1,-3
"Montgomery County, IA",IA,2011,5055,4754,301,6.0,-183
"Montgomery County, IA",IA,2010,5238,4808,430,8.2,0
"Montgomery County, IL",IL,2021,11279,10668,611,5.4,-151
"Montgomery County, IL",IL,2020,11430,10421,1009,8.8,-339
"Montgomery County, IL",IL,2019,11769,11184,585,5.0,-160
"Montgomery County, IL",IL,2018,11929,11231,698,5.9,-13
"Montgomery County, IL",IL,2017,11942,11261,681,5.7,-218
"Montgomery County, IL",IL,2016,12160,11297,863,7.1,123
"Montgomery County, IL",IL,2015,12037,11123,914,7.6,-77
"Montgomery County, IL",IL,2014,12114,11045,1069,8.8,-449
"Montgomery County, IL",IL,2013,12563,11194,1369,10.9,-552
"Montgomery County, IL",IL,2012,13115,11635,1480,11.3,-522
"Montgomery County, IL",IL,2011,13637,12007,1630,12.0,-230
"Montgomery County, IL",IL,2010,13867,12143,1724,12.4,0
"Montgomery County, IN",IN,2021,18414,17933,481,2.6,-195
"Montgomery County, IN",IN,2020,18609,17632,977,5.3,-303
"Montgomery County, IN",IN,2019,18912,18344,568,3.0,-217
"Montgomery County, IN",IN,2018,19129,18556,573,3.0,138
"Montgomery County, IN",IN,2017,18991,18416,575,3.0,-187
"Montgomery County, IN",IN,2016,19178,18450,728,3.8,-87
"Montgomery County, IN",IN,2015,19265,18500,765,4.0,564
"Montgomery County, IN",IN,2014,18701,17695,1006,5.4,274
"Montgomery County, IN",IN,2013,18427,17133,1294,7.0,-181
"Montgomery County, IN",IN,2012,18608,17110,1498,8.1,-142
"Montgomery County, IN",IN,2011,18750,17128,1622,8.7,-144
"Montgomery County, IN",IN,2010,18894,17025,1869,9.9,0
"Montgomery County, KS",KS,2021,14715,14140,575,3.9,-144
"Montgomery County, KS",KS,2020,14859,13800,1059,7.1,-25
"Montgomery County, KS",KS,2019,14884,14285,599,4.0,58
"Montgomery County, KS",KS,2018,14826,14205,621,4.2,-219
"Montgomery County, KS",KS,2017,15045,14260,785,5.2,-1025
"Montgomery County, KS",KS,2016,16070,15088,982,6.1,-549
"Montgomery County, KS",KS,2015,16619,15548,1071,6.4,-745
"Montgomery County, KS",KS,2014,17364,16371,993,5.7,-515
"Montgomery County, KS",KS,2013,17879,16669,1210,6.8,-595
"Montgomery County, KS",KS,2012,18474,17050,1424,7.7,126
"Montgomery County, KS",KS,2011,18348,16554,1794,9.8,276
"Montgomery County, KS",KS,2010,18072,16172,1900,10.5,0
"Montgomery County, KY",KY,2021,11543,10928,615,5.3,219
"Montgomery County, KY",KY,2020,11324,10450,874,7.7,-319
"Montgomery County, KY",KY,2019,11643,11053,590,5.1,-16
"Montgomery County, KY",KY,2018,11659,10983,676,5.8,-72
"Montgomery County, KY",KY,2017,11731,10970,761,6.5,-123
"Montgomery County, KY",KY,2016,11854,11101,753,6.4,149
"Montgomery County, KY",KY,2015,11705,10943,762,6.5,-55
"Montgomery County, KY",KY,2014,11760,10885,875,7.4,-380
"Montgomery County, KY",KY,2013,12140,11121,1019,8.4,-192
"Montgomery County, KY",KY,2012,12332,11237,1095,8.9,224
"Montgomery County, KY",KY,2011,12108,10757,1351,11.2,-33
"Montgomery County, KY",KY,2010,12141,10647,1494,12.3,0
"Montgomery County, MD",MD,2021,547389,517358,30031,5.5,-9076
"Montgomery County, MD",MD,2020,556465,521828,34637,6.2,-18886
"Montgomery County, MD",MD,2019,575351,559116,16235,2.8,10948
"Montgomery County, MD",MD,2018,564403,547810,16593,2.9,3033
"Montgomery County, MD",MD,2017,561370,543489,17881,3.2,16721
"Montgomery County, MD",MD,2016,544649,526510,18139,3.3,-2580
"Montgomery County, MD",MD,2015,547229,526310,20919,3.8,2958
"Montgomery County, MD",MD,2014,544271,520698,23573,4.3,1137
"Montgomery County, MD",MD,2013,543134,516469,26665,4.9,2324
"Montgomery County, MD",MD,2012,540810,513193,27617,5.1,3863
"Montgomery County, MD",MD,2011,536947,508359,28588,5.3,3791
"Montgomery County, MD",MD,2010,533156,502458,30698,5.8,0
"Montgomery County, MO",MO,2021,5788,5573,215,3.7,82
"Montgomery County, MO",MO,2020,5706,5427,279,4.9,3
"Montgomery County, MO",MO,2019,5703,5533,170,3.0,21
"Montgomery County, MO",MO,2018,5682,5520,162,2.9,35
"Montgomery County, MO",MO,2017,5647,5463,184,3.3,-96
"Montgomery County, MO",MO,2016,5743,5481,262,4.6,71
"Montgomery County, MO",MO,2015,5672,5385,287,5.1,5
"Montgomery County, MO",MO,2014,5667,5330,337,5.9,-36
"Montgomery County, MO",MO,2013,5703,5288,415,7.3,-64
"Montgomery County, MO",MO,2012,5767,5300,467,8.1,-161
"Montgomery County, MO",MO,2011,5928,5328,600,10.1,-90
"Montgomery County, MO",MO,2010,6018,5355,663,11.0,0
"Montgomery County, MS",MS,2021,3877,3641,236,6.1,17
"Montgomery County, MS",MS,2020,3860,3556,304,7.9,-86
"Montgomery County, MS",MS,2019,3946,3709,237,6.0,-53
"Montgomery County, MS",MS,2018,3999,3781,218,5.5,-154
"Montgomery County, MS",MS,2017,4153,3936,217,5.2,-65
"Montgomery County, MS",MS,2016,4218,3943,275,6.5,30
"Montgomery County, MS",MS,2015,4188,3859,329,7.9,7
"Montgomery County, MS",MS,2014,4181,3791,390,9.3,-195
"Montgomery County, MS",MS,2013,4376,3884,492,11.2,-213
"Montgomery County, MS",MS,2012,4589,4064,525,11.4,-96
"Montgomery County, MS",MS,2011,4685,4117,568,12.1,7
"Montgomery County, MS",MS,2010,4678,4051,627,13.4,0
"Montgomery County, NC",NC,2021,11014,10499,515,4.7,41
"Montgomery County, NC",NC,2020,10973,10264,709,6.5,-506
"Montgomery County, NC",NC,2019,11479,11031,448,3.9,109
"Montgomery County, NC",NC,2018,11370,10909,461,4.1,-215
"Montgomery County, NC",NC,2017,11585,11057,528,4.6,-79
"Montgomery County, NC",NC,2016,11664,11061,603,5.2,51
"Montgomery County, NC",NC,2015,11613,10960,653,5.6,142
"Montgomery County, NC",NC,2014,11471,10760,711,6.2,-228
"Montgomery County, NC",NC,2013,11699,10757,942,8.1,43
"Montgomery County, NC",NC,2012,11656,10393,1263,10.8,91
"Montgomery County, NC",NC,2011,11565,10203,1362,11.8,82
"Montgomery County, NC",NC,2010,11483,10081,1402,12.2,0
"Montgomery County, NY",NY,2021,21900,20661,1239,5.7,-542
"Montgomery County, NY",NY,2020,22442,20553,1889,8.4,-334
"Montgomery County, NY",NY,2019,22776,21663,1113,4.9,-129
"Montgomery County, NY",NY,2018,22905,21730,1175,5.1,-37
"Montgomery County, NY",NY,2017,22942,21638,1304,5.7,621
"Montgomery County, NY",NY,2016,22321,21022,1299,5.8,86
"Montgomery County, NY",NY,2015,22235,20765,1470,6.6,-6
"Montgomery County, NY",NY,2014,22241,20565,1676,7.5,-922
"Montgomery County, NY",NY,2013,23163,20982,2181,9.4,-261
"Montgomery County, NY",NY,2012,23424,20954,2470,10.5,-48
"Montgomery County, NY",NY,2011,23472,21051,2421,10.3,-479
"Montgomery County, NY",NY,2010,23951,21488,2463,10.3,0
"Montgomery County, OH",OH,2021,248437,234606,13831,5.6,-2629
"Montgomery County, OH",OH,2020,251066,229324,21742,8.7,-2821
"Montgomery County, OH",OH,2019,253887,243116,10771,4.2,1643
"Montgomery County, OH",OH,2018,252244,240844,11400,4.5,-911
"Montgomery County, OH",OH,2017,253155,240829,12326,4.9,2116
"Montgomery County, OH",OH,2016,251039,238575,12464,5.0,1135
"Montgomery County, OH",OH,2015,249904,237254,12650,5.1,193
"Montgomery County, OH",OH,2014,249711,234391,15320,6.1,-1424
"Montgomery County, OH",OH,2013,251135,230358,20777,8.3,-3455
"Montgomery County, OH",OH,2012,254590,233721,20869,8.2,-4801
"Montgomery County, OH",OH,2011,259391,234202,25189,9.7,-6350
"Montgomery County, OH",OH,2010,265741,235489,30252,11.4,0
"Montgomery County, PA",PA,2021,455531,432931,22600,5.0,662
"Montgomery County, PA",PA,2020,454869,420355,34514,7.6,-7084
"Montgomery County, PA",PA,2019,461953,445356,16597,3.6,6750
"Montgomery County, PA",PA,2018,455203,438929,16274,3.6,2920
"Montgomery County, PA",PA,2017,452283,434530,17753,3.9,4175
"Montgomery County, PA",PA,2016,448108,429780,18328,4.1,7150
"Montgomery County, PA",PA,2015,440958,422288,18670,4.2,4901
"Montgomery County, PA",PA,2014,436057,415511,20546,4.7,1738
"Montgomery County, PA",PA,2013,434319,409692,24627,5.7,-458
"Montgomery County, PA",PA,2012,434777,407767,27010,6.2,5266
"Montgomery County, PA",PA,2011,429511,402275,27236,6.3,318
"Montgomery County, PA",PA,2010,429193,400319,28874,6.7,0
"Montgomery County, TN",TN,2021,87746,83799,3947,4.5,800
"Montgomery County, TN",TN,2020,86946,80428,6518,7.5,139
"Montgomery County, TN",TN,2019,86807,83519,3288,3.8,2638
"Montgomery County, TN",TN,2018,84169,80928,3241,3.9,2108
"Montgomery County, TN",TN,2017,82061,78699,3362,4.1,2043
"Montgomery County, TN",TN,2016,80018,75931,4087,5.1,1266
"Montgomery County, TN",TN,2015,78752,74205,4547,5.8,1382
"Montgomery County, TN",TN,2014,77370,72207,5163,6.7,-245
"Montgomery County, TN",TN,2013,77615,71766,5849,7.5,-318
"Montgomery County, TN",TN,2012,77933,71919,6014,7.7,864
"Montgomery County, TN",TN,2011,77069,70384,6685,8.7,1393
"Montgomery County, TN",TN,2010,75676,69106,6570,8.7,0
"Montgomery County, TX",TX,2021,293629,276611,17018,5.8,5541
"Montgomery County, TX",TX,2020,288088,266622,21466,7.5,2554
"Montgomery County, TX",TX,2019,285534,275842,9692,3.4,8564
"Montgomery County, TX",TX,2018,276970,266516,10454,3.8,8764
"Montgomery County, TX",TX,2017,268206,256420,11786,4.4,2210
"Montgomery County, TX",TX,2016,265996,252941,13055,4.9,7682
"Montgomery County, TX",TX,2015,258314,247267,11047,4.3,4872
"Montgomery County, TX",TX,2014,253442,242097,11345,4.5,7610
"Montgomery County, TX",TX,2013,245832,232431,13401,5.5,7193
"Montgomery County, TX",TX,2012,238639,224554,14085,5.9,7017
"Montgomery County, TX",TX,2011,231622,214730,16892,7.3,6894
"Montgomery County, TX",TX,2010,224728,207696,17032,7.6,0
"Montgomery County, VA",VA,2021,49360,47901,1459,3.0,268
"Montgomery County, VA",VA,2020,49092,46761,2331,4.7,-1974
"Montgomery County, VA",VA,2019,51066,49650,1416,2.8,707
"Montgomery County, VA",VA,2018,50359,48891,1468,2.9,213
"Montgomery County, VA",VA,2017,50146,48280,1866,3.7,350
"Montgomery County, VA",VA,2016,49796,47769,2027,4.1,-129
"Montgomery County, VA",VA,2015,49925,47798,2127,4.3,-23
"Montgomery County, VA",VA,2014,49948,47448,2500,5.0,270
"Montgomery County, VA",VA,2013,49678,46938,2740,5.5,588
"Montgomery County, VA",VA,2012,49090,46231,2859,5.8,798
"Montgomery County, VA",VA,2011,48292,45247,3045,6.3,737
"Montgomery County, VA",VA,2010,47555,44117,3438,7.2,0
"Montmorency County, MI",MI,2021,2936,2661,275,9.4,-74
"Montmorency County, MI",MI,2020,3010,2596,414,13.8,12
"Montmorency County, MI",MI,2019,2998,2743,255,8.5,-22
"Montmorency County, MI",MI,2018,3020,2754,266,8.8,-38
"Montmorency County, MI",MI,2017,3058,2743,315,10.3,-11
"Montmorency County, MI",MI,2016,3069,2755,314,10.2,-14
"Montmorency County, MI",MI,2015,3083,2772,311,10.1,-80
"Montmorency County, MI",MI,2014,3163,2753,410,13.0,-46
"Montmorency County, MI",MI,2013,3209,2698,511,15.9,-36
"Montmorency County, MI",MI,2012,3245,2723,522,16.1,-82
"Montmorency County, MI",MI,2011,3327,2748,579,17.4,-180
"Montmorency County, MI",MI,2010,3507,2820,687,19.6,0
"Montour County, PA",PA,2021,9001,8609,392,4.4,-95
"Montour County, PA",PA,2020,9096,8531,565,6.2,-166
"Montour County, PA",PA,2019,9262,8922,340,3.7,70
"Montour County, PA",PA,2018,9192,8859,333,3.6,6
"Montour County, PA",PA,2017,9186,8827,359,3.9,44
"Montour County, PA",PA,2016,9142,8757,385,4.2,-6
"Montour County, PA",PA,2015,9148,8746,402,4.4,-81
"Montour County, PA",PA,2014,9229,8794,435,4.7,-207
"Montour County, PA",PA,2013,9436,8938,498,5.3,9
"Montour County, PA",PA,2012,9427,8891,536,5.7,252
"Montour County, PA",PA,2011,9175,8614,561,6.1,120
"Montour County, PA",PA,2010,9055,8465,590,6.5,0
"Montrose County, CO",CO,2021,22392,21270,1122,5.0,901
"Montrose County, CO",CO,2020,21491,20134,1357,6.3,-98
"Montrose County, CO",CO,2019,21589,20955,634,2.9,179
"Montrose County, CO",CO,2018,21410,20681,729,3.4,789
"Montrose County, CO",CO,2017,20621,19993,628,3.0,559
"Montrose County, CO",CO,2016,20062,19268,794,4.0,743
"Montrose County, CO",CO,2015,19319,18379,940,4.9,59
"Montrose County, CO",CO,2014,19260,17958,1302,6.8,-19
"Montrose County, CO",CO,2013,19279,17487,1792,9.3,-506
"Montrose County, CO",CO,2012,19785,17716,2069,10.5,-205
"Montrose County, CO",CO,2011,19990,17706,2284,11.4,-582
"Montrose County, CO",CO,2010,20572,18217,2355,11.4,0
"Moody County, SD",SD,2021,4002,3890,112,2.8,2
"Moody County, SD",SD,2020,4000,3806,194,4.9,-23
"Moody County, SD",SD,2019,4023,3899,124,3.1,33
"Moody County, SD",SD,2018,3990,3880,110,2.8,14
"Moody County, SD",SD,2017,3976,3840,136,3.4,6
"Moody County, SD",SD,2016,3970,3823,147,3.7,2
"Moody County, SD",SD,2015,3968,3836,132,3.3,-32
"Moody County, SD",SD,2014,4000,3840,160,4.0,-25
"Moody County, SD",SD,2013,4025,3843,182,4.5,-19
"Moody County, SD",SD,2012,4044,3834,210,5.2,-125
"Moody County, SD",SD,2011,4169,3909,260,6.2,-6
"Moody County, SD",SD,2010,4175,3886,289,6.9,0
"Moore County, NC",NC,2021,40161,38325,1836,4.6,619
"Moore County, NC",NC,2020,39542,36751,2791,7.1,-2238
"Moore County, NC",NC,2019,41780,40190,1590,3.8,1280
"Moore County, NC",NC,2018,40500,38928,1572,3.9,1194
"Moore County, NC",NC,2017,39306,37545,1761,4.5,-83
"Moore County, NC",NC,2016,39389,37411,1978,5.0,1138
"Moore County, NC",NC,2015,38251,36059,2192,5.7,67
"Moore County, NC",NC,2014,38184,35914,2270,5.9,212
"Moore County, NC",NC,2013,37972,35104,2868,7.6,183
"Moore County, NC",NC,2012,37789,34388,3401,9.0,512
"Moore County, NC",NC,2011,37277,33725,3552,9.5,817
"Moore County, NC",NC,2010,36460,32810,3650,10.0,0
"Moore County, TN",TN,2021,3577,3483,94,2.6,-36
"Moore County, TN",TN,2020,3613,3421,192,5.3,-21
"Moore County, TN",TN,2019,3634,3528,106,2.9,129
"Moore County, TN",TN,2018,3505,3398,107,3.1,22
"Moore County, TN",TN,2017,3483,3374,109,3.1,96
"Moore County, TN",TN,2016,3387,3259,128,3.8,75
"Moore County, TN",TN,2015,3312,3164,148,4.5,17
"Moore County, TN",TN,2014,3295,3127,168,5.1,-41
"Moore County, TN",TN,2013,3336,3136,200,6.0,-53
"Moore County, TN",TN,2012,3389,3189,200,5.9,59
"Moore County, TN",TN,2011,3330,3098,232,7.0,72
"Moore County, TN",TN,2010,3258,2996,262,8.0,0
"Moore County, TX",TX,2021,10983,10616,367,3.3,493
"Moore County, TX",TX,2020,10490,10098,392,3.7,-200
"Moore County, TX",TX,2019,10690,10443,247,2.3,-73
"Moore County, TX",TX,2018,10763,10475,288,2.7,-224
"Moore County, TX",TX,2017,10987,10668,319,2.9,-210
"Moore County, TX",TX,2016,11197,10864,333,3.0,82
"Moore County, TX",TX,2015,11115,10765,350,3.1,-164
"Moore County, TX",TX,2014,11279,10882,397,3.5,-137
"Moore County, TX",TX,2013,11416,10926,490,4.3,-147
"Moore County, TX",TX,2012,11563,11066,497,4.3,-179
"Moore County, TX",TX,2011,11742,11157,585,5.0,179
"Moore County, TX",TX,2010,11563,10940,623,5.4,0
"Mora County, NM",NM,2021,1998,1874,124,6.2,-34
"Mora County, NM",NM,2020,2032,1873,159,7.8,-208
"Mora County, NM",NM,2019,2240,2103,137,6.1,-58
"Mora County, NM",NM,2018,2298,2159,139,6.0,66
"Mora County, NM",NM,2017,2232,2057,175,7.8,-24
"Mora County, NM",NM,2016,2256,2057,199,8.8,-30
"Mora County, NM",NM,2015,2286,2062,224,9.8,10
"Mora County, NM",NM,2014,2276,2029,247,10.9,9
"Mora County, NM",NM,2013,2267,2003,264,11.6,-48
"Mora County, NM",NM,2012,2315,2066,249,10.8,-44
"Mora County, NM",NM,2011,2359,2080,279,11.8,-51
"Mora County, NM",NM,2010,2410,2125,285,11.8,0
"Morehouse Parish, LA",LA,2021,9942,9214,728,7.3,-75
"Morehouse Parish, LA",LA,2020,10017,8971,1046,10.4,16
"Morehouse Parish, LA",LA,2019,10001,9201,800,8.0,-191
"Morehouse Parish, LA",LA,2018,10192,9367,825,8.1,-185
"Morehouse Parish, LA",LA,2017,10377,9550,827,8.0,-258
"Morehouse Parish, LA",LA,2016,10635,9603,1032,9.7,-138
"Morehouse Parish, LA",LA,2015,10773,9597,1176,10.9,-333
"Morehouse Parish, LA",LA,2014,11106,9880,1226,11.0,13
"Morehouse Parish, LA",LA,2013,11093,9769,1324,11.9,-167
"Morehouse Parish, LA",LA,2012,11260,9856,1404,12.5,201
"Morehouse Parish, LA",LA,2011,11059,9540,1519,13.7,23
"Morehouse Parish, LA",LA,2010,11036,9423,1613,14.6,0
"Morgan County, AL",AL,2021,59256,57716,1540,2.6,-481
"Morgan County, AL",AL,2020,59737,56771,2966,5.0,558
"Morgan County, AL",AL,2019,59179,57574,1605,2.7,1406
"Morgan County, AL",AL,2018,57773,55769,2004,3.5,2108
"Morgan County, AL",AL,2017,55665,53328,2337,4.2,1252
"Morgan County, AL",AL,2016,54413,51395,3018,5.5,-369
"Morgan County, AL",AL,2015,54782,51538,3244,5.9,-1353
"Morgan County, AL",AL,2014,56135,52450,3685,6.6,-816
"Morgan County, AL",AL,2013,56951,52979,3972,7.0,-521
"Morgan County, AL",AL,2012,57472,52866,4606,8.0,-847
"Morgan County, AL",AL,2011,58319,52836,5483,9.4,475
"Morgan County, AL",AL,2010,57844,51711,6133,10.6,0
"Morgan County, CO",CO,2021,16212,15419,793,4.9,313
"Morgan County, CO",CO,2020,15899,15089,810,5.1,-419
"Morgan County, CO",CO,2019,16318,15913,405,2.5,129
"Morgan County, CO",CO,2018,16189,15754,435,2.7,743
"Morgan County, CO",CO,2017,15446,15098,348,2.3,407
"Morgan County, CO",CO,2016,15039,14542,497,3.3,370
"Morgan County, CO",CO,2015,14669,14132,537,3.7,-133
"Morgan County, CO",CO,2014,14802,14125,677,4.6,147
"Morgan County, CO",CO,2013,14655,13713,942,6.4,-282
"Morgan County, CO",CO,2012,14937,13911,1026,6.9,-68
"Morgan County, CO",CO,2011,15005,13963,1042,6.9,622
"Morgan County, CO",CO,2010,14383,13318,1065,7.4,0
"Morgan County, GA",GA,2021,9521,9212,309,3.2,299
"Morgan County, GA",GA,2020,9222,8732,490,5.3,-170
"Morgan County, GA",GA,2019,9392,9085,307,3.3,179
"Morgan County, GA",GA,2018,9213,8880,333,3.6,137
"Morgan County, GA",GA,2017,9076,8665,411,4.5,378
"Morgan County, GA",GA,2016,8698,8254,444,5.1,374
"Morgan County, GA",GA,2015,8324,7860,464,5.6,-20
"Morgan County, GA",GA,2014,8344,7796,548,6.6,8
"Morgan County, GA",GA,2013,8336,7669,667,8.0,-175
"Morgan County, GA",GA,2012,8511,7754,757,8.9,-111
"Morgan County, GA",GA,2011,8622,7763,859,10.0,-32
"Morgan County, GA",GA,2010,8654,7739,915,10.6,0
"Morgan County, IL",IL,2021,15739,14958,781,5.0,-115
"Morgan County, IL",IL,2020,15854,14746,1108,7.0,-661
"Morgan County, IL",IL,2019,16515,15882,633,3.8,114
"Morgan County, IL",IL,2018,16401,15682,719,4.4,-40
"Morgan County, IL",IL,2017,16441,15721,720,4.4,-564
"Morgan County, IL",IL,2016,17005,16165,840,4.9,46
"Morgan County, IL",IL,2015,16959,16106,853,5.0,-199
"Morgan County, IL",IL,2014,17158,16125,1033,6.0,-170
"Morgan County, IL",IL,2013,17328,15971,1357,7.8,-322
"Morgan County, IL",IL,2012,17650,16280,1370,7.8,-436
"Morgan County, IL",IL,2011,18086,16629,1457,8.1,-250
"Morgan County, IL",IL,2010,18336,16777,1559,8.5,0
"Morgan County, IN",IN,2021,36205,35153,1052,2.9,723
"Morgan County, IN",IN,2020,35482,33531,1951,5.5,-1081
"Morgan County, IN",IN,2019,36563,35452,1111,3.0,239
"Morgan County, IN",IN,2018,36324,35105,1219,3.4,456
"Morgan County, IN",IN,2017,35868,34617,1251,3.5,-206
"Morgan County, IN",IN,2016,36074,34561,1513,4.2,709
"Morgan County, IN",IN,2015,35365,33710,1655,4.7,356
"Morgan County, IN",IN,2014,35009,32982,2027,5.8,129
"Morgan County, IN",IN,2013,34880,32296,2584,7.4,175
"Morgan County, IN",IN,2012,34705,31838,2867,8.3,-261
"Morgan County, IN",IN,2011,34966,31773,3193,9.1,-69
"Morgan County, IN",IN,2010,35035,31496,3539,10.1,0
"Morgan County, KY",KY,2021,4326,4077,249,5.8,-69
"Morgan County, KY",KY,2020,4395,4106,289,6.6,-187
"Morgan County, KY",KY,2019,4582,4349,233,5.1,112
"Morgan County, KY",KY,2018,4470,4193,277,6.2,-38
"Morgan County, KY",KY,2017,4508,4181,327,7.3,23
"Morgan County, KY",KY,2016,4485,4130,355,7.9,80
"Morgan County, KY",KY,2015,4405,4042,363,8.2,-390
"Morgan County, KY",KY,2014,4795,4346,449,9.4,-261
"Morgan County, KY",KY,2013,5056,4524,532,10.5,-168
"Morgan County, KY",KY,2012,5224,4666,558,10.7,-20
"Morgan County, KY",KY,2011,5244,4669,575,11.0,103
"Morgan County, KY",KY,2010,5141,4465,676,13.1,0
"Morgan County, MO",MO,2021,8540,8137,403,4.7,338
"Morgan County, MO",MO,2020,8202,7693,509,6.2,128
"Morgan County, MO",MO,2019,8074,7742,332,4.1,119
"Morgan County, MO",MO,2018,7955,7620,335,4.2,20
"Morgan County, MO",MO,2017,7935,7546,389,4.9,-23
"Morgan County, MO",MO,2016,7958,7491,467,5.9,-73
"Morgan County, MO",MO,2015,8031,7479,552,6.9,92
"Morgan County, MO",MO,2014,7939,7247,692,8.7,109
"Morgan County, MO",MO,2013,7830,7082,748,9.6,66
"Morgan County, MO",MO,2012,7764,6968,796,10.3,-79
"Morgan County, MO",MO,2011,7843,6832,1011,12.9,-104
"Morgan County, MO",MO,2010,7947,6800,1147,14.4,0
"Morgan County, OH",OH,2021,6756,6334,422,6.2,74
"Morgan County, OH",OH,2020,6682,6065,617,9.2,-102
"Morgan County, OH",OH,2019,6784,6342,442,6.5,39
"Morgan County, OH",OH,2018,6745,6342,403,6.0,9
"Morgan County, OH",OH,2017,6736,6281,455,6.8,-44
"Morgan County, OH",OH,2016,6780,6214,566,8.3,52
"Morgan County, OH",OH,2015,6728,6232,496,7.4,44
"Morgan County, OH",OH,2014,6684,6163,521,7.8,-3
"Morgan County, OH",OH,2013,6687,6014,673,10.1,-15
"Morgan County, OH",OH,2012,6702,6038,664,9.9,-66
"Morgan County, OH",OH,2011,6768,6000,768,11.3,-108
"Morgan County, OH",OH,2010,6876,5957,919,13.4,0
"Morgan County, TN",TN,2021,7731,7397,334,4.3,148
"Morgan County, TN",TN,2020,7583,7106,477,6.3,-226
"Morgan County, TN",TN,2019,7809,7488,321,4.1,-8
"Morgan County, TN",TN,2018,7817,7466,351,4.5,7
"Morgan County, TN",TN,2017,7810,7427,383,4.9,1
"Morgan County, TN",TN,2016,7809,7304,505,6.5,77
"Morgan County, TN",TN,2015,7732,7159,573,7.4,-71
"Morgan County, TN",TN,2014,7803,7113,690,8.8,-277
"Morgan County, TN",TN,2013,8080,7259,821,10.2,-237
"Morgan County, TN",TN,2012,8317,7451,866,10.4,-140
"Morgan County, TN",TN,2011,8457,7530,927,11.0,44
"Morgan County, TN",TN,2010,8413,7440,973,11.6,0
"Morgan County, UT",UT,2021,5779,5658,121,2.1,115
"Morgan County, UT",UT,2020,5664,5473,191,3.4,103
"Morgan County, UT",UT,2019,5561,5427,134,2.4,73
"Morgan County, UT",UT,2018,5488,5345,143,2.6,75
"Morgan County, UT",UT,2017,5413,5264,149,2.8,288
"Morgan County, UT",UT,2016,5125,4977,148,2.9,221
"Morgan County, UT",UT,2015,4904,4754,150,3.1,253
"Morgan County, UT",UT,2014,4651,4500,151,3.2,207
"Morgan County, UT",UT,2013,4444,4279,165,3.7,186
"Morgan County, UT",UT,2012,4258,4074,184,4.3,43
"Morgan County, UT",UT,2011,4215,3963,252,6.0,-40
"Morgan County, UT",UT,2010,4255,3958,297,7.0,0
"Morgan County, WV",WV,2021,8532,8236,296,3.5,291
"Morgan County, WV",WV,2020,8241,7752,489,5.9,24
"Morgan County, WV",WV,2019,8217,7897,320,3.9,173
"Morgan County, WV",WV,2018,8044,7703,341,4.2,180
"Morgan County, WV",WV,2017,7864,7553,311,4.0,185
"Morgan County, WV",WV,2016,7679,7342,337,4.4,116
"Morgan County, WV",WV,2015,7563,7158,405,5.4,91
"Morgan County, WV",WV,2014,7472,7036,436,5.8,23
"Morgan County, WV",WV,2013,7449,6992,457,6.1,-140
"Morgan County, WV",WV,2012,7589,7053,536,7.1,7
"Morgan County, WV",WV,2011,7582,6971,611,8.1,-85
"Morgan County, WV",WV,2010,7667,6966,701,9.1,0
"Morovis Municipio, PR",PR,2021,8636,7848,788,9.1,
"Morovis Municipio, PR",PR,2020,N.A.,N.A.,N.A.,N.A.,
"Morovis Municipio, PR",PR,2019,8015,7288,727,9.1,127
"Morovis Municipio, PR",PR,2018,7888,7122,766,9.7,-140
"Morovis Municipio, PR",PR,2017,8028,7032,996,12.4,-91
"Morovis Municipio, PR",PR,2016,8119,7027,1092,13.4,-18
"Morovis Municipio, PR",PR,2015,8137,6992,1145,14.1,-285
"Morovis Municipio, PR",PR,2014,8422,6867,1555,18.5,-284
"Morovis Municipio, PR",PR,2013,8706,7030,1676,19.3,29
"Morovis Municipio, PR",PR,2012,8677,7088,1589,18.3,-177
"Morovis Municipio, PR",PR,2011,8854,7013,1841,20.8,-433
"Morovis Municipio, PR",PR,2010,9287,7168,2119,22.8,0
"Morrill County, NE",NE,2021,2641,2576,65,2.5,2
"Morrill County, NE",NE,2020,2639,2547,92,3.5,4
"Morrill County, NE",NE,2019,2635,2560,75,2.8,25
"Morrill County, NE",NE,2018,2610,2538,72,2.8,-21
"Morrill County, NE",NE,2017,2631,2552,79,3.0,-32
"Morrill County, NE",NE,2016,2663,2579,84,3.2,2
"Morrill County, NE",NE,2015,2661,2585,76,2.9,-22
"Morrill County, NE",NE,2014,2683,2603,80,3.0,-63
"Morrill County, NE",NE,2013,2746,2660,86,3.1,48
"Morrill County, NE",NE,2012,2698,2614,84,3.1,39
"Morrill County, NE",NE,2011,2659,2569,90,3.4,13
"Morrill County, NE",NE,2010,2646,2536,110,4.2,0
"Morris County, KS",KS,2021,3053,2981,72,2.4,-24
"Morris County, KS",KS,2020,3077,2960,117,3.8,73
"Morris County, KS",KS,2019,3004,2923,81,2.7,-10
"Morris County, KS",KS,2018,3014,2934,80,2.7,7
"Morris County, KS",KS,2017,3007,2913,94,3.1,-58
"Morris County, KS",KS,2016,3065,2947,118,3.8,-47
"Morris County, KS",KS,2015,3112,2979,133,4.3,11
"Morris County, KS",KS,2014,3101,2965,136,4.4,-6
"Morris County, KS",KS,2013,3107,2938,169,5.4,-108
"Morris County, KS",KS,2012,3215,3019,196,6.1,-89
"Morris County, KS",KS,2011,3304,3087,217,6.6,-7
"Morris County, KS",KS,2010,3311,3088,223,6.7,0
"Morris County, NJ",NJ,2021,262719,249661,13058,5.0,1609
"Morris County, NJ",NJ,2020,261110,241500,19610,7.5,-6432
"Morris County, NJ",NJ,2019,267542,260411,7131,2.7,3784
"Morris County, NJ",NJ,2018,263758,255505,8253,3.1,-606
"Morris County, NJ",NJ,2017,264364,254986,9378,3.5,5003
"Morris County, NJ",NJ,2016,259361,249294,10067,3.9,-577
"Morris County, NJ",NJ,2015,259938,248715,11223,4.3,-1058
"Morris County, NJ",NJ,2014,260996,247892,13104,5.0,-3018
"Morris County, NJ",NJ,2013,264014,247409,16605,6.3,-2968
"Morris County, NJ",NJ,2012,266982,247908,19074,7.1,1507
"Morris County, NJ",NJ,2011,265475,246715,18760,7.1,323
"Morris County, NJ",NJ,2010,265152,245208,19944,7.5,0
"Morris County, TX",TX,2021,4624,4140,484,10.5,-197
"Morris County, TX",TX,2020,4821,4280,541,11.2,68
"Morris County, TX",TX,2019,4753,4501,252,5.3,88
"Morris County, TX",TX,2018,4665,4356,309,6.6,20
"Morris County, TX",TX,2017,4645,4242,403,8.7,-250
"Morris County, TX",TX,2016,4895,4359,536,10.9,-423
"Morris County, TX",TX,2015,5318,4847,471,8.9,-301
"Morris County, TX",TX,2014,5619,5174,445,7.9,-212
"Morris County, TX",TX,2013,5831,5268,563,9.7,10
"Morris County, TX",TX,2012,5821,5257,564,9.7,1
"Morris County, TX",TX,2011,5820,5100,720,12.4,41
"Morris County, TX",TX,2010,5779,4980,799,13.8,0
"Morrison County, MN",MN,2021,17149,16388,761,4.4,-894
"Morrison County, MN",MN,2020,18043,16780,1263,7.0,259
"Morrison County, MN",MN,2019,17784,16803,981,5.5,145
"Morrison County, MN",MN,2018,17639,16756,883,5.0,-109
"Morrison County, MN",MN,2017,17748,16795,953,5.4,-108
"Morrison County, MN",MN,2016,17856,16853,1003,5.6,11
"Morrison County, MN",MN,2015,17845,16861,984,5.5,404
"Morrison County, MN",MN,2014,17441,16327,1114,6.4,-261
"Morrison County, MN",MN,2013,17702,16490,1212,6.8,-256
"Morrison County, MN",MN,2012,17958,16682,1276,7.1,-835
"Morrison County, MN",MN,2011,18793,17242,1551,8.3,164
"Morrison County, MN",MN,2010,18629,16858,1771,9.5,0
"Morrow County, OH",OH,2021,16911,16149,762,4.5,205
"Morrow County, OH",OH,2020,16706,15504,1202,7.2,-267
"Morrow County, OH",OH,2019,16973,16266,707,4.2,234
"Morrow County, OH",OH,2018,16739,15969,770,4.6,-92
"Morrow County, OH",OH,2017,16831,16001,830,4.9,-3
"Morrow County, OH",OH,2016,16834,15978,856,5.1,93
"Morrow County, OH",OH,2015,16741,15888,853,5.1,-103
"Morrow County, OH",OH,2014,16844,15842,1002,5.9,-42
"Morrow County, OH",OH,2013,16886,15532,1354,8.0,-18
"Morrow County, OH",OH,2012,16904,15530,1374,8.1,-187
"Morrow County, OH",OH,2011,17091,15361,1730,10.1,-247
"Morrow County, OH",OH,2010,17338,15352,1986,11.5,0
"Morrow County, OR",OR,2021,5966,5694,272,4.6,196
"Morrow County, OR",OR,2020,5770,5473,297,5.1,27
"Morrow County, OR",OR,2019,5743,5510,233,4.1,53
"Morrow County, OR",OR,2018,5690,5453,237,4.2,-30
"Morrow County, OR",OR,2017,5720,5471,249,4.4,-33
"Morrow County, OR",OR,2016,5753,5478,275,4.8,208
"Morrow County, OR",OR,2015,5545,5235,310,5.6,35
"Morrow County, OR",OR,2014,5510,5137,373,6.8,-61
"Morrow County, OR",OR,2013,5571,5148,423,7.6,-104
"Morrow County, OR",OR,2012,5675,5216,459,8.1,-123
"Morrow County, OR",OR,2011,5798,5316,482,8.3,50
"Morrow County, OR",OR,2010,5748,5208,540,9.4,0
"Morton County, KS",KS,2021,1135,1106,29,2.6,6
"Morton County, KS",KS,2020,1129,1096,33,2.9,-11
"Morton County, KS",KS,2019,1140,1107,33,2.9,-34
"Morton County, KS",KS,2018,1174,1137,37,3.2,-29
"Morton County, KS",KS,2017,1203,1158,45,3.7,-147
"Morton County, KS",KS,2016,1350,1298,52,3.9,-89
"Morton County, KS",KS,2015,1439,1379,60,4.2,-51
"Morton County, KS",KS,2014,1490,1432,58,3.9,-107
"Morton County, KS",KS,2013,1597,1534,63,3.9,-66
"Morton County, KS",KS,2012,1663,1601,62,3.7,-20
"Morton County, KS",KS,2011,1683,1622,61,3.6,-74
"Morton County, KS",KS,2010,1757,1681,76,4.3,0
"Morton County, ND",ND,2021,17062,16409,653,3.8,98
"Morton County, ND",ND,2020,16964,16112,852,5.0,245
"Morton County, ND",ND,2019,16719,16273,446,2.7,112
"Morton County, ND",ND,2018,16607,16114,493,3.0,-230
"Morton County, ND",ND,2017,16837,16321,516,3.1,79
"Morton County, ND",ND,2016,16758,16212,546,3.3,621
"Morton County, ND",ND,2015,16137,15639,498,3.1,362
"Morton County, ND",ND,2014,15775,15270,505,3.2,177
"Morton County, ND",ND,2013,15598,15085,513,3.3,188
"Morton County, ND",ND,2012,15410,14881,529,3.4,-369
"Morton County, ND",ND,2011,15779,15168,611,3.9,-242
"Morton County, ND",ND,2010,16021,15305,716,4.5,0
"Motley County, TX",TX,2021,453,430,23,5.1,24
"Motley County, TX",TX,2020,429,410,19,4.4,-38
"Motley County, TX",TX,2019,467,451,16,3.4,9
"Motley County, TX",TX,2018,458,441,17,3.7,-33
"Motley County, TX",TX,2017,491,473,18,3.7,-17
"Motley County, TX",TX,2016,508,490,18,3.5,15
"Motley County, TX",TX,2015,493,475,18,3.7,-3
"Motley County, TX",TX,2014,496,475,21,4.2,-5
"Motley County, TX",TX,2013,501,471,30,6.0,-20
"Motley County, TX",TX,2012,521,490,31,6.0,-72
"Motley County, TX",TX,2011,593,551,42,7.1,-31
"Motley County, TX",TX,2010,624,585,39,6.3,0
"Moultrie County, IL",IL,2021,7337,7077,260,3.5,93
"Moultrie County, IL",IL,2020,7244,6870,374,5.2,-374
"Moultrie County, IL",IL,2019,7618,7376,242,3.2,88
"Moultrie County, IL",IL,2018,7530,7247,283,3.8,191
"Moultrie County, IL",IL,2017,7339,7055,284,3.9,-136
"Moultrie County, IL",IL,2016,7475,7133,342,4.6,89
"Moultrie County, IL",IL,2015,7386,7064,322,4.4,334
"Moultrie County, IL",IL,2014,7052,6667,385,5.5,-43
"Moultrie County, IL",IL,2013,7095,6588,507,7.1,-268
"Moultrie County, IL",IL,2012,7363,6837,526,7.1,-98
"Moultrie County, IL",IL,2011,7461,6894,567,7.6,-212
"Moultrie County, IL",IL,2010,7673,7012,661,8.6,0
"Mountrail County, ND",ND,2021,6486,6259,227,3.5,-455
"Mountrail County, ND",ND,2020,6941,6579,362,5.2,-591
"Mountrail County, ND",ND,2019,7532,7438,94,1.2,324
"Mountrail County, ND",ND,2018,7208,7105,103,1.4,114
"Mountrail County, ND",ND,2017,7094,6950,144,2.0,-23
"Mountrail County, ND",ND,2016,7117,6904,213,3.0,-962
"Mountrail County, ND",ND,2015,8079,7920,159,2.0,-878
"Mountrail County, ND",ND,2014,8957,8846,111,1.2,1041
"Mountrail County, ND",ND,2013,7916,7795,121,1.5,544
"Mountrail County, ND",ND,2012,7372,7257,115,1.6,890
"Mountrail County, ND",ND,2011,6482,6347,135,2.1,959
"Mountrail County, ND",ND,2010,5523,5381,142,2.6,0
"Mower County, MN",MN,2021,20169,19538,631,3.1,-787
"Mower County, MN",MN,2020,20956,19879,1077,5.1,322
"Mower County, MN",MN,2019,20634,19971,663,3.2,157
"Mower County, MN",MN,2018,20477,19882,595,2.9,-176
"Mower County, MN",MN,2017,20653,20065,588,2.8,147
"Mower County, MN",MN,2016,20506,19858,648,3.2,99
"Mower County, MN",MN,2015,20407,19738,669,3.3,83
"Mower County, MN",MN,2014,20324,19529,795,3.9,-170
"Mower County, MN",MN,2013,20494,19562,932,4.5,-190
"Mower County, MN",MN,2012,20684,19644,1040,5.0,-179
"Mower County, MN",MN,2011,20863,19677,1186,5.7,-60
"Mower County, MN",MN,2010,20923,19644,1279,6.1,0
"Muhlenberg County, KY",KY,2021,9822,9171,651,6.6,-91
"Muhlenberg County, KY",KY,2020,9913,9080,833,8.4,-591
"Muhlenberg County, KY",KY,2019,10504,9893,611,5.8,-32
"Muhlenberg County, KY",KY,2018,10536,9847,689,6.5,-709
"Muhlenberg County, KY",KY,2017,11245,10480,765,6.8,-116
"Muhlenberg County, KY",KY,2016,11361,10540,821,7.2,-142
"Muhlenberg County, KY",KY,2015,11503,10677,826,7.2,-866
"Muhlenberg County, KY",KY,2014,12369,11429,940,7.6,-597
"Muhlenberg County, KY",KY,2013,12966,11760,1206,9.3,545
"Muhlenberg County, KY",KY,2012,12421,11197,1224,9.9,-558
"Muhlenberg County, KY",KY,2011,12979,11647,1332,10.3,-133
"Muhlenberg County, KY",KY,2010,13112,11663,1449,11.1,0
"Multnomah County, OR",OR,2021,461936,436295,25641,5.6,5912
"Multnomah County, OR",OR,2020,456024,416679,39345,8.6,4677
"Multnomah County, OR",OR,2019,451347,436702,14645,3.2,2480
"Multnomah County, OR",OR,2018,448867,432846,16021,3.6,-1753
"Multnomah County, OR",OR,2017,450620,434508,16112,3.6,7759
"Multnomah County, OR",OR,2016,442861,424464,18397,4.2,12829
"Multnomah County, OR",OR,2015,430032,409444,20588,4.8,7861
"Multnomah County, OR",OR,2014,422171,397764,24407,5.8,7443
"Multnomah County, OR",OR,2013,414728,387011,27717,6.7,-7219
"Multnomah County, OR",OR,2012,421947,389862,32085,7.6,-3271
"Multnomah County, OR",OR,2011,425218,389284,35934,8.5,4560
"Multnomah County, OR",OR,2010,420658,379568,41090,9.8,0
"Murray County, GA",GA,2021,15477,14812,665,4.3,99
"Murray County, GA",GA,2020,15378,14230,1148,7.5,-265
"Murray County, GA",GA,2019,15643,14815,828,5.3,-391
"Murray County, GA",GA,2018,16034,15174,860,5.4,18
"Murray County, GA",GA,2017,16016,15021,995,6.2,371
"Murray County, GA",GA,2016,15645,14521,1124,7.2,-246
"Murray County, GA",GA,2015,15891,14700,1191,7.5,44
"Murray County, GA",GA,2014,15847,14358,1489,9.4,-17
"Murray County, GA",GA,2013,15864,14092,1772,11.2,-474
"Murray County, GA",GA,2012,16338,14277,2061,12.6,-679
"Murray County, GA",GA,2011,17017,14676,2341,13.8,-217
"Murray County, GA",GA,2010,17234,14831,2403,13.9,0
"Murray County, MN",MN,2021,4599,4424,175,3.8,-282
"Murray County, MN",MN,2020,4881,4624,257,5.3,-21
"Murray County, MN",MN,2019,4902,4679,223,4.5,0
"Murray County, MN",MN,2018,4902,4707,195,4.0,-5
"Murray County, MN",MN,2017,4907,4689,218,4.4,-46
"Murray County, MN",MN,2016,4953,4719,234,4.7,-122
"Murray County, MN",MN,2015,5075,4846,229,4.5,205
"Murray County, MN",MN,2014,4870,4627,243,5.0,28
"Murray County, MN",MN,2013,4842,4580,262,5.4,-159
"Murray County, MN",MN,2012,5001,4739,262,5.2,-49
"Murray County, MN",MN,2011,5050,4734,316,6.3,24
"Murray County, MN",MN,2010,5026,4680,346,6.9,0
"Murray County, OK",OK,2021,6097,5860,237,3.9,-13
"Murray County, OK",OK,2020,6110,5728,382,6.3,-186
"Murray County, OK",OK,2019,6296,6116,180,2.9,-166
"Murray County, OK",OK,2018,6462,6281,181,2.8,86
"Murray County, OK",OK,2017,6376,6152,224,3.5,38
"Murray County, OK",OK,2016,6338,6062,276,4.4,-424
"Murray County, OK",OK,2015,6762,6483,279,4.1,216
"Murray County, OK",OK,2014,6546,6281,265,4.0,80
"Murray County, OK",OK,2013,6466,6151,315,4.9,-185
"Murray County, OK",OK,2012,6651,6353,298,4.5,184
"Murray County, OK",OK,2011,6467,6164,303,4.7,155
"Murray County, OK",OK,2010,6312,5937,375,5.9,0
"Muscatine County, IA",IA,2021,20871,19890,981,4.7,-581
"Muscatine County, IA",IA,2020,21452,20215,1237,5.8,-821
"Muscatine County, IA",IA,2019,22273,21667,606,2.7,191
"Muscatine County, IA",IA,2018,22082,21497,585,2.6,3
"Muscatine County, IA",IA,2017,22079,21367,712,3.2,-469
"Muscatine County, IA",IA,2016,22548,21697,851,3.8,334
"Muscatine County, IA",IA,2015,22214,21364,850,3.8,97
"Muscatine County, IA",IA,2014,22117,21116,1001,4.5,392
"Muscatine County, IA",IA,2013,21725,20591,1134,5.2,399
"Muscatine County, IA",IA,2012,21326,20099,1227,5.8,-186
"Muscatine County, IA",IA,2011,21512,20068,1444,6.7,-264
"Muscatine County, IA",IA,2010,21776,19999,1777,8.2,0
"Muscogee County, GA",GA,2021,76629,72553,4076,5.3,-584
"Muscogee County, GA",GA,2020,77213,71219,5994,7.8,-701
"Muscogee County, GA",GA,2019,77914,74199,3715,4.8,-1077
"Muscogee County, GA",GA,2018,78991,74911,4080,5.2,-795
"Muscogee County, GA",GA,2017,79786,75013,4773,6.0,1348
"Muscogee County, GA",GA,2016,78438,73041,5397,6.9,414
"Muscogee County, GA",GA,2015,78024,72100,5924,7.6,-2687
"Muscogee County, GA",GA,2014,80711,73885,6826,8.5,-2314
"Muscogee County, GA",GA,2013,83025,75322,7703,9.3,-306
"Muscogee County, GA",GA,2012,83331,75280,8051,9.7,589
"Muscogee County, GA",GA,2011,82742,74480,8262,10.0,747
"Muscogee County, GA",GA,2010,81995,73575,8420,10.3,0
"Muskegon County, MI",MI,2021,75304,69663,5641,7.5,-2111
"Muskegon County, MI",MI,2020,77415,68203,9212,11.9,115
"Muskegon County, MI",MI,2019,77300,73939,3361,4.3,-809
"Muskegon County, MI",MI,2018,78109,74516,3593,4.6,214
"Muskegon County, MI",MI,2017,77895,73815,4080,5.2,236
"Muskegon County, MI",MI,2016,77659,73383,4276,5.5,-24
"Muskegon County, MI",MI,2015,77683,73101,4582,5.9,315
"Muskegon County, MI",MI,2014,77368,71415,5953,7.7,910
"Muskegon County, MI",MI,2013,76458,68958,7500,9.8,543
"Muskegon County, MI",MI,2012,75915,68384,7531,9.9,464
"Muskegon County, MI",MI,2011,75451,67161,8290,11.0,-1454
"Muskegon County, MI",MI,2010,76905,66050,10855,14.1,0
"Muskingum County, OH",OH,2021,40348,38273,2075,5.1,150
"Muskingum County, OH",OH,2020,40198,37072,3126,7.8,173
"Muskingum County, OH",OH,2019,40025,38050,1975,4.9,279
"Muskingum County, OH",OH,2018,39746,37646,2100,5.3,-266
"Muskingum County, OH",OH,2017,40012,37750,2262,5.7,115
"Muskingum County, OH",OH,2016,39897,37474,2423,6.1,957
"Muskingum County, OH",OH,2015,38940,36495,2445,6.3,-506
"Muskingum County, OH",OH,2014,39446,36643,2803,7.1,-482
"Muskingum County, OH",OH,2013,39928,36291,3637,9.1,-449
"Muskingum County, OH",OH,2012,40377,36680,3697,9.2,-815
"Muskingum County, OH",OH,2011,41192,36712,4480,10.9,-525
"Muskingum County, OH",OH,2010,41717,36461,5256,12.6,0
"Muskogee County, OK",OK,2021,28881,27629,1252,4.3,-118
"Muskogee County, OK",OK,2020,28999,27213,1786,6.2,-491
"Muskogee County, OK",OK,2019,29490,28405,1085,3.7,383
"Muskogee County, OK",OK,2018,29107,27988,1119,3.8,-314
"Muskogee County, OK",OK,2017,29421,28005,1416,4.8,-167
"Muskogee County, OK",OK,2016,29588,28033,1555,5.3,36
"Muskogee County, OK",OK,2015,29552,28071,1481,5.0,283
"Muskogee County, OK",OK,2014,29269,27650,1619,5.5,-389
"Muskogee County, OK",OK,2013,29658,27796,1862,6.3,-314
"Muskogee County, OK",OK,2012,29972,28023,1949,6.5,200
"Muskogee County, OK",OK,2011,29772,27677,2095,7.0,-32
"Muskogee County, OK",OK,2010,29804,27450,2354,7.9,0
"Musselshell County, MT",MT,2021,2354,2255,99,4.2,14
"Musselshell County, MT",MT,2020,2340,2200,140,6.0,36
"Musselshell County, MT",MT,2019,2304,2213,91,3.9,2
"Musselshell County, MT",MT,2018,2302,2203,99,4.3,-3
"Musselshell County, MT",MT,2017,2305,2200,105,4.6,11
"Musselshell County, MT",MT,2016,2294,2172,122,5.3,-116
"Musselshell County, MT",MT,2015,2410,2304,106,4.4,48
"Musselshell County, MT",MT,2014,2362,2266,96,4.1,-15
"Musselshell County, MT",MT,2013,2377,2259,118,5.0,-39
"Musselshell County, MT",MT,2012,2416,2291,125,5.2,87
"Musselshell County, MT",MT,2011,2329,2182,147,6.3,-54
"Musselshell County, MT",MT,2010,2383,2221,162,6.8,0
"Nacogdoches County, TX",TX,2021,28255,26714,1541,5.5,610
"Nacogdoches County, TX",TX,2020,27645,25828,1817,6.6,-186
"Nacogdoches County, TX",TX,2019,27831,26795,1036,3.7,-550
"Nacogdoches County, TX",TX,2018,28381,27267,1114,3.9,35
"Nacogdoches County, TX",TX,2017,28346,27131,1215,4.3,-376
"Nacogdoches County, TX",TX,2016,28722,27375,1347,4.7,580
"Nacogdoches County, TX",TX,2015,28142,26811,1331,4.7,-446
"Nacogdoches County, TX",TX,2014,28588,27041,1547,5.4,-583
"Nacogdoches County, TX",TX,2013,29171,27256,1915,6.6,-330
"Nacogdoches County, TX",TX,2012,29501,27554,1947,6.6,-1104
"Nacogdoches County, TX",TX,2011,30605,28398,2207,7.2,-219
"Nacogdoches County, TX",TX,2010,30824,28621,2203,7.1,0
"Naguabo Municipio, PR",PR,2021,8818,8162,656,7.4,
"Naguabo Municipio, PR",PR,2020,N.A.,N.A.,N.A.,N.A.,
"Naguabo Municipio, PR",PR,2019,8237,7509,728,8.8,80
"Naguabo Municipio, PR",PR,2018,8157,7254,903,11.1,144
"Naguabo Municipio, PR",PR,2017,8013,7120,893,11.1,-73
"Naguabo Municipio, PR",PR,2016,8086,7089,997,12.3,-2
"Naguabo Municipio, PR",PR,2015,8088,7023,1065,13.2,-200
"Naguabo Municipio, PR",PR,2014,8288,7026,1262,15.2,-230
"Naguabo Municipio, PR",PR,2013,8518,7126,1392,16.3,-48
"Naguabo Municipio, PR",PR,2012,8566,7105,1461,17.1,-143
"Naguabo Municipio, PR",PR,2011,8709,7033,1676,19.2,-390
"Naguabo Municipio, PR",PR,2010,9099,7152,1947,21.4,0
"Nance County, NE",NE,2021,1972,1934,38,1.9,-3
"Nance County, NE",NE,2020,1975,1913,62,3.1,-32
"Nance County, NE",NE,2019,2007,1946,61,3.0,-24
"Nance County, NE",NE,2018,2031,1981,50,2.5,-6
"Nance County, NE",NE,2017,2037,1986,51,2.5,26
"Nance County, NE",NE,2016,2011,1956,55,2.7,-62
"Nance County, NE",NE,2015,2073,2022,51,2.5,1
"Nance County, NE",NE,2014,2072,2016,56,2.7,0
"Nance County, NE",NE,2013,2072,2007,65,3.1,-22
"Nance County, NE",NE,2012,2094,2026,68,3.2,30
"Nance County, NE",NE,2011,2064,1988,76,3.7,87
"Nance County, NE",NE,2010,1977,1898,79,4.0,0
"Nantucket County/town, MA",MA,2021,7733,7138,595,7.7,111
"Nantucket County/town, MA",MA,2020,7622,6775,847,11.1,-100
"Nantucket County/town, MA",MA,2019,7722,7383,339,4.4,122
"Nantucket County/town, MA",MA,2018,7600,7255,345,4.5,332
"Nantucket County/town, MA",MA,2017,7268,6939,329,4.5,218
"Nantucket County/town, MA",MA,2016,7050,6727,323,4.6,78
"Nantucket County/town, MA",MA,2015,6972,6597,375,5.4,4
"Nantucket County/town, MA",MA,2014,6968,6537,431,6.2,367
"Nantucket County/town, MA",MA,2013,6601,6124,477,7.2,177
"Nantucket County/town, MA",MA,2012,6424,5920,504,7.8,188
"Nantucket County/town, MA",MA,2011,6236,5701,535,8.6,69
"Nantucket County/town, MA",MA,2010,6167,5590,577,9.4,0
"Napa County, CA",CA,2021,68437,64305,4132,6.0,-340
"Napa County, CA",CA,2020,68777,62575,6202,9.0,-4565
"Napa County, CA",CA,2019,73342,71210,2132,2.9,-428
"Napa County, CA",CA,2018,73770,71572,2198,3.0,533
"Napa County, CA",CA,2017,73237,70549,2688,3.7,296
"Napa County, CA",CA,2016,72941,69799,3142,4.3,-776
"Napa County, CA",CA,2015,73717,70290,3427,4.6,458
"Napa County, CA",CA,2014,73259,69047,4212,5.7,720
"Napa County, CA",CA,2013,72539,67444,5095,7.0,894
"Napa County, CA",CA,2012,71645,65492,6153,8.6,1017
"Napa County, CA",CA,2011,70628,63595,7033,10.0,384
"Napa County, CA",CA,2010,70244,62830,7414,10.6,0
"Naranjito Municipio, PR",PR,2021,7691,6884,807,10.5,
"Naranjito Municipio, PR",PR,2020,N.A.,N.A.,N.A.,N.A.,
"Naranjito Municipio, PR",PR,2019,7080,6483,597,8.4,16
"Naranjito Municipio, PR",PR,2018,7064,6371,693,9.8,-91
"Naranjito Municipio, PR",PR,2017,7155,6308,847,11.8,-105
"Naranjito Municipio, PR",PR,2016,7260,6319,941,13.0,-47
"Naranjito Municipio, PR",PR,2015,7307,6308,999,13.7,-171
"Naranjito Municipio, PR",PR,2014,7478,6233,1245,16.6,-192
"Naranjito Municipio, PR",PR,2013,7670,6403,1267,16.5,-104
"Naranjito Municipio, PR",PR,2012,7774,6460,1314,16.9,-161
"Naranjito Municipio, PR",PR,2011,7935,6415,1520,19.2,-304
"Naranjito Municipio, PR",PR,2010,8239,6570,1669,20.3,0
"Nash County, NC",NC,2021,42040,39381,2659,6.3,635
"Nash County, NC",NC,2020,41405,38076,3329,8.0,-1397
"Nash County, NC",NC,2019,42802,40772,2030,4.7,17
"Nash County, NC",NC,2018,42785,40576,2209,5.2,-262
"Nash County, NC",NC,2017,43047,40453,2594,6.0,-745
"Nash County, NC",NC,2016,43792,40909,2883,6.6,-17
"Nash County, NC",NC,2015,43809,40658,3151,7.2,-408
"Nash County, NC",NC,2014,44217,40795,3422,7.7,-1161
"Nash County, NC",NC,2013,45378,40816,4562,10.1,-1152
"Nash County, NC",NC,2012,46530,41042,5488,11.8,-634
"Nash County, NC",NC,2011,47164,41286,5878,12.5,-452
"Nash County, NC",NC,2010,47616,41699,5917,12.4,0
"Nassau County, FL",FL,2021,42729,41268,1461,3.4,1176
"Nassau County, FL",FL,2020,41553,39035,2518,6.1,56
"Nassau County, FL",FL,2019,41497,40248,1249,3.0,1306
"Nassau County, FL",FL,2018,40191,38856,1335,3.3,1356
"Nassau County, FL",FL,2017,38835,37298,1537,4.0,938
"Nassau County, FL",FL,2016,37897,36176,1721,4.5,1194
"Nassau County, FL",FL,2015,36703,34798,1905,5.2,495
"Nassau County, FL",FL,2014,36208,33989,2219,6.1,134
"Nassau County, FL",FL,2013,36074,33542,2532,7.0,359
"Nassau County, FL",FL,2012,35715,32750,2965,8.3,-91
"Nassau County, FL",FL,2011,35806,32372,3434,9.6,315
"Nassau County, FL",FL,2010,35491,31842,3649,10.3,0
"Nassau County, NY",NY,2021,708286,676654,31632,4.5,-1962
"Nassau County, NY",NY,2020,710248,653335,56913,8.0,-16836
"Nassau County, NY",NY,2019,727084,703155,23929,3.3,5340
"Nassau County, NY",NY,2018,721744,696501,25243,3.5,2232
"Nassau County, NY",NY,2017,719512,690355,29157,4.1,19373
"Nassau County, NY",NY,2016,700139,672300,27839,4.0,3745
"Nassau County, NY",NY,2015,696394,666770,29624,4.3,11586
"Nassau County, NY",NY,2014,684808,651793,33015,4.8,-11228
"Nassau County, NY",NY,2013,696036,653821,42215,6.1,3489
"Nassau County, NY",NY,2012,692547,643054,49493,7.1,8173
"Nassau County, NY",NY,2011,684374,637173,47201,6.9,-7599
"Nassau County, NY",NY,2010,691973,641573,50400,7.3,0
"Natchitoches Parish, LA",LA,2021,16341,15575,766,4.7,258
"Natchitoches Parish, LA",LA,2020,16083,14903,1180,7.3,-330
"Natchitoches Parish, LA",LA,2019,16413,15456,957,5.8,-67
"Natchitoches Parish, LA",LA,2018,16480,15530,950,5.8,112
"Natchitoches Parish, LA",LA,2017,16368,15390,978,6.0,-365
"Natchitoches Parish, LA",LA,2016,16733,15606,1127,6.7,232
"Natchitoches Parish, LA",LA,2015,16501,15256,1245,7.5,-317
"Natchitoches Parish, LA",LA,2014,16818,15539,1279,7.6,2
"Natchitoches Parish, LA",LA,2013,16816,15474,1342,8.0,724
"Natchitoches Parish, LA",LA,2012,16092,14718,1374,8.5,-96
"Natchitoches Parish, LA",LA,2011,16188,14766,1422,8.8,-379
"Natchitoches Parish, LA",LA,2010,16567,15163,1404,8.5,0
"Natrona County, WY",WY,2021,39057,36688,2369,6.1,-1024
"Natrona County, WY",WY,2020,40081,36982,3099,7.7,-38
"Natrona County, WY",WY,2019,40119,38500,1619,4.0,668
"Natrona County, WY",WY,2018,39451,37622,1829,4.6,-196
"Natrona County, WY",WY,2017,39647,37509,2138,5.4,-1369
"Natrona County, WY",WY,2016,41016,38073,2943,7.2,-1466
"Natrona County, WY",WY,2015,42482,40431,2051,4.8,-381
"Natrona County, WY",WY,2014,42863,41051,1812,4.2,378
"Natrona County, WY",WY,2013,42485,40539,1946,4.6,584
"Natrona County, WY",WY,2012,41901,39714,2187,5.2,1288
"Natrona County, WY",WY,2011,40613,37995,2618,6.4,889
"Natrona County, WY",WY,2010,39724,36745,2979,7.5,0
"Navajo County, AZ",AZ,2021,39276,36704,2572,6.5,90
"Navajo County, AZ",AZ,2020,39186,35304,3882,9.9,-303
"Navajo County, AZ",AZ,2019,39489,36514,2975,7.5,366
"Navajo County, AZ",AZ,2018,39123,36124,2999,7.7,-586
"Navajo County, AZ",AZ,2017,39709,36633,3076,7.7,-1802
"Navajo County, AZ",AZ,2016,41511,38030,3481,8.4,580
"Navajo County, AZ",AZ,2015,40931,36963,3968,9.7,-1012
"Navajo County, AZ",AZ,2014,41943,37291,4652,11.1,-491
"Navajo County, AZ",AZ,2013,42434,36681,5753,13.6,-889
"Navajo County, AZ",AZ,2012,43323,37200,6123,14.1,-217
"Navajo County, AZ",AZ,2011,43540,37120,6420,14.7,-438
"Navajo County, AZ",AZ,2010,43978,37557,6421,14.6,0
"Navarro County, TX",TX,2021,23685,22479,1206,5.1,543
"Navarro County, TX",TX,2020,23142,21711,1431,6.2,-621
"Navarro County, TX",TX,2019,23763,22988,775,3.3,339
"Navarro County, TX",TX,2018,23424,22552,872,3.7,776
"Navarro County, TX",TX,2017,22648,21750,898,4.0,-127
"Navarro County, TX",TX,2016,22775,21822,953,4.2,-123
"Navarro County, TX",TX,2015,22898,21926,972,4.2,-212
"Navarro County, TX",TX,2014,23110,21888,1222,5.3,-235
"Navarro County, TX",TX,2013,23345,21808,1537,6.6,154
"Navarro County, TX",TX,2012,23191,21517,1674,7.2,113
"Navarro County, TX",TX,2011,23078,21149,1929,8.4,271
"Navarro County, TX",TX,2010,22807,20898,1909,8.4,0
"Nelson County, KY",KY,2021,23223,22213,1010,4.3,527
"Nelson County, KY",KY,2020,22696,21163,1533,6.8,-556
"Nelson County, KY",KY,2019,23252,22249,1003,4.3,560
"Nelson County, KY",KY,2018,22692,21740,952,4.2,407
"Nelson County, KY",KY,2017,22285,21322,963,4.3,579
"Nelson County, KY",KY,2016,21706,20731,975,4.5,690
"Nelson County, KY",KY,2015,21016,19963,1053,5.0,-297
"Nelson County, KY",KY,2014,21313,20016,1297,6.1,-375
"Nelson County, KY",KY,2013,21688,20066,1622,7.5,-221
"Nelson County, KY",KY,2012,21909,20086,1823,8.3,50
"Nelson County, KY",KY,2011,21859,19543,2316,10.6,-228
"Nelson County, KY",KY,2010,22087,19595,2492,11.3,0
"Nelson County, ND",ND,2021,1395,1343,52,3.7,-8
"Nelson County, ND",ND,2020,1403,1340,63,4.5,-6
"Nelson County, ND",ND,2019,1409,1369,40,2.8,-25
"Nelson County, ND",ND,2018,1434,1391,43,3.0,-73
"Nelson County, ND",ND,2017,1507,1461,46,3.1,-24
"Nelson County, ND",ND,2016,1531,1479,52,3.4,26
"Nelson County, ND",ND,2015,1505,1449,56,3.7,-11
"Nelson County, ND",ND,2014,1516,1460,56,3.7,-21
"Nelson County, ND",ND,2013,1537,1471,66,4.3,0
"Nelson County, ND",ND,2012,1537,1476,61,4.0,-122
"Nelson County, ND",ND,2011,1659,1589,70,4.2,-35
"Nelson County, ND",ND,2010,1694,1627,67,4.0,0
"Nelson County, VA",VA,2021,7106,6857,249,3.5,-123
"Nelson County, VA",VA,2020,7229,6822,407,5.6,-413
"Nelson County, VA",VA,2019,7642,7434,208,2.7,250
"Nelson County, VA",VA,2018,7392,7165,227,3.1,37
"Nelson County, VA",VA,2017,7355,7100,255,3.5,109
"Nelson County, VA",VA,2016,7246,6989,257,3.5,-50
"Nelson County, VA",VA,2015,7296,7003,293,4.0,-122
"Nelson County, VA",VA,2014,7418,7060,358,4.8,59
"Nelson County, VA",VA,2013,7359,6963,396,5.4,-94
"Nelson County, VA",VA,2012,7453,7028,425,5.7,-140
"Nelson County, VA",VA,2011,7593,7113,480,6.3,7
"Nelson County, VA",VA,2010,7586,7031,555,7.3,0
"Nemaha County, KS",KS,2021,5553,5455,98,1.8,-27
"Nemaha County, KS",KS,2020,5580,5428,152,2.7,187
"Nemaha County, KS",KS,2019,5393,5247,146,2.7,-105
"Nemaha County, KS",KS,2018,5498,5374,124,2.3,-99
"Nemaha County, KS",KS,2017,5597,5463,134,2.4,-326
"Nemaha County, KS",KS,2016,5923,5765,158,2.7,-32
"Nemaha County, KS",KS,2015,5955,5803,152,2.6,98
"Nemaha County, KS",KS,2014,5857,5691,166,2.8,21
"Nemaha County, KS",KS,2013,5836,5635,201,3.4,-184
"Nemaha County, KS",KS,2012,6020,5803,217,3.6,89
"Nemaha County, KS",KS,2011,5931,5705,226,3.8,109
"Nemaha County, KS",KS,2010,5822,5575,247,4.2,0
"Nemaha County, NE",NE,2021,3662,3581,81,2.2,37
"Nemaha County, NE",NE,2020,3625,3498,127,3.5,-42
"Nemaha County, NE",NE,2019,3667,3534,133,3.6,19
"Nemaha County, NE",NE,2018,3648,3520,128,3.5,11
"Nemaha County, NE",NE,2017,3637,3494,143,3.9,0
"Nemaha County, NE",NE,2016,3637,3505,132,3.6,-67
"Nemaha County, NE",NE,2015,3704,3569,135,3.6,-24
"Nemaha County, NE",NE,2014,3728,3586,142,3.8,-82
"Nemaha County, NE",NE,2013,3810,3624,186,4.9,-67
"Nemaha County, NE",NE,2012,3877,3694,183,4.7,-86
"Nemaha County, NE",NE,2011,3963,3765,198,5.0,117
"Nemaha County, NE",NE,2010,3846,3638,208,5.4,0
"Neosho County, KS",KS,2021,6093,5834,259,4.3,-124
"Neosho County, KS",KS,2020,6217,5833,384,6.2,67
"Neosho County, KS",KS,2019,6150,5870,280,4.6,133
"Neosho County, KS",KS,2018,6017,5732,285,4.7,-54
"Neosho County, KS",KS,2017,6071,5753,318,5.2,-12
"Neosho County, KS",KS,2016,6083,5648,435,7.2,-202
"Neosho County, KS",KS,2015,6285,5818,467,7.4,-117
"Neosho County, KS",KS,2014,6402,5923,479,7.5,-347
"Neosho County, KS",KS,2013,6749,6174,575,8.5,-173
"Neosho County, KS",KS,2012,6922,6313,609,8.8,-513
"Neosho County, KS",KS,2011,7435,6752,683,9.2,27
"Neosho County, KS",KS,2010,7408,6657,751,10.1,0
"Neshoba County, MS",MS,2021,10035,9472,563,5.6,-211
"Neshoba County, MS",MS,2020,10246,9313,933,9.1,-97
"Neshoba County, MS",MS,2019,10343,9730,613,5.9,191
"Neshoba County, MS",MS,2018,10152,9629,523,5.2,-212
"Neshoba County, MS",MS,2017,10364,9813,551,5.3,-288
"Neshoba County, MS",MS,2016,10652,10027,625,5.9,60
"Neshoba County, MS",MS,2015,10592,9933,659,6.2,-151
"Neshoba County, MS",MS,2014,10743,10007,736,6.9,-221
"Neshoba County, MS",MS,2013,10964,10114,850,7.8,-813
"Neshoba County, MS",MS,2012,11777,10813,964,8.2,-224
"Neshoba County, MS",MS,2011,12001,10908,1093,9.1,172
"Neshoba County, MS",MS,2010,11829,10634,1195,10.1,0
"Ness County, KS",KS,2021,1312,1283,29,2.2,-36
"Ness County, KS",KS,2020,1348,1304,44,3.3,8
"Ness County, KS",KS,2019,1340,1307,33,2.5,1
"Ness County, KS",KS,2018,1339,1304,35,2.6,-24
"Ness County, KS",KS,2017,1363,1324,39,2.9,-66
"Ness County, KS",KS,2016,1429,1380,49,3.4,-113
"Ness County, KS",KS,2015,1542,1491,51,3.3,-73
"Ness County, KS",KS,2014,1615,1572,43,2.7,10
"Ness County, KS",KS,2013,1605,1556,49,3.1,-27
"Ness County, KS",KS,2012,1632,1579,53,3.2,1
"Ness County, KS",KS,2011,1631,1577,54,3.3,13
"Ness County, KS",KS,2010,1618,1555,63,3.9,0
"Nevada County, AR",AR,2021,3373,3237,136,4.0,-172
"Nevada County, AR",AR,2020,3545,3336,209,5.9,-110
"Nevada County, AR",AR,2019,3655,3514,141,3.9,9
"Nevada County, AR",AR,2018,3646,3521,125,3.4,43
"Nevada County, AR",AR,2017,3603,3475,128,3.6,-47
"Nevada County, AR",AR,2016,3650,3515,135,3.7,-25
"Nevada County, AR",AR,2015,3675,3495,180,4.9,-57
"Nevada County, AR",AR,2014,3732,3513,219,5.9,-80
"Nevada County, AR",AR,2013,3812,3526,286,7.5,-344
"Nevada County, AR",AR,2012,4156,3847,309,7.4,-16
"Nevada County, AR",AR,2011,4172,3796,376,9.0,151
"Nevada County, AR",AR,2010,4021,3635,386,9.6,0
"Nevada County, CA",CA,2021,47089,44459,2630,5.6,392
"Nevada County, CA",CA,2020,46697,42871,3826,8.2,-1780
"Nevada County, CA",CA,2019,48477,46830,1647,3.4,-84
"Nevada County, CA",CA,2018,48561,46844,1717,3.5,273
"Nevada County, CA",CA,2017,48288,46289,1999,4.1,141
"Nevada County, CA",CA,2016,48147,45838,2309,4.8,141
"Nevada County, CA",CA,2015,48006,45388,2618,5.5,260
"Nevada County, CA",CA,2014,47746,44581,3165,6.6,-248
"Nevada County, CA",CA,2013,47994,44056,3938,8.2,-263
"Nevada County, CA",CA,2012,48257,43474,4783,9.9,-684
"Nevada County, CA",CA,2011,48941,43418,5523,11.3,2
"Nevada County, CA",CA,2010,48939,43068,5871,12.0,0
"New Castle County, DE",DE,2021,303427,287298,16129,5.3,4646
"New Castle County, DE",DE,2020,298781,276479,22302,7.5,55
"New Castle County, DE",DE,2019,298726,287970,10756,3.6,1931
"New Castle County, DE",DE,2018,296795,285953,10842,3.7,1946
"New Castle County, DE",DE,2017,294849,281937,12912,4.4,3092
"New Castle County, DE",DE,2016,291757,278853,12904,4.4,2268
"New Castle County, DE",DE,2015,289489,276051,13438,4.6,6566
"New Castle County, DE",DE,2014,282923,267664,15259,5.4,5712
"New Castle County, DE",DE,2013,277211,259476,17735,6.4,-1380
"New Castle County, DE",DE,2012,278591,259505,19086,6.9,833
"New Castle County, DE",DE,2011,277758,257356,20402,7.3,5108
"New Castle County, DE",DE,2010,272650,249470,23180,8.5,0
"New Hanover County, NC",NC,2021,122709,117512,5197,4.2,4418
"New Hanover County, NC",NC,2020,118291,109989,8302,7.0,-3545
"New Hanover County, NC",NC,2019,121836,117493,4343,3.6,2308
"New Hanover County, NC",NC,2018,119528,114909,4619,3.9,1815
"New Hanover County, NC",NC,2017,117713,112848,4865,4.1,2023
"New Hanover County, NC",NC,2016,115690,110226,5464,4.7,2424
"New Hanover County, NC",NC,2015,113266,107283,5983,5.3,2724
"New Hanover County, NC",NC,2014,110542,104191,6351,5.7,817
"New Hanover County, NC",NC,2013,109725,101673,8052,7.3,-36
"New Hanover County, NC",NC,2012,109761,100052,9709,8.8,1688
"New Hanover County, NC",NC,2011,108073,97757,10316,9.5,86
"New Hanover County, NC",NC,2010,107987,97615,10372,9.6,0
"New Haven County, CT",CT,2021,453791,424057,29734,6.6,-8717
"New Haven County, CT",CT,2020,462508,426061,36447,7.9,-9041
"New Haven County, CT",CT,2019,471549,454140,17409,3.7,4481
"New Haven County, CT",CT,2018,467068,447589,19479,4.2,2103
"New Haven County, CT",CT,2017,464965,442959,22006,4.7,7962
"New Haven County, CT",CT,2016,457003,433288,23715,5.2,528
"New Haven County, CT",CT,2015,456475,428605,27870,6.1,-184
"New Haven County, CT",CT,2014,456659,423672,32987,7.2,4540
"New Haven County, CT",CT,2013,452119,412914,39205,8.7,-4839
"New Haven County, CT",CT,2012,456958,415358,41600,9.1,-5662
"New Haven County, CT",CT,2011,462620,416898,45722,9.9,221
"New Haven County, CT",CT,2010,462399,413886,48513,10.5,0
"New Kent County, VA",VA,2021,12555,12184,371,3.0,-212
"New Kent County, VA",VA,2020,12767,12190,577,4.5,-233
"New Kent County, VA",VA,2019,13000,12696,304,2.3,479
"New Kent County, VA",VA,2018,12521,12185,336,2.7,426
"New Kent County, VA",VA,2017,12095,11714,381,3.2,405
"New Kent County, VA",VA,2016,11690,11300,390,3.3,432
"New Kent County, VA",VA,2015,11258,10835,423,3.8,142
"New Kent County, VA",VA,2014,11116,10623,493,4.4,328
"New Kent County, VA",VA,2013,10788,10257,531,4.9,188
"New Kent County, VA",VA,2012,10600,10021,579,5.5,177
"New Kent County, VA",VA,2011,10423,9757,666,6.4,113
"New Kent County, VA",VA,2010,10310,9546,764,7.4,0
"New London County, CT",CT,2021,129504,120631,8873,6.9,-4239
"New London County, CT",CT,2020,133743,121093,12650,9.5,-6075
"New London County, CT",CT,2019,139818,135051,4767,3.4,696
"New London County, CT",CT,2018,139122,133887,5235,3.8,-285
"New London County, CT",CT,2017,139407,133507,5900,4.2,3226
"New London County, CT",CT,2016,136181,129595,6586,4.8,-200
"New London County, CT",CT,2015,136381,128427,7954,5.8,-453
"New London County, CT",CT,2014,136834,127534,9300,6.8,-293
"New London County, CT",CT,2013,137127,125765,11362,8.3,-2481
"New London County, CT",CT,2012,139608,127497,12111,8.7,-3475
"New London County, CT",CT,2011,143083,130113,12970,9.1,-749
"New London County, CT",CT,2010,143832,130327,13505,9.4,0
"New Madrid County, MO",MO,2021,8326,7930,396,4.8,-71
"New Madrid County, MO",MO,2020,8397,7910,487,5.8,238
"New Madrid County, MO",MO,2019,8159,7827,332,4.1,143
"New Madrid County, MO",MO,2018,8016,7642,374,4.7,23
"New Madrid County, MO",MO,2017,7993,7469,524,6.6,-237
"New Madrid County, MO",MO,2016,8230,7468,762,9.3,-301
"New Madrid County, MO",MO,2015,8531,7990,541,6.3,96
"New Madrid County, MO",MO,2014,8435,7806,629,7.5,169
"New Madrid County, MO",MO,2013,8266,7610,656,7.9,182
"New Madrid County, MO",MO,2012,8084,7409,675,8.3,-116
"New Madrid County, MO",MO,2011,8200,7386,814,9.9,10
"New Madrid County, MO",MO,2010,8190,7380,810,9.9,0
"New York County, NY",NY,2021,894457,826846,67611,7.6,-7811
"New York County, NY",NY,2020,902268,815372,86896,9.6,-67736
"New York County, NY",NY,2019,970004,937012,32992,3.4,10099
"New York County, NY",NY,2018,959905,924960,34945,3.6,1182
"New York County, NY",NY,2017,958723,920354,38369,4.0,50464
"New York County, NY",NY,2016,908259,867324,40935,4.5,2182
"New York County, NY",NY,2015,906077,862865,43212,4.8,837
"New York County, NY",NY,2014,905240,851252,53988,6.0,4640
"New York County, NY",NY,2013,900600,833170,67430,7.5,6027
"New York County, NY",NY,2012,894573,822146,72427,8.1,9643
"New York County, NY",NY,2011,884930,815453,69477,7.9,-2935
"New York County, NY",NY,2010,887865,811259,76606,8.6,0
"Newaygo County, MI",MI,2021,22817,21533,1284,5.6,-457
"Newaygo County, MI",MI,2020,23274,21172,2102,9.0,-156
"Newaygo County, MI",MI,2019,23430,22423,1007,4.3,217
"Newaygo County, MI",MI,2018,23213,22190,1023,4.4,-77
"Newaygo County, MI",MI,2017,23290,22159,1131,4.9,-104
"Newaygo County, MI",MI,2016,23394,22239,1155,4.9,204
"Newaygo County, MI",MI,2015,23190,21906,1284,5.5,518
"Newaygo County, MI",MI,2014,22672,21039,1633,7.2,571
"Newaygo County, MI",MI,2013,22101,20165,1936,8.8,2
"Newaygo County, MI",MI,2012,22099,20096,2003,9.1,-308
"Newaygo County, MI",MI,2011,22407,20120,2287,10.2,-355
"Newaygo County, MI",MI,2010,22762,19965,2797,12.3,0
"Newberry County, SC",SC,2021,19262,18628,634,3.3,462
"Newberry County, SC",SC,2020,18800,17929,871,4.6,125
"Newberry County, SC",SC,2019,18675,18190,485,2.6,192
"Newberry County, SC",SC,2018,18483,17921,562,3.0,463
"Newberry County, SC",SC,2017,18020,17281,739,4.1,-1115
"Newberry County, SC",SC,2016,19135,18303,832,4.3,249
"Newberry County, SC",SC,2015,18886,17895,991,5.2,329
"Newberry County, SC",SC,2014,18557,17524,1033,5.6,564
"Newberry County, SC",SC,2013,17993,16721,1272,7.1,-268
"Newberry County, SC",SC,2012,18261,16683,1578,8.6,-399
"Newberry County, SC",SC,2011,18660,16752,1908,10.2,-78
"Newberry County, SC",SC,2010,18738,16687,2051,10.9,0
"Newport County, RI",RI,2021,45042,42827,2215,4.9,569
"Newport County, RI",RI,2020,44473,40912,3561,8.0,-797
"Newport County, RI",RI,2019,45270,43864,1406,3.1,-213
"Newport County, RI",RI,2018,45483,43867,1616,3.6,-138
"Newport County, RI",RI,2017,45621,43823,1798,3.9,1390
"Newport County, RI",RI,2016,44231,42145,2086,4.7,87
"Newport County, RI",RI,2015,44144,41740,2404,5.4,13
"Newport County, RI",RI,2014,44131,41069,3062,6.9,-332
"Newport County, RI",RI,2013,44463,40598,3865,8.7,102
"Newport County, RI",RI,2012,44361,40313,4048,9.1,-245
"Newport County, RI",RI,2011,44606,40127,4479,10.0,-810
"Newport County, RI",RI,2010,45416,40701,4715,10.4,0
"Newport News city, VA",VA,2021,86364,81527,4837,5.6,-3210
"Newport News city, VA",VA,2020,89574,81831,7743,8.6,-986
"Newport News city, VA",VA,2019,90560,87466,3094,3.4,1117
"Newport News city, VA",VA,2018,89443,86228,3215,3.6,-347
"Newport News city, VA",VA,2017,89790,85701,4089,4.6,854
"Newport News city, VA",VA,2016,88936,84452,4484,5.0,-207
"Newport News city, VA",VA,2015,89143,84369,4774,5.4,-1852
"Newport News city, VA",VA,2014,90995,85403,5592,6.1,532
"Newport News city, VA",VA,2013,90463,84482,5981,6.6,591
"Newport News city, VA",VA,2012,89872,83269,6603,7.3,-678
"Newport News city, VA",VA,2011,90550,83192,7358,8.1,-272
"Newport News city, VA",VA,2010,90822,83062,7760,8.5,0
"Newton County, AR",AR,2021,3182,3085,97,3.0,-4
"Newton County, AR",AR,2020,3186,3023,163,5.1,-137
"Newton County, AR",AR,2019,3323,3209,114,3.4,22
"Newton County, AR",AR,2018,3301,3191,110,3.3,-21
"Newton County, AR",AR,2017,3322,3201,121,3.6,-95
"Newton County, AR",AR,2016,3417,3284,133,3.9,8
"Newton County, AR",AR,2015,3409,3246,163,4.8,21
"Newton County, AR",AR,2014,3388,3195,193,5.7,-123
"Newton County, AR",AR,2013,3511,3274,237,6.8,-133
"Newton County, AR",AR,2012,3644,3387,257,7.1,-141
"Newton County, AR",AR,2011,3785,3515,270,7.1,-3
"Newton County, AR",AR,2010,3788,3536,252,6.7,0
"Newton County, GA",GA,2021,53410,51064,2346,4.4,1287
"Newton County, GA",GA,2020,52123,48448,3675,7.1,-811
"Newton County, GA",GA,2019,52934,50793,2141,4.0,852
"Newton County, GA",GA,2018,52082,49719,2363,4.5,351
"Newton County, GA",GA,2017,51731,48957,2774,5.4,1725
"Newton County, GA",GA,2016,50006,46972,3034,6.1,2115
"Newton County, GA",GA,2015,47891,44597,3294,6.9,20
"Newton County, GA",GA,2014,47871,43929,3942,8.2,-131
"Newton County, GA",GA,2013,48002,43372,4630,9.6,-128
"Newton County, GA",GA,2012,48130,42907,5223,10.9,-171
"Newton County, GA",GA,2011,48301,42380,5921,12.3,163
"Newton County, GA",GA,2010,48138,41951,6187,12.9,0
"Newton County, IN",IN,2021,6526,6280,246,3.8,-31
"Newton County, IN",IN,2020,6557,6100,457,7.0,-362
"Newton County, IN",IN,2019,6919,6635,284,4.1,-143
"Newton County, IN",IN,2018,7062,6759,303,4.3,-11
"Newton County, IN",IN,2017,7073,6737,336,4.8,30
"Newton County, IN",IN,2016,7043,6655,388,5.5,83
"Newton County, IN",IN,2015,6960,6558,402,5.8,9
"Newton County, IN",IN,2014,6951,6468,483,6.9,35
"Newton County, IN",IN,2013,6916,6309,607,8.8,-10
"Newton County, IN",IN,2012,6926,6272,654,9.4,-79
"Newton County, IN",IN,2011,7005,6327,678,9.7,-70
"Newton County, IN",IN,2010,7075,6293,782,11.1,0
"Newton County, MO",MO,2021,27045,26014,1031,3.8,465
"Newton County, MO",MO,2020,26580,25048,1532,5.8,-469
"Newton County, MO",MO,2019,27049,26210,839,3.1,25
"Newton County, MO",MO,2018,27024,26217,807,3.0,-290
"Newton County, MO",MO,2017,27314,26321,993,3.6,-872
"Newton County, MO",MO,2016,28186,26960,1226,4.3,-80
"Newton County, MO",MO,2015,28266,26948,1318,4.7,-66
"Newton County, MO",MO,2014,28332,26796,1536,5.4,-519
"Newton County, MO",MO,2013,28851,27098,1753,6.1,-337
"Newton County, MO",MO,2012,29188,27332,1856,6.4,352
"Newton County, MO",MO,2011,28836,26490,2346,8.1,200
"Newton County, MO",MO,2010,28636,26083,2553,8.9,0
"Newton County, MS",MS,2021,8146,7703,443,5.4,206
"Newton County, MS",MS,2020,7940,7324,616,7.8,-434
"Newton County, MS",MS,2019,8374,7899,475,5.7,-384
"Newton County, MS",MS,2018,8758,8328,430,4.9,-142
"Newton County, MS",MS,2017,8900,8436,464,5.2,297
"Newton County, MS",MS,2016,8603,8085,518,6.0,-89
"Newton County, MS",MS,2015,8692,8152,540,6.2,-51
"Newton County, MS",MS,2014,8743,8154,589,6.7,-242
"Newton County, MS",MS,2013,8985,8319,666,7.4,-376
"Newton County, MS",MS,2012,9361,8631,730,7.8,-57
"Newton County, MS",MS,2011,9418,8568,850,9.0,197
"Newton County, MS",MS,2010,9221,8317,904,9.8,0
"Newton County, TX",TX,2021,4897,4387,510,10.4,-48
"Newton County, TX",TX,2020,4945,4394,551,11.1,-139
"Newton County, TX",TX,2019,5084,4763,321,6.3,-55
"Newton County, TX",TX,2018,5139,4791,348,6.8,-100
"Newton County, TX",TX,2017,5239,4818,421,8.0,-116
"Newton County, TX",TX,2016,5355,4930,425,7.9,-16
"Newton County, TX",TX,2015,5371,4964,407,7.6,-184
"Newton County, TX",TX,2014,5555,5089,466,8.4,-41
"Newton County, TX",TX,2013,5596,4990,606,10.8,-193
"Newton County, TX",TX,2012,5789,5153,636,11.0,-261
"Newton County, TX",TX,2011,6050,5255,795,13.1,100
"Newton County, TX",TX,2010,5950,5190,760,12.8,0
"Nez Perce County, ID",ID,2021,20918,20235,683,3.3,19
"Nez Perce County, ID",ID,2020,20899,19861,1038,5.0,-254
"Nez Perce County, ID",ID,2019,21153,20549,604,2.9,62
"Nez Perce County, ID",ID,2018,21091,20501,590,2.8,-217
"Nez Perce County, ID",ID,2017,21308,20698,610,2.9,447
"Nez Perce County, ID",ID,2016,20861,20198,663,3.2,220
"Nez Perce County, ID",ID,2015,20641,19932,709,3.4,366
"Nez Perce County, ID",ID,2014,20275,19531,744,3.7,-97
"Nez Perce County, ID",ID,2013,20372,19242,1130,5.5,427
"Nez Perce County, ID",ID,2012,19945,18770,1175,5.9,-124
"Nez Perce County, ID",ID,2011,20069,18822,1247,6.2,-47
"Nez Perce County, ID",ID,2010,20116,18811,1305,6.5,0
"Niagara County, NY",NY,2021,96212,90759,5453,5.7,-2994
"Niagara County, NY",NY,2020,99206,89223,9983,10.1,-1627
"Niagara County, NY",NY,2019,100833,96034,4799,4.8,-321
"Niagara County, NY",NY,2018,101154,95896,5258,5.2,-120
"Niagara County, NY",NY,2017,101274,95048,6226,6.1,993
"Niagara County, NY",NY,2016,100281,94345,5936,5.9,-689
"Niagara County, NY",NY,2015,100970,94705,6265,6.2,-445
"Niagara County, NY",NY,2014,101415,94233,7182,7.1,-3552
"Niagara County, NY",NY,2013,104967,95856,9111,8.7,-654
"Niagara County, NY",NY,2012,105621,95634,9987,9.5,-151
"Niagara County, NY",NY,2011,105772,96025,9747,9.2,-2217
"Niagara County, NY",NY,2010,107989,97385,10604,9.8,0
"Nicholas County, KY",KY,2021,3314,3171,143,4.3,43
"Nicholas County, KY",KY,2020,3271,3051,220,6.7,-44
"Nicholas County, KY",KY,2019,3315,3176,139,4.2,34
"Nicholas County, KY",KY,2018,3281,3134,147,4.5,-34
"Nicholas County, KY",KY,2017,3315,3133,182,5.5,96
"Nicholas County, KY",KY,2016,3219,3036,183,5.7,44
"Nicholas County, KY",KY,2015,3175,2978,197,6.2,-278
"Nicholas County, KY",KY,2014,3453,3187,266,7.7,-78
"Nicholas County, KY",KY,2013,3531,3229,302,8.6,-6
"Nicholas County, KY",KY,2012,3537,3244,293,8.3,-54
"Nicholas County, KY",KY,2011,3591,3269,322,9.0,-59
"Nicholas County, KY",KY,2010,3650,3278,372,10.2,0
"Nicholas County, WV",WV,2021,9085,8541,544,6.0,-196
"Nicholas County, WV",WV,2020,9281,8328,953,10.3,-193
"Nicholas County, WV",WV,2019,9474,8873,601,6.3,92
"Nicholas County, WV",WV,2018,9382,8786,596,6.4,69
"Nicholas County, WV",WV,2017,9313,8646,667,7.2,-306
"Nicholas County, WV",WV,2016,9619,8770,849,8.8,-427
"Nicholas County, WV",WV,2015,10046,9158,888,8.8,-101
"Nicholas County, WV",WV,2014,10147,9239,908,8.9,-234
"Nicholas County, WV",WV,2013,10381,9397,984,9.5,-445
"Nicholas County, WV",WV,2012,10826,9856,970,9.0,-117
"Nicholas County, WV",WV,2011,10943,9973,970,8.9,16
"Nicholas County, WV",WV,2010,10927,9828,1099,10.1,0
"Nicollet County, MN",MN,2021,20123,19567,556,2.8,-821
"Nicollet County, MN",MN,2020,20944,19912,1032,4.9,-217
"Nicollet County, MN",MN,2019,21161,20589,572,2.7,290
"Nicollet County, MN",MN,2018,20871,20376,495,2.4,164
"Nicollet County, MN",MN,2017,20707,20177,530,2.6,364
"Nicollet County, MN",MN,2016,20343,19767,576,2.8,-6
"Nicollet County, MN",MN,2015,20349,19801,548,2.7,539
"Nicollet County, MN",MN,2014,19810,19190,620,3.1,78
"Nicollet County, MN",MN,2013,19732,18983,749,3.8,-28
"Nicollet County, MN",MN,2012,19760,18853,907,4.6,-221
"Nicollet County, MN",MN,2011,19981,18959,1022,5.1,185
"Nicollet County, MN",MN,2010,19796,18584,1212,6.1,0
"Niobrara County, WY",WY,2021,1259,1214,45,3.6,26
"Niobrara County, WY",WY,2020,1233,1188,45,3.6,5
"Niobrara County, WY",WY,2019,1228,1193,35,2.9,-59
"Niobrara County, WY",WY,2018,1287,1251,36,2.8,-17
"Niobrara County, WY",WY,2017,1304,1267,37,2.8,-34
"Niobrara County, WY",WY,2016,1338,1294,44,3.3,21
"Niobrara County, WY",WY,2015,1317,1278,39,3.0,-18
"Niobrara County, WY",WY,2014,1335,1288,47,3.5,-25
"Niobrara County, WY",WY,2013,1360,1312,48,3.5,-5
"Niobrara County, WY",WY,2012,1365,1311,54,4.0,-10
"Niobrara County, WY",WY,2011,1375,1315,60,4.4,-4
"Niobrara County, WY",WY,2010,1379,1311,68,4.9,0
"Noble County, IN",IN,2021,21988,21273,715,3.3,-868
"Noble County, IN",IN,2020,22856,20926,1930,8.4,-945
"Noble County, IN",IN,2019,23801,23075,726,3.1,118
"Noble County, IN",IN,2018,23683,22997,686,2.9,551
"Noble County, IN",IN,2017,23132,22425,707,3.1,-222
"Noble County, IN",IN,2016,23354,22419,935,4.0,-295
"Noble County, IN",IN,2015,23649,22647,1002,4.2,505
"Noble County, IN",IN,2014,23144,21947,1197,5.2,489
"Noble County, IN",IN,2013,22655,21027,1628,7.2,17
"Noble County, IN",IN,2012,22638,20717,1921,8.5,-541
"Noble County, IN",IN,2011,23179,20891,2288,9.9,181
"Noble County, IN",IN,2010,22998,20049,2949,12.8,0
"Noble County, OH",OH,2021,4628,4314,314,6.8,-8
"Noble County, OH",OH,2020,4636,4186,450,9.7,-123
"Noble County, OH",OH,2019,4759,4427,332,7.0,-34
"Noble County, OH",OH,2018,4793,4474,319,6.7,-1
"Noble County, OH",OH,2017,4794,4449,345,7.2,-119
"Noble County, OH",OH,2016,4913,4481,432,8.8,-78
"Noble County, OH",OH,2015,4991,4624,367,7.4,-104
"Noble County, OH",OH,2014,5095,4707,388,7.6,-190
"Noble County, OH",OH,2013,5285,4777,508,9.6,504
"Noble County, OH",OH,2012,4781,4256,525,11.0,-193
"Noble County, OH",OH,2011,4974,4311,663,13.3,-256
"Noble County, OH",OH,2010,5230,4392,838,16.0,0
"Noble County, OK",OK,2021,5564,5423,141,2.5,113
"Noble County, OK",OK,2020,5451,5225,226,4.1,-194
"Noble County, OK",OK,2019,5645,5516,129,2.3,-62
"Noble County, OK",OK,2018,5707,5565,142,2.5,-31
"Noble County, OK",OK,2017,5738,5559,179,3.1,-18
"Noble County, OK",OK,2016,5756,5560,196,3.4,119
"Noble County, OK",OK,2015,5637,5442,195,3.5,99
"Noble County, OK",OK,2014,5538,5342,196,3.5,70
"Noble County, OK",OK,2013,5468,5233,235,4.3,-4
"Noble County, OK",OK,2012,5472,5237,235,4.3,144
"Noble County, OK",OK,2011,5328,5066,262,4.9,85
"Noble County, OK",OK,2010,5243,4901,342,6.5,0
"Nobles County, MN",MN,2021,11076,10760,316,2.9,-589
"Nobles County, MN",MN,2020,11665,11159,506,4.3,329
"Nobles County, MN",MN,2019,11336,10977,359,3.2,-4
"Nobles County, MN",MN,2018,11340,11023,317,2.8,-52
"Nobles County, MN",MN,2017,11392,11027,365,3.2,-58
"Nobles County, MN",MN,2016,11450,11018,432,3.8,-102
"Nobles County, MN",MN,2015,11552,11174,378,3.3,296
"Nobles County, MN",MN,2014,11256,10862,394,3.5,185
"Nobles County, MN",MN,2013,11071,10618,453,4.1,-231
"Nobles County, MN",MN,2012,11302,10807,495,4.4,-207
"Nobles County, MN",MN,2011,11509,10900,609,5.3,-22
"Nobles County, MN",MN,2010,11531,10882,649,5.6,0
"Nodaway County, MO",MO,2021,10791,10473,318,2.9,83
"Nodaway County, MO",MO,2020,10708,10235,473,4.4,-16
"Nodaway County, MO",MO,2019,10724,10423,301,2.8,89
"Nodaway County, MO",MO,2018,10635,10330,305,2.9,1
"Nodaway County, MO",MO,2017,10634,10254,380,3.6,-204
"Nodaway County, MO",MO,2016,10838,10334,504,4.7,-109
"Nodaway County, MO",MO,2015,10947,10399,548,5.0,-114
"Nodaway County, MO",MO,2014,11061,10304,757,6.8,-262
"Nodaway County, MO",MO,2013,11323,10575,748,6.6,-321
"Nodaway County, MO",MO,2012,11644,10973,671,5.8,103
"Nodaway County, MO",MO,2011,11541,10733,808,7.0,-169
"Nodaway County, MO",MO,2010,11710,10871,839,7.2,0
"Nolan County, TX",TX,2021,7091,6754,337,4.8,85
"Nolan County, TX",TX,2020,7006,6631,375,5.4,51
"Nolan County, TX",TX,2019,6955,6751,204,2.9,302
"Nolan County, TX",TX,2018,6653,6433,220,3.3,-75
"Nolan County, TX",TX,2017,6728,6455,273,4.1,-139
"Nolan County, TX",TX,2016,6867,6537,330,4.8,-48
"Nolan County, TX",TX,2015,6915,6633,282,4.1,-122
"Nolan County, TX",TX,2014,7037,6731,306,4.3,84
"Nolan County, TX",TX,2013,6953,6554,399,5.7,-124
"Nolan County, TX",TX,2012,7077,6659,418,5.9,-273
"Nolan County, TX",TX,2011,7350,6816,534,7.3,9
"Nolan County, TX",TX,2010,7341,6788,553,7.5,0
"Nome Census Area, AK",AK,2021,4088,3693,395,9.7,149
"Nome Census Area, AK",AK,2020,3939,3508,431,10.9,-85
"Nome Census Area, AK",AK,2019,4024,3624,400,9.9,-75
"Nome Census Area, AK",AK,2018,4099,3670,429,10.5,8
"Nome Census Area, AK",AK,2017,4091,3626,465,11.4,19
"Nome Census Area, AK",AK,2016,4072,3574,498,12.2,7
"Nome Census Area, AK",AK,2015,4065,3596,469,11.5,-42
"Nome Census Area, AK",AK,2014,4107,3610,497,12.1,-16
"Nome Census Area, AK",AK,2013,4123,3613,510,12.4,-43
"Nome Census Area, AK",AK,2012,4166,3673,493,11.8,49
"Nome Census Area, AK",AK,2011,4117,3599,518,12.6,2
"Nome Census Area, AK",AK,2010,4115,3582,533,13.0,0
"Norfolk city, VA",VA,2021,107879,101694,6185,5.7,-3874
"Norfolk city, VA",VA,2020,111753,102070,9683,8.7,-1083
"Norfolk city, VA",VA,2019,112836,108973,3863,3.4,401
"Norfolk city, VA",VA,2018,112435,108386,4049,3.6,-234
"Norfolk city, VA",VA,2017,112669,107538,5131,4.6,2205
"Norfolk city, VA",VA,2016,110464,104722,5742,5.2,-482
"Norfolk city, VA",VA,2015,110946,104840,6106,5.5,-1457
"Norfolk city, VA",VA,2014,112403,105379,7024,6.2,-349
"Norfolk city, VA",VA,2013,112752,105086,7666,6.8,110
"Norfolk city, VA",VA,2012,112642,104230,8412,7.5,-100
"Norfolk city, VA",VA,2011,112742,103387,9355,8.3,102
"Norfolk city, VA",VA,2010,112640,102555,10085,9.0,0
"Norfolk County, MA",MA,2021,390570,370471,20099,5.1,547
"Norfolk County, MA",MA,2020,390023,355614,34409,8.8,-8604
"Norfolk County, MA",MA,2019,398627,388029,10598,2.7,5774
"Norfolk County, MA",MA,2018,392853,380800,12053,3.1,9782
"Norfolk County, MA",MA,2017,383071,370046,13025,3.4,10499
"Norfolk County, MA",MA,2016,372572,359531,13041,3.5,3385
"Norfolk County, MA",MA,2015,369187,353831,15356,4.2,1720
"Norfolk County, MA",MA,2014,367467,349123,18344,5.0,4557
"Norfolk County, MA",MA,2013,362910,342068,20842,5.7,1887
"Norfolk County, MA",MA,2012,361023,340369,20654,5.7,2178
"Norfolk County, MA",MA,2011,358845,336362,22483,6.3,604
"Norfolk County, MA",MA,2010,358241,332356,25885,7.2,0
"Norman County, MN",MN,2021,3154,3030,124,3.9,-176
"Norman County, MN",MN,2020,3330,3113,217,6.5,39
"Norman County, MN",MN,2019,3291,3123,168,5.1,-85
"Norman County, MN",MN,2018,3376,3220,156,4.6,-36
"Norman County, MN",MN,2017,3412,3250,162,4.7,-27
"Norman County, MN",MN,2016,3439,3275,164,4.8,-11
"Norman County, MN",MN,2015,3450,3286,164,4.8,127
"Norman County, MN",MN,2014,3323,3153,170,5.1,7
"Norman County, MN",MN,2013,3316,3123,193,5.8,-211
"Norman County, MN",MN,2012,3527,3317,210,6.0,-130
"Norman County, MN",MN,2011,3657,3411,246,6.7,50
"Norman County, MN",MN,2010,3607,3357,250,6.9,0
"North Slope Borough, AK",AK,2021,2918,2733,185,6.3,-246
"North Slope Borough, AK",AK,2020,3164,2971,193,6.1,-388
"North Slope Borough, AK",AK,2019,3552,3348,204,5.7,139
"North Slope Borough, AK",AK,2018,3413,3198,215,6.3,-185
"North Slope Borough, AK",AK,2017,3598,3348,250,6.9,-353
"North Slope Borough, AK",AK,2016,3951,3694,257,6.5,-345
"North Slope Borough, AK",AK,2015,4296,4059,237,5.5,-42
"North Slope Borough, AK",AK,2014,4338,4084,254,5.9,286
"North Slope Borough, AK",AK,2013,4052,3753,299,7.4,40
"North Slope Borough, AK",AK,2012,4012,3697,315,7.9,32
"North Slope Borough, AK",AK,2011,3980,3670,310,7.8,15
"North Slope Borough, AK",AK,2010,3965,3635,330,8.3,0
"Northampton County, NC",NC,2021,7178,6731,447,6.2,-36
"Northampton County, NC",NC,2020,7214,6701,513,7.1,-481
"Northampton County, NC",NC,2019,7695,7307,388,5.0,166
"Northampton County, NC",NC,2018,7529,7140,389,5.2,-105
"Northampton County, NC",NC,2017,7634,7158,476,6.2,-157
"Northampton County, NC",NC,2016,7791,7225,566,7.3,-65
"Northampton County, NC",NC,2015,7856,7271,585,7.4,-84
"Northampton County, NC",NC,2014,7940,7319,621,7.8,-228
"Northampton County, NC",NC,2013,8168,7375,793,9.7,-206
"Northampton County, NC",NC,2012,8374,7390,984,11.8,-302
"Northampton County, NC",NC,2011,8676,7615,1061,12.2,-57
"Northampton County, NC",NC,2010,8733,7727,1006,11.5,0
"Northampton County, PA",PA,2021,162125,152487,9638,5.9,779
"Northampton County, PA",PA,2020,161346,146914,14432,8.9,-2197
"Northampton County, PA",PA,2019,163543,156047,7496,4.6,2128
"Northampton County, PA",PA,2018,161415,153991,7424,4.6,1317
"Northampton County, PA",PA,2017,160098,152125,7973,5.0,1013
"Northampton County, PA",PA,2016,159085,150961,8124,5.1,2428
"Northampton County, PA",PA,2015,156657,148266,8391,5.4,1454
"Northampton County, PA",PA,2014,155203,145875,9328,6.0,-48
"Northampton County, PA",PA,2013,155251,144133,11118,7.2,155
"Northampton County, PA",PA,2012,155096,142791,12305,7.9,2776
"Northampton County, PA",PA,2011,152320,140012,12308,8.1,919
"Northampton County, PA",PA,2010,151401,138498,12903,8.5,0
"Northampton County, VA",VA,2021,5359,5071,288,5.4,-59
"Northampton County, VA",VA,2020,5418,4998,420,7.8,-95
"Northampton County, VA",VA,2019,5513,5270,243,4.4,77
"Northampton County, VA",VA,2018,5436,5145,291,5.4,-132
"Northampton County, VA",VA,2017,5568,5258,310,5.6,-313
"Northampton County, VA",VA,2016,5881,5546,335,5.7,-239
"Northampton County, VA",VA,2015,6120,5752,368,6.0,19
"Northampton County, VA",VA,2014,6101,5648,453,7.4,70
"Northampton County, VA",VA,2013,6031,5494,537,8.9,-153
"Northampton County, VA",VA,2012,6184,5623,561,9.1,-170
"Northampton County, VA",VA,2011,6354,5791,563,8.9,8
"Northampton County, VA",VA,2010,6346,5796,550,8.7,0
"Northumberland County, PA",PA,2021,42079,39224,2855,6.8,-721
"Northumberland County, PA",PA,2020,42800,38777,4023,9.4,-835
"Northumberland County, PA",PA,2019,43635,41130,2505,5.7,65
"Northumberland County, PA",PA,2018,43570,41201,2369,5.4,-504
"Northumberland County, PA",PA,2017,44074,41537,2537,5.8,60
"Northumberland County, PA",PA,2016,44014,41296,2718,6.2,560
"Northumberland County, PA",PA,2015,43454,40755,2699,6.2,-433
"Northumberland County, PA",PA,2014,43887,40904,2983,6.8,-664
"Northumberland County, PA",PA,2013,44551,40780,3771,8.5,-422
"Northumberland County, PA",PA,2012,44973,40967,4006,8.9,123
"Northumberland County, PA",PA,2011,44850,40820,4030,9.0,-354
"Northumberland County, PA",PA,2010,45204,40841,4363,9.7,0
"Northumberland County, VA",VA,2021,5503,5236,267,4.9,-160
"Northumberland County, VA",VA,2020,5663,5304,359,6.3,-77
"Northumberland County, VA",VA,2019,5740,5495,245,4.3,145
"Northumberland County, VA",VA,2018,5595,5349,246,4.4,-17
"Northumberland County, VA",VA,2017,5612,5322,290,5.2,158
"Northumberland County, VA",VA,2016,5454,5161,293,5.4,-29
"Northumberland County, VA",VA,2015,5483,5154,329,6.0,-174
"Northumberland County, VA",VA,2014,5657,5265,392,6.9,-32
"Northumberland County, VA",VA,2013,5689,5278,411,7.2,-193
"Northumberland County, VA",VA,2012,5882,5411,471,8.0,-140
"Northumberland County, VA",VA,2011,6022,5482,540,9.0,-139
"Northumberland County, VA",VA,2010,6161,5614,547,8.9,0
"Northwest Arctic Borough, AK",AK,2021,2914,2578,336,11.5,-27
"Northwest Arctic Borough, AK",AK,2020,2941,2570,371,12.6,37
"Northwest Arctic Borough, AK",AK,2019,2904,2533,371,12.8,-19
"Northwest Arctic Borough, AK",AK,2018,2923,2552,371,12.7,-22
"Northwest Arctic Borough, AK",AK,2017,2945,2496,449,15.2,-5
"Northwest Arctic Borough, AK",AK,2016,2950,2496,454,15.4,57
"Northwest Arctic Borough, AK",AK,2015,2893,2444,449,15.5,-98
"Northwest Arctic Borough, AK",AK,2014,2991,2490,501,16.8,-63
"Northwest Arctic Borough, AK",AK,2013,3054,2551,503,16.5,30
"Northwest Arctic Borough, AK",AK,2012,3024,2542,482,15.9,44
"Northwest Arctic Borough, AK",AK,2011,2980,2510,470,15.8,18
"Northwest Arctic Borough, AK",AK,2010,2962,2551,411,13.9,0
"Norton city, VA",VA,2021,1604,1525,79,4.9,-57
"Norton city, VA",VA,2020,1661,1539,122,7.3,-38
"Norton city, VA",VA,2019,1699,1638,61,3.6,18
"Norton city, VA",VA,2018,1681,1615,66,3.9,-36
"Norton city, VA",VA,2017,1717,1627,90,5.2,55
"Norton city, VA",VA,2016,1662,1550,112,6.7,-77
"Norton city, VA",VA,2015,1739,1620,119,6.8,-72
"Norton city, VA",VA,2014,1811,1674,137,7.6,-58
"Norton city, VA",VA,2013,1869,1717,152,8.1,-121
"Norton city, VA",VA,2012,1990,1841,149,7.5,-119
"Norton city, VA",VA,2011,2109,1964,145,6.9,27
"Norton city, VA",VA,2010,2082,1927,155,7.4,0
"Norton County, KS",KS,2021,2669,2622,47,1.8,25
"Norton County, KS",KS,2020,2644,2578,66,2.5,-58
"Norton County, KS",KS,2019,2702,2644,58,2.1,-53
"Norton County, KS",KS,2018,2755,2698,57,2.1,-69
"Norton County, KS",KS,2017,2824,2761,63,2.2,-61
"Norton County, KS",KS,2016,2885,2815,70,2.4,-72
"Norton County, KS",KS,2015,2957,2884,73,2.5,-87
"Norton County, KS",KS,2014,3044,2972,72,2.4,-48
"Norton County, KS",KS,2013,3092,3006,86,2.8,-64
"Norton County, KS",KS,2012,3156,3058,98,3.1,2
"Norton County, KS",KS,2011,3154,3045,109,3.5,54
"Norton County, KS",KS,2010,3100,2983,117,3.8,0
"Nottoway County, VA",VA,2021,7029,6772,257,3.7,-175
"Nottoway County, VA",VA,2020,7204,6841,363,5.0,-167
"Nottoway County, VA",VA,2019,7371,7170,201,2.7,88
"Nottoway County, VA",VA,2018,7283,7061,222,3.0,91
"Nottoway County, VA",VA,2017,7192,6920,272,3.8,148
"Nottoway County, VA",VA,2016,7044,6768,276,3.9,-114
"Nottoway County, VA",VA,2015,7158,6838,320,4.5,56
"Nottoway County, VA",VA,2014,7102,6730,372,5.2,29
"Nottoway County, VA",VA,2013,7073,6656,417,5.9,204
"Nottoway County, VA",VA,2012,6869,6440,429,6.2,-13
"Nottoway County, VA",VA,2011,6882,6391,491,7.1,13
"Nottoway County, VA",VA,2010,6869,6335,534,7.8,0
"Nowata County, OK",OK,2021,4637,4474,163,3.5,49
"Nowata County, OK",OK,2020,4588,4343,245,5.3,39
"Nowata County, OK",OK,2019,4549,4401,148,3.3,-55
"Nowata County, OK",OK,2018,4604,4418,186,4.0,9
"Nowata County, OK",OK,2017,4595,4359,236,5.1,-84
"Nowata County, OK",OK,2016,4679,4404,275,5.9,-115
"Nowata County, OK",OK,2015,4794,4527,267,5.6,45
"Nowata County, OK",OK,2014,4749,4469,280,5.9,-62
"Nowata County, OK",OK,2013,4811,4495,316,6.6,-82
"Nowata County, OK",OK,2012,4893,4570,323,6.6,7
"Nowata County, OK",OK,2011,4886,4517,369,7.6,-3
"Nowata County, OK",OK,2010,4889,4456,433,8.9,0
"Noxubee County, MS",MS,2021,3597,3276,321,8.9,-179
"Noxubee County, MS",MS,2020,3776,3365,411,10.9,3
"Noxubee County, MS",MS,2019,3773,3497,276,7.3,-29
"Noxubee County, MS",MS,2018,3802,3539,263,6.9,-92
"Noxubee County, MS",MS,2017,3894,3601,293,7.5,-55
"Noxubee County, MS",MS,2016,3949,3616,333,8.4,5
"Noxubee County, MS",MS,2015,3944,3553,391,9.9,-52
"Noxubee County, MS",MS,2014,3996,3491,505,12.6,-93
"Noxubee County, MS",MS,2013,4089,3543,546,13.4,-163
"Noxubee County, MS",MS,2012,4252,3705,547,12.9,-132
"Noxubee County, MS",MS,2011,4384,3760,624,14.2,-48
"Noxubee County, MS",MS,2010,4432,3751,681,15.4,0
"Nuckolls County, NE",NE,2021,2501,2455,46,1.8,23
"Nuckolls County, NE",NE,2020,2478,2412,66,2.7,54
"Nuckolls County, NE",NE,2019,2424,2358,66,2.7,21
"Nuckolls County, NE",NE,2018,2403,2337,66,2.7,20
"Nuckolls County, NE",NE,2017,2383,2319,64,2.7,3
"Nuckolls County, NE",NE,2016,2380,2311,69,2.9,-11
"Nuckolls County, NE",NE,2015,2391,2330,61,2.6,-14
"Nuckolls County, NE",NE,2014,2405,2338,67,2.8,-45
"Nuckolls County, NE",NE,2013,2450,2373,77,3.1,-21
"Nuckolls County, NE",NE,2012,2471,2388,83,3.4,-26
"Nuckolls County, NE",NE,2011,2497,2407,90,3.6,59
"Nuckolls County, NE",NE,2010,2438,2336,102,4.2,0
"Nueces County, TX",TX,2021,163825,152485,11340,6.9,483
"Nueces County, TX",TX,2020,163342,148793,14549,8.9,-1653
"Nueces County, TX",TX,2019,164995,158208,6787,4.1,-1261
"Nueces County, TX",TX,2018,166256,158449,7807,4.7,-496
"Nueces County, TX",TX,2017,166752,157654,9098,5.5,-1075
"Nueces County, TX",TX,2016,167827,158355,9472,5.6,1937
"Nueces County, TX",TX,2015,165890,157629,8261,5.0,-2124
"Nueces County, TX",TX,2014,168014,159297,8717,5.2,39
"Nueces County, TX",TX,2013,167975,157617,10358,6.2,1345
"Nueces County, TX",TX,2012,166630,155750,10880,6.5,2371
"Nueces County, TX",TX,2011,164259,150752,13507,8.2,1508
"Nueces County, TX",TX,2010,162751,149458,13293,8.2,0
"Nye County, NV",NV,2021,17290,16230,1060,6.1,-81
"Nye County, NV",NV,2020,17371,15604,1767,10.2,66
"Nye County, NV",NV,2019,17305,16391,914,5.3,724
"Nye County, NV",NV,2018,16581,15659,922,5.6,593
"Nye County, NV",NV,2017,15988,14962,1026,6.4,83
"Nye County, NV",NV,2016,15905,14721,1184,7.4,103
"Nye County, NV",NV,2015,15802,14399,1403,8.9,-233
"Nye County, NV",NV,2014,16035,14434,1601,10.0,-209
"Nye County, NV",NV,2013,16244,14199,2045,12.6,-367
"Nye County, NV",NV,2012,16611,14128,2483,14.9,-170
"Nye County, NV",NV,2011,16781,13915,2866,17.1,35
"Nye County, NV",NV,2010,16746,13805,2941,17.6,0
"O'Brien County, IA",IA,2021,8082,7837,245,3.0,-70
"O'Brien County, IA",IA,2020,8152,7884,268,3.3,-263
"O'Brien County, IA",IA,2019,8415,8243,172,2.0,187
"O'Brien County, IA",IA,2018,8228,8065,163,2.0,125
"O'Brien County, IA",IA,2017,8103,7911,192,2.4,-302
"O'Brien County, IA",IA,2016,8405,8174,231,2.7,-27
"O'Brien County, IA",IA,2015,8432,8196,236,2.8,195
"O'Brien County, IA",IA,2014,8237,7969,268,3.3,184
"O'Brien County, IA",IA,2013,8053,7760,293,3.6,-20
"O'Brien County, IA",IA,2012,8073,7765,308,3.8,-64
"O'Brien County, IA",IA,2011,8137,7791,346,4.3,15
"O'Brien County, IA",IA,2010,8122,7738,384,4.7,0
"Oakland County, MI",MI,2021,660330,629457,30873,4.7,6991
"Oakland County, MI",MI,2020,653339,593872,59467,9.1,-35322
"Oakland County, MI",MI,2019,688661,665495,23166,3.4,6392
"Oakland County, MI",MI,2018,682269,659290,22979,3.4,9239
"Oakland County, MI",MI,2017,673030,649306,23724,3.5,20580
"Oakland County, MI",MI,2016,652450,625608,26842,4.1,21694
"Oakland County, MI",MI,2015,630756,601330,29426,4.7,1072
"Oakland County, MI",MI,2014,629684,589088,40596,6.4,-509
"Oakland County, MI",MI,2013,630193,581499,48694,7.7,12551
"Oakland County, MI",MI,2012,617642,567085,50557,8.2,8950
"Oakland County, MI",MI,2011,608692,552687,56005,9.2,-8657
"Oakland County, MI",MI,2010,617349,547238,70111,11.4,0
"Obion County, TN",TN,2021,12285,11710,575,4.7,117
"Obion County, TN",TN,2020,12168,11351,817,6.7,-346
"Obion County, TN",TN,2019,12514,11903,611,4.9,222
"Obion County, TN",TN,2018,12292,11685,607,4.9,65
"Obion County, TN",TN,2017,12227,11555,672,5.5,-353
"Obion County, TN",TN,2016,12580,11691,889,7.1,81
"Obion County, TN",TN,2015,12499,11430,1069,8.6,-359
"Obion County, TN",TN,2014,12858,11625,1233,9.6,-848
"Obion County, TN",TN,2013,13706,12121,1585,11.6,-637
"Obion County, TN",TN,2012,14343,12386,1957,13.6,-919
"Obion County, TN",TN,2011,15262,13381,1881,12.3,-299
"Obion County, TN",TN,2010,15561,14036,1525,9.8,0
"Ocean County, NJ",NJ,2021,292150,274713,17437,6.0,2729
"Ocean County, NJ",NJ,2020,289421,263021,26400,9.1,-408
"Ocean County, NJ",NJ,2019,289829,279736,10093,3.5,7487
"Ocean County, NJ",NJ,2018,282342,270779,11563,4.1,4519
"Ocean County, NJ",NJ,2017,277823,264758,13065,4.7,8992
"Ocean County, NJ",NJ,2016,268831,254901,13930,5.2,3298
"Ocean County, NJ",NJ,2015,265533,249320,16213,6.1,929
"Ocean County, NJ",NJ,2014,264604,245127,19477,7.4,-797
"Ocean County, NJ",NJ,2013,265401,240258,25143,9.5,-2193
"Ocean County, NJ",NJ,2012,267594,238964,28630,10.7,2193
"Ocean County, NJ",NJ,2011,265401,237652,27749,10.5,1237
"Ocean County, NJ",NJ,2010,264164,236591,27573,10.4,0
"Oceana County, MI",MI,2021,11581,10721,860,7.4,-417
"Oceana County, MI",MI,2020,11998,10695,1303,10.9,-77
"Oceana County, MI",MI,2019,12075,11342,733,6.1,27
"Oceana County, MI",MI,2018,12048,11291,757,6.3,-172
"Oceana County, MI",MI,2017,12220,11366,854,7.0,-140
"Oceana County, MI",MI,2016,12360,11446,914,7.4,-192
"Oceana County, MI",MI,2015,12552,11536,1016,8.1,-315
"Oceana County, MI",MI,2014,12867,11573,1294,10.1,102
"Oceana County, MI",MI,2013,12765,11200,1565,12.3,-107
"Oceana County, MI",MI,2012,12872,11261,1611,12.5,-66
"Oceana County, MI",MI,2011,12938,11191,1747,13.5,-294
"Oceana County, MI",MI,2010,13232,11155,2077,15.7,0
"Ochiltree County, TX",TX,2021,3952,3772,180,4.6,-48
"Ochiltree County, TX",TX,2020,4000,3767,233,5.8,-250
"Ochiltree County, TX",TX,2019,4250,4137,113,2.7,-163
"Ochiltree County, TX",TX,2018,4413,4289,124,2.8,-77
"Ochiltree County, TX",TX,2017,4490,4325,165,3.7,-174
"Ochiltree County, TX",TX,2016,4664,4419,245,5.3,-610
"Ochiltree County, TX",TX,2015,5274,5048,226,4.3,-289
"Ochiltree County, TX",TX,2014,5563,5395,168,3.0,145
"Ochiltree County, TX",TX,2013,5418,5212,206,3.8,110
"Ochiltree County, TX",TX,2012,5308,5105,203,3.8,207
"Ochiltree County, TX",TX,2011,5101,4847,254,5.0,228
"Ochiltree County, TX",TX,2010,4873,4584,289,5.9,0
"Oconee County, GA",GA,2021,20285,19842,443,2.2,676
"Oconee County, GA",GA,2020,19609,18893,716,3.7,-460
"Oconee County, GA",GA,2019,20069,19536,533,2.7,-64
"Oconee County, GA",GA,2018,20133,19529,604,3.0,478
"Oconee County, GA",GA,2017,19655,18955,700,3.6,1183
"Oconee County, GA",GA,2016,18472,17706,766,4.1,1087
"Oconee County, GA",GA,2015,17385,16602,783,4.5,153
"Oconee County, GA",GA,2014,17232,16355,877,5.1,156
"Oconee County, GA",GA,2013,17076,16125,951,5.6,60
"Oconee County, GA",GA,2012,17016,15960,1056,6.2,137
"Oconee County, GA",GA,2011,16879,15710,1169,6.9,4
"Oconee County, GA",GA,2010,16875,15655,1220,7.2,0
"Oconee County, SC",SC,2021,34123,32885,1238,3.6,-68
"Oconee County, SC",SC,2020,34191,32421,1770,5.2,50
"Oconee County, SC",SC,2019,34141,33208,933,2.7,249
"Oconee County, SC",SC,2018,33892,32769,1123,3.3,519
"Oconee County, SC",SC,2017,33373,31937,1436,4.3,-746
"Oconee County, SC",SC,2016,34119,32396,1723,5.0,-348
"Oconee County, SC",SC,2015,34467,32490,1977,5.7,287
"Oconee County, SC",SC,2014,34180,32079,2101,6.1,886
"Oconee County, SC",SC,2013,33294,30810,2484,7.5,-147
"Oconee County, SC",SC,2012,33441,30565,2876,8.6,16
"Oconee County, SC",SC,2011,33425,30114,3311,9.9,-185
"Oconee County, SC",SC,2010,33610,29729,3881,11.5,0
"Oconto County, WI",WI,2021,20816,20039,777,3.7,146
"Oconto County, WI",WI,2020,20670,19369,1301,6.3,86
"Oconto County, WI",WI,2019,20584,19876,708,3.4,-253
"Oconto County, WI",WI,2018,20837,20156,681,3.3,132
"Oconto County, WI",WI,2017,20705,19980,725,3.5,299
"Oconto County, WI",WI,2016,20406,19527,879,4.3,118
"Oconto County, WI",WI,2015,20288,19266,1022,5.0,-33
"Oconto County, WI",WI,2014,20321,19079,1242,6.1,-126
"Oconto County, WI",WI,2013,20447,18882,1565,7.7,-182
"Oconto County, WI",WI,2012,20629,18927,1702,8.3,-429
"Oconto County, WI",WI,2011,21058,19086,1972,9.4,-279
"Oconto County, WI",WI,2010,21337,19085,2252,10.6,0
"Ogemaw County, MI",MI,2021,7874,7256,618,7.8,-174
"Ogemaw County, MI",MI,2020,8048,7129,919,11.4,0
"Ogemaw County, MI",MI,2019,8048,7502,546,6.8,-170
"Ogemaw County, MI",MI,2018,8218,7646,572,7.0,41
"Ogemaw County, MI",MI,2017,8177,7559,618,7.6,-85
"Ogemaw County, MI",MI,2016,8262,7612,650,7.9,-188
"Ogemaw County, MI",MI,2015,8450,7777,673,8.0,-165
"Ogemaw County, MI",MI,2014,8615,7769,846,9.8,-15
"Ogemaw County, MI",MI,2013,8630,7623,1007,11.7,-25
"Ogemaw County, MI",MI,2012,8655,7679,976,11.3,-100
"Ogemaw County, MI",MI,2011,8755,7680,1075,12.3,-232
"Ogemaw County, MI",MI,2010,8987,7723,1264,14.1,0
"Oglala Lakota County, SD",SD,2021,3998,3649,349,8.7,233
"Oglala Lakota County, SD",SD,2020,3765,3418,347,9.2,254
"Oglala Lakota County, SD",SD,2019,3511,3217,294,8.4,-29
"Oglala Lakota County, SD",SD,2018,3540,3200,340,9.6,-62
"Oglala Lakota County, SD",SD,2017,3602,3215,387,10.7,-32
"Oglala Lakota County, SD",SD,2016,3634,3239,395,10.9,30
"Oglala Lakota County, SD",SD,2015,3604,3197,407,11.3,-33
"Oglala Lakota County, SD",SD,2014,3637,3164,473,13.0,-57
"Oglala Lakota County, SD",SD,2013,3694,3202,492,13.3,-80
"Oglala Lakota County, SD",SD,2012,3774,3263,511,13.5,20
"Oglala Lakota County, SD",SD,2011,3754,3238,516,13.7,23
"Oglala Lakota County, SD",SD,2010,3731,3253,478,12.8,0
"Ogle County, IL",IL,2021,23645,22277,1368,5.8,-448
"Ogle County, IL",IL,2020,24093,22102,1991,8.3,-909
"Ogle County, IL",IL,2019,25002,23845,1157,4.6,-517
"Ogle County, IL",IL,2018,25519,24256,1263,4.9,91
"Ogle County, IL",IL,2017,25428,24125,1303,5.1,-472
"Ogle County, IL",IL,2016,25900,24368,1532,5.9,-47
"Ogle County, IL",IL,2015,25947,24345,1602,6.2,31
"Ogle County, IL",IL,2014,25916,23982,1934,7.5,169
"Ogle County, IL",IL,2013,25747,23219,2528,9.8,-781
"Ogle County, IL",IL,2012,26528,23831,2697,10.2,-888
"Ogle County, IL",IL,2011,27416,24270,3146,11.5,-741
"Ogle County, IL",IL,2010,28157,24627,3530,12.5,0
"Oglethorpe County, GA",GA,2021,7027,6826,201,2.9,182
"Oglethorpe County, GA",GA,2020,6845,6522,323,4.7,-200
"Oglethorpe County, GA",GA,2019,7045,6809,236,3.3,-97
"Oglethorpe County, GA",GA,2018,7142,6875,267,3.7,19
"Oglethorpe County, GA",GA,2017,7123,6813,310,4.4,204
"Oglethorpe County, GA",GA,2016,6919,6578,341,4.9,269
"Oglethorpe County, GA",GA,2015,6650,6275,375,5.6,1
"Oglethorpe County, GA",GA,2014,6649,6207,442,6.6,-82
"Oglethorpe County, GA",GA,2013,6731,6225,506,7.5,-140
"Oglethorpe County, GA",GA,2012,6871,6292,579,8.4,-119
"Oglethorpe County, GA",GA,2011,6990,6313,677,9.7,-109
"Oglethorpe County, GA",GA,2010,7099,6404,695,9.8,0
"Ohio County, IN",IN,2021,3121,3042,79,2.5,-37
"Ohio County, IN",IN,2020,3158,2923,235,7.4,-70
"Ohio County, IN",IN,2019,3228,3117,111,3.4,36
"Ohio County, IN",IN,2018,3192,3082,110,3.4,41
"Ohio County, IN",IN,2017,3151,3038,113,3.6,-76
"Ohio County, IN",IN,2016,3227,3072,155,4.8,50
"Ohio County, IN",IN,2015,3177,3003,174,5.5,-42
"Ohio County, IN",IN,2014,3219,2998,221,6.9,50
"Ohio County, IN",IN,2013,3169,2911,258,8.1,-13
"Ohio County, IN",IN,2012,3182,2904,278,8.7,-36
"Ohio County, IN",IN,2011,3218,2918,300,9.3,-46
"Ohio County, IN",IN,2010,3264,2912,352,10.8,0
"Ohio County, KY",KY,2021,9010,8512,498,5.5,-263
"Ohio County, KY",KY,2020,9273,8626,647,7.0,-485
"Ohio County, KY",KY,2019,9758,9285,473,4.8,-102
"Ohio County, KY",KY,2018,9860,9313,547,5.5,72
"Ohio County, KY",KY,2017,9788,9179,609,6.2,264
"Ohio County, KY",KY,2016,9524,8894,630,6.6,217
"Ohio County, KY",KY,2015,9307,8720,587,6.3,-216
"Ohio County, KY",KY,2014,9523,8794,729,7.7,-379
"Ohio County, KY",KY,2013,9902,8991,911,9.2,-488
"Ohio County, KY",KY,2012,10390,9482,908,8.7,10
"Ohio County, KY",KY,2011,10380,9358,1022,9.8,9
"Ohio County, KY",KY,2010,10371,9197,1174,11.3,0
"Ohio County, WV",WV,2021,20333,19292,1041,5.1,83
"Ohio County, WV",WV,2020,20250,18585,1665,8.2,-951
"Ohio County, WV",WV,2019,21201,20241,960,4.5,-339
"Ohio County, WV",WV,2018,21540,20563,977,4.5,495
"Ohio County, WV",WV,2017,21045,20055,990,4.7,350
"Ohio County, WV",WV,2016,20695,19546,1149,5.6,-214
"Ohio County, WV",WV,2015,20909,19764,1145,5.5,-275
"Ohio County, WV",WV,2014,21184,20025,1159,5.5,-174
"Ohio County, WV",WV,2013,21358,20158,1200,5.6,-9
"Ohio County, WV",WV,2012,21367,20053,1314,6.1,50
"Ohio County, WV",WV,2011,21317,19800,1517,7.1,-479
"Ohio County, WV",WV,2010,21796,20065,1731,7.9,0
"Okaloosa County, FL",FL,2021,99417,96102,3315,3.3,4183
"Okaloosa County, FL",FL,2020,95234,89599,5635,5.9,-626
"Okaloosa County, FL",FL,2019,95860,93198,2662,2.8,1343
"Okaloosa County, FL",FL,2018,94517,91591,2926,3.1,859
"Okaloosa County, FL",FL,2017,93658,90353,3305,3.5,125
"Okaloosa County, FL",FL,2016,93533,89740,3793,4.1,1454
"Okaloosa County, FL",FL,2015,92079,87870,4209,4.6,189
"Okaloosa County, FL",FL,2014,91890,87023,4867,5.3,24
"Okaloosa County, FL",FL,2013,91866,86383,5483,6.0,1056
"Okaloosa County, FL",FL,2012,90810,84517,6293,6.9,425
"Okaloosa County, FL",FL,2011,90385,83334,7051,7.8,2037
"Okaloosa County, FL",FL,2010,88348,81155,7193,8.1,0
"Okanogan County, WA",WA,2021,19538,18246,1292,6.6,74
"Okanogan County, WA",WA,2020,19464,17729,1735,8.9,-1191
"Okanogan County, WA",WA,2019,20655,19241,1414,6.8,-73
"Okanogan County, WA",WA,2018,20728,19399,1329,6.4,-290
"Okanogan County, WA",WA,2017,21018,19611,1407,6.7,-397
"Okanogan County, WA",WA,2016,21415,20015,1400,6.5,185
"Okanogan County, WA",WA,2015,21230,19803,1427,6.7,-46
"Okanogan County, WA",WA,2014,21276,19804,1472,6.9,300
"Okanogan County, WA",WA,2013,20976,19212,1764,8.4,-69
"Okanogan County, WA",WA,2012,21045,19218,1827,8.7,-66
"Okanogan County, WA",WA,2011,21111,19160,1951,9.2,-765
"Okanogan County, WA",WA,2010,21876,19753,2123,9.7,0
"Okeechobee County, FL",FL,2021,17488,16768,720,4.1,398
"Okeechobee County, FL",FL,2020,17090,16089,1001,5.9,-510
"Okeechobee County, FL",FL,2019,17600,16972,628,3.6,24
"Okeechobee County, FL",FL,2018,17576,16904,672,3.8,-624
"Okeechobee County, FL",FL,2017,18200,17390,810,4.5,-5
"Okeechobee County, FL",FL,2016,18205,17261,944,5.2,887
"Okeechobee County, FL",FL,2015,17318,16216,1102,6.4,-334
"Okeechobee County, FL",FL,2014,17652,16316,1336,7.6,-414
"Okeechobee County, FL",FL,2013,18066,16421,1645,9.1,-145
"Okeechobee County, FL",FL,2012,18211,16341,1870,10.3,493
"Okeechobee County, FL",FL,2011,17718,15607,2111,11.9,-216
"Okeechobee County, FL",FL,2010,17934,15740,2194,12.2,0
"Okfuskee County, OK",OK,2021,4425,4210,215,4.9,37
"Okfuskee County, OK",OK,2020,4388,4090,298,6.8,-198
"Okfuskee County, OK",OK,2019,4586,4387,199,4.3,102
"Okfuskee County, OK",OK,2018,4484,4280,204,4.5,44
"Okfuskee County, OK",OK,2017,4440,4186,254,5.7,-105
"Okfuskee County, OK",OK,2016,4545,4278,267,5.9,8
"Okfuskee County, OK",OK,2015,4537,4278,259,5.7,88
"Okfuskee County, OK",OK,2014,4449,4190,259,5.8,35
"Okfuskee County, OK",OK,2013,4414,4111,303,6.9,23
"Okfuskee County, OK",OK,2012,4391,4066,325,7.4,-8
"Okfuskee County, OK",OK,2011,4399,4041,358,8.1,58
"Okfuskee County, OK",OK,2010,4341,3934,407,9.4,0
"Oklahoma County, OK",OK,2021,389697,373878,15819,4.1,6404
"Oklahoma County, OK",OK,2020,383293,358408,24885,6.5,-763
"Oklahoma County, OK",OK,2019,384056,372568,11488,3.0,3578
"Oklahoma County, OK",OK,2018,380478,368385,12093,3.2,4072
"Oklahoma County, OK",OK,2017,376406,362194,14212,3.8,1639
"Oklahoma County, OK",OK,2016,374767,359263,15504,4.1,157
"Oklahoma County, OK",OK,2015,374610,360212,14398,3.8,5176
"Oklahoma County, OK",OK,2014,369434,354490,14944,4.0,1351
"Oklahoma County, OK",OK,2013,368083,350800,17283,4.7,3943
"Oklahoma County, OK",OK,2012,364140,347251,16889,4.6,7792
"Oklahoma County, OK",OK,2011,356348,338412,17936,5.0,2487
"Oklahoma County, OK",OK,2010,353861,332961,20900,5.9,0
"Okmulgee County, OK",OK,2021,15459,14660,799,5.2,136
"Okmulgee County, OK",OK,2020,15323,14185,1138,7.4,-356
"Okmulgee County, OK",OK,2019,15679,14947,732,4.7,109
"Okmulgee County, OK",OK,2018,15570,14829,741,4.8,-293
"Okmulgee County, OK",OK,2017,15863,14914,949,6.0,-260
"Okmulgee County, OK",OK,2016,16123,15005,1118,6.9,-74
"Okmulgee County, OK",OK,2015,16197,15144,1053,6.5,225
"Okmulgee County, OK",OK,2014,15972,14923,1049,6.6,-240
"Okmulgee County, OK",OK,2013,16212,15021,1191,7.3,-247
"Okmulgee County, OK",OK,2012,16459,15194,1265,7.7,-1
"Okmulgee County, OK",OK,2011,16460,15043,1417,8.6,-379
"Okmulgee County, OK",OK,2010,16839,15257,1582,9.4,0
"Oktibbeha County, MS",MS,2021,22478,21246,1232,5.5,679
"Oktibbeha County, MS",MS,2020,21799,20156,1643,7.5,-953
"Oktibbeha County, MS",MS,2019,22752,21470,1282,5.6,418
"Oktibbeha County, MS",MS,2018,22334,21248,1086,4.9,153
"Oktibbeha County, MS",MS,2017,22181,21047,1134,5.1,-765
"Oktibbeha County, MS",MS,2016,22946,21675,1271,5.5,521
"Oktibbeha County, MS",MS,2015,22425,21034,1391,6.2,423
"Oktibbeha County, MS",MS,2014,22002,20411,1591,7.2,-218
"Oktibbeha County, MS",MS,2013,22220,20463,1757,7.9,-809
"Oktibbeha County, MS",MS,2012,23029,21137,1892,8.2,203
"Oktibbeha County, MS",MS,2011,22826,20694,2132,9.3,1083
"Oktibbeha County, MS",MS,2010,21743,19580,2163,9.9,0
"Oldham County, KY",KY,2021,33100,31915,1185,3.6,657
"Oldham County, KY",KY,2020,32443,30919,1524,4.7,-1154
"Oldham County, KY",KY,2019,33597,32557,1040,3.1,321
"Oldham County, KY",KY,2018,33276,32214,1062,3.2,339
"Oldham County, KY",KY,2017,32937,31805,1132,3.4,1005
"Oldham County, KY",KY,2016,31932,30862,1070,3.4,994
"Oldham County, KY",KY,2015,30938,29747,1191,3.8,656
"Oldham County, KY",KY,2014,30282,28852,1430,4.7,-39
"Oldham County, KY",KY,2013,30321,28611,1710,5.6,519
"Oldham County, KY",KY,2012,29802,28045,1757,5.9,471
"Oldham County, KY",KY,2011,29331,27302,2029,6.9,-60
"Oldham County, KY",KY,2010,29391,27155,2236,7.6,0
"Oldham County, TX",TX,2021,917,885,32,3.5,29
"Oldham County, TX",TX,2020,888,853,35,3.9,-12
"Oldham County, TX",TX,2019,900,874,26,2.9,3
"Oldham County, TX",TX,2018,897,873,24,2.7,2
"Oldham County, TX",TX,2017,895,872,23,2.6,-13
"Oldham County, TX",TX,2016,908,881,27,3.0,-6
"Oldham County, TX",TX,2015,914,887,27,3.0,-26
"Oldham County, TX",TX,2014,940,905,35,3.7,-19
"Oldham County, TX",TX,2013,959,916,43,4.5,10
"Oldham County, TX",TX,2012,949,909,40,4.2,-30
"Oldham County, TX",TX,2011,979,935,44,4.5,17
"Oldham County, TX",TX,2010,962,917,45,4.7,0
"Oliver County, ND",ND,2021,873,840,33,3.8,-2
"Oliver County, ND",ND,2020,875,830,45,5.1,-10
"Oliver County, ND",ND,2019,885,855,30,3.4,-7
"Oliver County, ND",ND,2018,892,859,33,3.7,-32
"Oliver County, ND",ND,2017,924,886,38,4.1,28
"Oliver County, ND",ND,2016,896,847,49,5.5,20
"Oliver County, ND",ND,2015,876,824,52,5.9,6
"Oliver County, ND",ND,2014,870,816,54,6.2,-12
"Oliver County, ND",ND,2013,882,828,54,6.1,-2
"Oliver County, ND",ND,2012,884,827,57,6.4,-36
"Oliver County, ND",ND,2011,920,866,54,5.9,-8
"Oliver County, ND",ND,2010,928,876,52,5.6,0
"Olmsted County, MN",MN,2021,89697,87173,2524,2.8,-2158
"Olmsted County, MN",MN,2020,91855,86794,5061,5.5,1738
"Olmsted County, MN",MN,2019,90117,87653,2464,2.7,1994
"Olmsted County, MN",MN,2018,88123,85948,2175,2.5,1021
"Olmsted County, MN",MN,2017,87102,84728,2374,2.7,1939
"Olmsted County, MN",MN,2016,85163,82628,2535,3.0,1083
"Olmsted County, MN",MN,2015,84080,81573,2507,3.0,854
"Olmsted County, MN",MN,2014,83226,80284,2942,3.5,-224
"Olmsted County, MN",MN,2013,83450,80055,3395,4.1,821
"Olmsted County, MN",MN,2012,82629,78949,3680,4.5,1142
"Olmsted County, MN",MN,2011,81487,77180,4307,5.3,230
"Olmsted County, MN",MN,2010,81257,76408,4849,6.0,0
"Oneida County, ID",ID,2021,2578,2514,64,2.5,230
"Oneida County, ID",ID,2020,2348,2248,100,4.3,9
"Oneida County, ID",ID,2019,2339,2285,54,2.3,-6
"Oneida County, ID",ID,2018,2345,2293,52,2.2,74
"Oneida County, ID",ID,2017,2271,2205,66,2.9,71
"Oneida County, ID",ID,2016,2200,2123,77,3.5,71
"Oneida County, ID",ID,2015,2129,2059,70,3.3,19
"Oneida County, ID",ID,2014,2110,2037,73,3.5,1
"Oneida County, ID",ID,2013,2109,2008,101,4.8,10
"Oneida County, ID",ID,2012,2099,1993,106,5.1,84
"Oneida County, ID",ID,2011,2015,1901,114,5.7,6
"Oneida County, ID",ID,2010,2009,1892,117,5.8,0
"Oneida County, NY",NY,2021,100177,95112,5065,5.1,-2236
"Oneida County, NY",NY,2020,102413,94429,7984,7.8,-1493
"Oneida County, NY",NY,2019,103906,99643,4263,4.1,829
"Oneida County, NY",NY,2018,103077,98517,4560,4.4,-583
"Oneida County, NY",NY,2017,103660,98506,5154,5.0,1954
"Oneida County, NY",NY,2016,101706,96689,5017,4.9,-242
"Oneida County, NY",NY,2015,101948,96471,5477,5.4,-1088
"Oneida County, NY",NY,2014,103036,96696,6340,6.2,-4092
"Oneida County, NY",NY,2013,107128,98964,8164,7.6,-1278
"Oneida County, NY",NY,2012,108406,99345,9061,8.4,-732
"Oneida County, NY",NY,2011,109138,100348,8790,8.1,-3205
"Oneida County, NY",NY,2010,112343,103595,8748,7.8,0
"Oneida County, WI",WI,2021,18205,17422,783,4.3,119
"Oneida County, WI",WI,2020,18086,16774,1312,7.3,138
"Oneida County, WI",WI,2019,17948,17213,735,4.1,-264
"Oneida County, WI",WI,2018,18212,17570,642,3.5,-201
"Oneida County, WI",WI,2017,18413,17716,697,3.8,-118
"Oneida County, WI",WI,2016,18531,17654,877,4.7,-51
"Oneida County, WI",WI,2015,18582,17536,1046,5.6,-161
"Oneida County, WI",WI,2014,18743,17497,1246,6.6,157
"Oneida County, WI",WI,2013,18586,17004,1582,8.5,-523
"Oneida County, WI",WI,2012,19109,17473,1636,8.6,270
"Oneida County, WI",WI,2011,18839,17111,1728,9.2,-228
"Oneida County, WI",WI,2010,19067,17161,1906,10.0,0
"Onondaga County, NY",NY,2021,219876,209099,10777,4.9,-4348
"Onondaga County, NY",NY,2020,224224,206289,17935,8.0,-1105
"Onondaga County, NY",NY,2019,225329,216807,8522,3.8,802
"Onondaga County, NY",NY,2018,224527,215593,8934,4.0,737
"Onondaga County, NY",NY,2017,223790,213395,10395,4.6,2538
"Onondaga County, NY",NY,2016,221252,211093,10159,4.6,-845
"Onondaga County, NY",NY,2015,222097,211070,11027,5.0,-2258
"Onondaga County, NY",NY,2014,224355,211780,12575,5.6,-7068
"Onondaga County, NY",NY,2013,231423,215189,16234,7.0,-1195
"Onondaga County, NY",NY,2012,232618,214042,18576,8.0,-311
"Onondaga County, NY",NY,2011,232929,214840,18089,7.8,-4235
"Onondaga County, NY",NY,2010,237164,217786,19378,8.2,0
"Onslow County, NC",NC,2021,65070,61732,3338,5.1,2264
"Onslow County, NC",NC,2020,62806,58361,4445,7.1,-1179
"Onslow County, NC",NC,2019,63985,61077,2908,4.5,563
"Onslow County, NC",NC,2018,63422,60323,3099,4.9,-216
"Onslow County, NC",NC,2017,63638,60298,3340,5.2,119
"Onslow County, NC",NC,2016,63519,60018,3501,5.5,-161
"Onslow County, NC",NC,2015,63680,59974,3706,5.8,-343
"Onslow County, NC",NC,2014,64023,60243,3780,5.9,-152
"Onslow County, NC",NC,2013,64175,59787,4388,6.8,52
"Onslow County, NC",NC,2012,64123,58859,5264,8.2,1104
"Onslow County, NC",NC,2011,63019,57804,5215,8.3,-571
"Onslow County, NC",NC,2010,63590,58387,5203,8.2,0
"Ontario County, NY",NY,2021,54962,52622,2340,4.3,-737
"Ontario County, NY",NY,2020,55699,51828,3871,6.9,-1104
"Ontario County, NY",NY,2019,56803,54688,2115,3.7,236
"Ontario County, NY",NY,2018,56567,54359,2208,3.9,714
"Ontario County, NY",NY,2017,55853,53365,2488,4.5,769
"Ontario County, NY",NY,2016,55084,52667,2417,4.4,113
"Ontario County, NY",NY,2015,54971,52355,2616,4.8,267
"Ontario County, NY",NY,2014,54704,51815,2889,5.3,-1130
"Ontario County, NY",NY,2013,55834,52231,3603,6.5,-126
"Ontario County, NY",NY,2012,55960,51830,4130,7.4,126
"Ontario County, NY",NY,2011,55834,51845,3989,7.1,-577
"Ontario County, NY",NY,2010,56411,52132,4279,7.6,0
"Ontonagon County, MI",MI,2021,2012,1859,153,7.6,-31
"Ontonagon County, MI",MI,2020,2043,1822,221,10.8,-42
"Ontonagon County, MI",MI,2019,2085,1940,145,7.0,-14
"Ontonagon County, MI",MI,2018,2099,1934,165,7.9,-67
"Ontonagon County, MI",MI,2017,2166,1978,188,8.7,-43
"Ontonagon County, MI",MI,2016,2209,2019,190,8.6,-97
"Ontonagon County, MI",MI,2015,2306,2087,219,9.5,-80
"Ontonagon County, MI",MI,2014,2386,2114,272,11.4,-67
"Ontonagon County, MI",MI,2013,2453,2117,336,13.7,-135
"Ontonagon County, MI",MI,2012,2588,2245,343,13.3,-175
"Ontonagon County, MI",MI,2011,2763,2331,432,15.6,-279
"Ontonagon County, MI",MI,2010,3042,2546,496,16.3,0
"Orange County, CA",CA,2021,1553897,1461154,92743,6.0,-7565
"Orange County, CA",CA,2020,1561462,1420678,140784,9.0,-54516
"Orange County, CA",CA,2019,1615978,1570049,45929,2.8,115
"Orange County, CA",CA,2018,1615863,1567723,48140,3.0,10076
"Orange County, CA",CA,2017,1605787,1549003,56784,3.5,8340
"Orange County, CA",CA,2016,1597447,1532725,64722,4.1,13151
"Orange County, CA",CA,2015,1584296,1513060,71236,4.5,18850
"Orange County, CA",CA,2014,1565446,1478476,86970,5.6,5966
"Orange County, CA",CA,2013,1559480,1455311,104169,6.7,1003
"Orange County, CA",CA,2012,1558477,1433508,124969,8.0,14693
"Orange County, CA",CA,2011,1543784,1400874,142910,9.3,6083
"Orange County, CA",CA,2010,1537701,1383916,153785,10.0,0
"Orange County, FL",FL,2021,741002,702684,38318,5.2,-840
"Orange County, FL",FL,2020,741842,656788,85054,11.5,-11068
"Orange County, FL",FL,2019,752910,730279,22631,3.0,12267
"Orange County, FL",FL,2018,740643,715936,24707,3.3,17260
"Orange County, FL",FL,2017,723383,695684,27699,3.8,14566
"Orange County, FL",FL,2016,708817,677671,31146,4.4,20080
"Orange County, FL",FL,2015,688737,653788,34949,5.1,13299
"Orange County, FL",FL,2014,675438,634818,40620,6.0,14106
"Orange County, FL",FL,2013,661332,614487,46845,7.1,11664
"Orange County, FL",FL,2012,649668,594652,55016,8.5,11288
"Orange County, FL",FL,2011,638380,575967,62413,9.8,8572
"Orange County, FL",FL,2010,629808,563766,66042,10.5,0
"Orange County, IN",IN,2021,8149,7804,345,4.2,-355
"Orange County, IN",IN,2020,8504,7552,952,11.2,-194
"Orange County, IN",IN,2019,8698,8404,294,3.4,119
"Orange County, IN",IN,2018,8579,8249,330,3.8,-138
"Orange County, IN",IN,2017,8717,8374,343,3.9,-171
"Orange County, IN",IN,2016,8888,8443,445,5.0,164
"Orange County, IN",IN,2015,8724,8206,518,5.9,180
"Orange County, IN",IN,2014,8544,7885,659,7.7,-222
"Orange County, IN",IN,2013,8766,7912,854,9.7,-14
"Orange County, IN",IN,2012,8780,7848,932,10.6,-97
"Orange County, IN",IN,2011,8877,7850,1027,11.6,-221
"Orange County, IN",IN,2010,9098,7974,1124,12.4,0
"Orange County, NC",NC,2021,79254,76516,2738,3.5,2944
"Orange County, NC",NC,2020,76310,72369,3941,5.2,-3040
"Orange County, NC",NC,2019,79350,76734,2616,3.3,2833
"Orange County, NC",NC,2018,76517,73979,2538,3.3,944
"Orange County, NC",NC,2017,75573,72716,2857,3.8,874
"Orange County, NC",NC,2016,74699,71532,3167,4.2,1391
"Orange County, NC",NC,2015,73308,69954,3354,4.6,588
"Orange County, NC",NC,2014,72720,69439,3281,4.5,-112
"Orange County, NC",NC,2013,72832,69076,3756,5.2,204
"Orange County, NC",NC,2012,72628,68085,4543,6.3,2086
"Orange County, NC",NC,2011,70542,65937,4605,6.5,292
"Orange County, NC",NC,2010,70250,65665,4585,6.5,0
"Orange County, NY",NY,2021,183818,175160,8658,4.7,-2780
"Orange County, NY",NY,2020,186598,171729,14869,8.0,-4896
"Orange County, NY",NY,2019,191494,184535,6959,3.6,3994
"Orange County, NY",NY,2018,187500,180244,7256,3.9,3429
"Orange County, NY",NY,2017,184071,175754,8317,4.5,5108
"Orange County, NY",NY,2016,178963,171096,7867,4.4,1308
"Orange County, NY",NY,2015,177655,169318,8337,4.7,2460
"Orange County, NY",NY,2014,175195,165500,9695,5.5,-3528
"Orange County, NY",NY,2013,178723,166198,12525,7.0,-630
"Orange County, NY",NY,2012,179353,164966,14387,8.0,236
"Orange County, NY",NY,2011,179117,165198,13919,7.8,-2316
"Orange County, NY",NY,2010,181433,166688,14745,8.1,0
"Orange County, TX",TX,2021,34858,31719,3139,9.0,-617
"Orange County, TX",TX,2020,35475,31720,3755,10.6,-537
"Orange County, TX",TX,2019,36012,34151,1861,5.2,-165
"Orange County, TX",TX,2018,36177,34067,2110,5.8,-700
"Orange County, TX",TX,2017,36877,34306,2571,7.0,-491
"Orange County, TX",TX,2016,37368,34859,2509,6.7,163
"Orange County, TX",TX,2015,37205,34755,2450,6.6,-650
"Orange County, TX",TX,2014,37855,34796,3059,8.1,-60
"Orange County, TX",TX,2013,37915,33940,3975,10.5,-865
"Orange County, TX",TX,2012,38780,34749,4031,10.4,-447
"Orange County, TX",TX,2011,39227,34566,4661,11.9,704
"Orange County, TX",TX,2010,38523,34016,4507,11.7,0
"Orange County, VA",VA,2021,16992,16376,616,3.6,-156
"Orange County, VA",VA,2020,17148,16186,962,5.6,-443
"Orange County, VA",VA,2019,17591,17069,522,3.0,407
"Orange County, VA",VA,2018,17184,16670,514,3.0,169
"Orange County, VA",VA,2017,17015,16380,635,3.7,629
"Orange County, VA",VA,2016,16386,15730,656,4.0,268
"Orange County, VA",VA,2015,16118,15388,730,4.5,-119
"Orange County, VA",VA,2014,16237,15393,844,5.2,119
"Orange County, VA",VA,2013,16118,15187,931,5.8,266
"Orange County, VA",VA,2012,15852,14814,1038,6.5,90
"Orange County, VA",VA,2011,15762,14587,1175,7.5,284
"Orange County, VA",VA,2010,15478,14171,1307,8.4,0
"Orange County, VT",VT,2021,15227,14737,490,3.2,-663
"Orange County, VT",VT,2020,15890,15054,836,5.3,-652
"Orange County, VT",VT,2019,16542,16156,386,2.3,93
"Orange County, VT",VT,2018,16449,16017,432,2.6,71
"Orange County, VT",VT,2017,16378,15875,503,3.1,427
"Orange County, VT",VT,2016,15951,15472,479,3.0,-27
"Orange County, VT",VT,2015,15978,15435,543,3.4,13
"Orange County, VT",VT,2014,15965,15347,618,3.9,-199
"Orange County, VT",VT,2013,16164,15499,665,4.1,-245
"Orange County, VT",VT,2012,16409,15658,751,4.6,-168
"Orange County, VT",VT,2011,16577,15679,898,5.4,-162
"Orange County, VT",VT,2010,16739,15718,1021,6.1,0
"Orangeburg County, SC",SC,2021,33801,31406,2395,7.1,-160
"Orangeburg County, SC",SC,2020,33961,30969,2992,8.8,88
"Orangeburg County, SC",SC,2019,33873,32302,1571,4.6,326
"Orangeburg County, SC",SC,2018,33547,31638,1909,5.7,-344
"Orangeburg County, SC",SC,2017,33891,31500,2391,7.1,-1583
"Orangeburg County, SC",SC,2016,35474,32396,3078,8.7,-1428
"Orangeburg County, SC",SC,2015,36902,32930,3972,10.8,-892
"Orangeburg County, SC",SC,2014,37794,33618,4176,11.0,-806
"Orangeburg County, SC",SC,2013,38600,33944,4656,12.1,-792
"Orangeburg County, SC",SC,2012,39392,33886,5506,14.0,-992
"Orangeburg County, SC",SC,2011,40384,34079,6305,15.6,-106
"Orangeburg County, SC",SC,2010,40490,33958,6532,16.1,0
"Oregon County, MO",MO,2021,3839,3636,203,5.3,-72
"Oregon County, MO",MO,2020,3911,3647,264,6.8,-31
"Oregon County, MO",MO,2019,3942,3794,148,3.8,7
"Oregon County, MO",MO,2018,3935,3801,134,3.4,-77
"Oregon County, MO",MO,2017,4012,3829,183,4.6,-98
"Oregon County, MO",MO,2016,4110,3864,246,6.0,-28
"Oregon County, MO",MO,2015,4138,3871,267,6.5,9
"Oregon County, MO",MO,2014,4129,3818,311,7.5,4
"Oregon County, MO",MO,2013,4125,3794,331,8.0,100
"Oregon County, MO",MO,2012,4025,3698,327,8.1,-20
"Oregon County, MO",MO,2011,4045,3640,405,10.0,-42
"Oregon County, MO",MO,2010,4087,3638,449,11.0,0
"Orleans County, NY",NY,2021,16976,16100,876,5.2,-378
"Orleans County, NY",NY,2020,17354,15957,1397,8.1,-570
"Orleans County, NY",NY,2019,17924,17110,814,4.5,14
"Orleans County, NY",NY,2018,17910,17029,881,4.9,63
"Orleans County, NY",NY,2017,17847,16800,1047,5.9,87
"Orleans County, NY",NY,2016,17760,16727,1033,5.8,-86
"Orleans County, NY",NY,2015,17846,16702,1144,6.4,-180
"Orleans County, NY",NY,2014,18026,16633,1393,7.7,-673
"Orleans County, NY",NY,2013,18699,16956,1743,9.3,-153
"Orleans County, NY",NY,2012,18852,16999,1853,9.8,10
"Orleans County, NY",NY,2011,18842,17088,1754,9.3,-332
"Orleans County, NY",NY,2010,19174,17299,1875,9.8,0
"Orleans County, VT",VT,2021,12770,12178,592,4.6,-348
"Orleans County, VT",VT,2020,13118,12105,1013,7.7,-656
"Orleans County, VT",VT,2019,13774,13200,574,4.2,-173
"Orleans County, VT",VT,2018,13947,13332,615,4.4,-41
"Orleans County, VT",VT,2017,13988,13272,716,5.1,416
"Orleans County, VT",VT,2016,13572,12883,689,5.1,-89
"Orleans County, VT",VT,2015,13661,12908,753,5.5,-19
"Orleans County, VT",VT,2014,13680,12822,858,6.3,-133
"Orleans County, VT",VT,2013,13813,12870,943,6.8,-258
"Orleans County, VT",VT,2012,14071,13013,1058,7.5,-87
"Orleans County, VT",VT,2011,14158,12948,1210,8.5,-82
"Orleans County, VT",VT,2010,14240,12926,1314,9.2,0
"Orleans Parish, LA",LA,2021,177776,162980,14796,8.3,-1998
"Orleans Parish, LA",LA,2020,179774,157276,22498,12.5,18
"Orleans Parish, LA",LA,2019,179756,171311,8445,4.7,730
"Orleans Parish, LA",LA,2018,179026,170148,8878,5.0,103
"Orleans Parish, LA",LA,2017,178923,169724,9199,5.1,-1264
"Orleans Parish, LA",LA,2016,180187,169604,10583,5.9,-1101
"Orleans Parish, LA",LA,2015,181288,169564,11724,6.5,3023
"Orleans Parish, LA",LA,2014,178265,166143,12122,6.8,4806
"Orleans Parish, LA",LA,2013,173459,161251,12208,7.0,3979
"Orleans Parish, LA",LA,2012,169480,156736,12744,7.5,3242
"Orleans Parish, LA",LA,2011,166238,152605,13633,8.2,3853
"Orleans Parish, LA",LA,2010,162385,149075,13310,8.2,0
"Orocovis Municipio, PR",PR,2021,5169,4645,524,10.1,
"Orocovis Municipio, PR",PR,2020,N.A.,N.A.,N.A.,N.A.,
"Orocovis Municipio, PR",PR,2019,4947,4441,506,10.2,-48
"Orocovis Municipio, PR",PR,2018,4995,4380,615,12.3,-101
"Orocovis Municipio, PR",PR,2017,5096,4369,727,14.3,-108
"Orocovis Municipio, PR",PR,2016,5204,4397,807,15.5,-50
"Orocovis Municipio, PR",PR,2015,5254,4396,858,16.3,-135
"Orocovis Municipio, PR",PR,2014,5389,4365,1024,19.0,-153
"Orocovis Municipio, PR",PR,2013,5542,4506,1036,18.7,-184
"Orocovis Municipio, PR",PR,2012,5726,4588,1138,19.9,-62
"Orocovis Municipio, PR",PR,2011,5788,4591,1197,20.7,-301
"Orocovis Municipio, PR",PR,2010,6089,4728,1361,22.4,0
"Osage County, KS",KS,2021,8001,7764,237,3.0,51
"Osage County, KS",KS,2020,7950,7556,394,5.0,-94
"Osage County, KS",KS,2019,8044,7761,283,3.5,-13
"Osage County, KS",KS,2018,8057,7760,297,3.7,69
"Osage County, KS",KS,2017,7988,7674,314,3.9,-106
"Osage County, KS",KS,2016,8094,7738,356,4.4,16
"Osage County, KS",KS,2015,8078,7676,402,5.0,-72
"Osage County, KS",KS,2014,8150,7710,440,5.4,-144
"Osage County, KS",KS,2013,8294,7744,550,6.6,-77
"Osage County, KS",KS,2012,8371,7769,602,7.2,-231
"Osage County, KS",KS,2011,8602,7903,699,8.1,-11
"Osage County, KS",KS,2010,8613,7912,701,8.1,0
"Osage County, MO",MO,2021,6985,6801,184,2.6,-30
"Osage County, MO",MO,2020,7015,6764,251,3.6,-34
"Osage County, MO",MO,2019,7049,6890,159,2.3,4
"Osage County, MO",MO,2018,7045,6879,166,2.4,-63
"Osage County, MO",MO,2017,7108,6897,211,3.0,-111
"Osage County, MO",MO,2016,7219,6974,245,3.4,105
"Osage County, MO",MO,2015,7114,6842,272,3.8,-84
"Osage County, MO",MO,2014,7198,6862,336,4.7,14
"Osage County, MO",MO,2013,7184,6823,361,5.0,-94
"Osage County, MO",MO,2012,7278,6900,378,5.2,-107
"Osage County, MO",MO,2011,7385,6919,466,6.3,-51
"Osage County, MO",MO,2010,7436,6926,510,6.9,0
"Osage County, OK",OK,2021,20265,19410,855,4.2,135
"Osage County, OK",OK,2020,20130,18796,1334,6.6,-447
"Osage County, OK",OK,2019,20577,19836,741,3.6,-29
"Osage County, OK",OK,2018,20606,19757,849,4.1,-63
"Osage County, OK",OK,2017,20669,19658,1011,4.9,-371
"Osage County, OK",OK,2016,21040,19871,1169,5.6,-161
"Osage County, OK",OK,2015,21201,20111,1090,5.1,247
"Osage County, OK",OK,2014,20954,19915,1039,5.0,-127
"Osage County, OK",OK,2013,21081,19889,1192,5.7,-144
"Osage County, OK",OK,2012,21225,20023,1202,5.7,39
"Osage County, OK",OK,2011,21186,19822,1364,6.4,-16
"Osage County, OK",OK,2010,21202,19629,1573,7.4,0
"Osborne County, KS",KS,2021,1961,1925,36,1.8,-11
"Osborne County, KS",KS,2020,1972,1920,52,2.6,-70
"Osborne County, KS",KS,2019,2042,2002,40,2.0,-9
"Osborne County, KS",KS,2018,2051,2000,51,2.5,29
"Osborne County, KS",KS,2017,2022,1967,55,2.7,-46
"Osborne County, KS",KS,2016,2068,1998,70,3.4,-28
"Osborne County, KS",KS,2015,2096,2023,73,3.5,36
"Osborne County, KS",KS,2014,2060,1984,76,3.7,-66
"Osborne County, KS",KS,2013,2126,2036,90,4.2,-54
"Osborne County, KS",KS,2012,2180,2087,93,4.3,-92
"Osborne County, KS",KS,2011,2272,2172,100,4.4,48
"Osborne County, KS",KS,2010,2224,2118,106,4.8,0
"Osceola County, FL",FL,2021,185839,174170,11669,6.3,-4326
"Osceola County, FL",FL,2020,190165,162828,27337,14.4,6068
"Osceola County, FL",FL,2019,184097,177876,6221,3.4,4872
"Osceola County, FL",FL,2018,179225,172446,6779,3.8,7521
"Osceola County, FL",FL,2017,171704,164153,7551,4.4,6912
"Osceola County, FL",FL,2016,164792,156541,8251,5.0,6900
"Osceola County, FL",FL,2015,157892,148689,9203,5.8,5437
"Osceola County, FL",FL,2014,152455,141903,10552,6.9,4889
"Osceola County, FL",FL,2013,147566,135390,12176,8.3,4904
"Osceola County, FL",FL,2012,142662,128766,13896,9.7,3208
"Osceola County, FL",FL,2011,139454,123764,15690,11.3,3337
"Osceola County, FL",FL,2010,136117,119677,16440,12.1,0
"Osceola County, IA",IA,2021,3530,3445,85,2.4,2
"Osceola County, IA",IA,2020,3528,3428,100,2.8,-70
"Osceola County, IA",IA,2019,3598,3532,66,1.8,28
"Osceola County, IA",IA,2018,3570,3502,68,1.9,-56
"Osceola County, IA",IA,2017,3626,3552,74,2.0,-36
"Osceola County, IA",IA,2016,3662,3566,96,2.6,117
"Osceola County, IA",IA,2015,3545,3445,100,2.8,85
"Osceola County, IA",IA,2014,3460,3345,115,3.3,46
"Osceola County, IA",IA,2013,3414,3283,131,3.8,16
"Osceola County, IA",IA,2012,3398,3256,142,4.2,-145
"Osceola County, IA",IA,2011,3543,3382,161,4.5,-116
"Osceola County, IA",IA,2010,3659,3476,183,5.0,0
"Osceola County, MI",MI,2021,11277,10653,624,5.5,-232
"Osceola County, MI",MI,2020,11509,10513,996,8.7,243
"Osceola County, MI",MI,2019,11266,10802,464,4.1,363
"Osceola County, MI",MI,2018,10903,10416,487,4.5,274
"Osceola County, MI",MI,2017,10629,10004,625,5.9,167
"Osceola County, MI",MI,2016,10462,9859,603,5.8,252
"Osceola County, MI",MI,2015,10210,9537,673,6.6,-27
"Osceola County, MI",MI,2014,10237,9362,875,8.5,184
"Osceola County, MI",MI,2013,10053,9060,993,9.9,47
"Osceola County, MI",MI,2012,10006,9021,985,9.8,-134
"Osceola County, MI",MI,2011,10140,9032,1108,10.9,-138
"Osceola County, MI",MI,2010,10278,8920,1358,13.2,0
"Oscoda County, MI",MI,2021,2630,2391,239,9.1,-166
"Oscoda County, MI",MI,2020,2796,2434,362,12.9,-197
"Oscoda County, MI",MI,2019,2993,2779,214,7.2,41
"Oscoda County, MI",MI,2018,2952,2761,191,6.5,39
"Oscoda County, MI",MI,2017,2913,2702,211,7.2,-2
"Oscoda County, MI",MI,2016,2915,2700,215,7.4,-11
"Oscoda County, MI",MI,2015,2926,2669,257,8.8,-59
"Oscoda County, MI",MI,2014,2985,2632,353,11.8,16
"Oscoda County, MI",MI,2013,2969,2510,459,15.5,-25
"Oscoda County, MI",MI,2012,2994,2531,463,15.5,-138
"Oscoda County, MI",MI,2011,3132,2595,537,17.1,-143
"Oscoda County, MI",MI,2010,3275,2652,623,19.0,0
"Oswego County, NY",NY,2021,51853,48999,2854,5.5,-1101
"Oswego County, NY",NY,2020,52954,48386,4568,8.6,-920
"Oswego County, NY",NY,2019,53874,51056,2818,5.2,11
"Oswego County, NY",NY,2018,53863,50939,2924,5.4,182
"Oswego County, NY",NY,2017,53681,50231,3450,6.4,346
"Oswego County, NY",NY,2016,53335,49835,3500,6.6,-605
"Oswego County, NY",NY,2015,53940,50041,3899,7.2,-1053
"Oswego County, NY",NY,2014,54993,50518,4475,8.1,-2200
"Oswego County, NY",NY,2013,57193,51407,5786,10.1,-692
"Oswego County, NY",NY,2012,57885,51445,6440,11.1,-211
"Oswego County, NY",NY,2011,58096,51792,6304,10.9,-880
"Oswego County, NY",NY,2010,58976,52573,6403,10.9,0
"Otero County, CO",CO,2021,8366,7854,512,6.1,187
"Otero County, CO",CO,2020,8179,7701,478,5.8,-56
"Otero County, CO",CO,2019,8235,7917,318,3.9,-74
"Otero County, CO",CO,2018,8309,7921,388,4.7,115
"Otero County, CO",CO,2017,8194,7878,316,3.9,84
"Otero County, CO",CO,2016,8110,7745,365,4.5,233
"Otero County, CO",CO,2015,7877,7437,440,5.6,-89
"Otero County, CO",CO,2014,7966,7360,606,7.6,-233
"Otero County, CO",CO,2013,8199,7405,794,9.7,-180
"Otero County, CO",CO,2012,8379,7508,871,10.4,-84
"Otero County, CO",CO,2011,8463,7587,876,10.4,-1
"Otero County, CO",CO,2010,8464,7650,814,9.6,0
"Otero County, NM",NM,2021,25093,23434,1659,6.6,-133
"Otero County, NM",NM,2020,25226,23181,2045,8.1,84
"Otero County, NM",NM,2019,25142,23878,1264,5.0,224
"Otero County, NM",NM,2018,24918,23702,1216,4.9,-298
"Otero County, NM",NM,2017,25216,23695,1521,6.0,-458
"Otero County, NM",NM,2016,25674,24101,1573,6.1,506
"Otero County, NM",NM,2015,25168,23594,1574,6.3,285
"Otero County, NM",NM,2014,24883,23347,1536,6.2,-514
"Otero County, NM",NM,2013,25397,23784,1613,6.4,316
"Otero County, NM",NM,2012,25081,23482,1599,6.4,524
"Otero County, NM",NM,2011,24557,22947,1610,6.6,-239
"Otero County, NM",NM,2010,24796,23075,1721,6.9,0
"Otoe County, NE",NE,2021,8597,8399,198,2.3,146
"Otoe County, NE",NE,2020,8451,8157,294,3.5,-61
"Otoe County, NE",NE,2019,8512,8242,270,3.2,268
"Otoe County, NE",NE,2018,8244,8003,241,2.9,12
"Otoe County, NE",NE,2017,8232,7954,278,3.4,-75
"Otoe County, NE",NE,2016,8307,8026,281,3.4,75
"Otoe County, NE",NE,2015,8232,7961,271,3.3,-16
"Otoe County, NE",NE,2014,8248,7945,303,3.7,-161
"Otoe County, NE",NE,2013,8409,8058,351,4.2,-84
"Otoe County, NE",NE,2012,8493,8120,373,4.4,-65
"Otoe County, NE",NE,2011,8558,8123,435,5.1,93
"Otoe County, NE",NE,2010,8465,8030,435,5.1,0
"Otsego County, MI",MI,2021,11351,10579,772,6.8,-251
"Otsego County, MI",MI,2020,11602,10364,1238,10.7,-31
"Otsego County, MI",MI,2019,11633,11045,588,5.1,21
"Otsego County, MI",MI,2018,11612,10997,615,5.3,-48
"Otsego County, MI",MI,2017,11660,10970,690,5.9,-61
"Otsego County, MI",MI,2016,11721,11017,704,6.0,257
"Otsego County, MI",MI,2015,11464,10751,713,6.2,229
"Otsego County, MI",MI,2014,11235,10321,914,8.1,-21
"Otsego County, MI",MI,2013,11256,10094,1162,10.3,27
"Otsego County, MI",MI,2012,11229,10040,1189,10.6,-188
"Otsego County, MI",MI,2011,11417,10081,1336,11.7,-331
"Otsego County, MI",MI,2010,11748,10123,1625,13.8,0
"Otsego County, NY",NY,2021,26786,25595,1191,4.4,-285
"Otsego County, NY",NY,2020,27071,25196,1875,6.9,-1488
"Otsego County, NY",NY,2019,28559,27394,1165,4.1,-77
"Otsego County, NY",NY,2018,28636,27397,1239,4.3,97
"Otsego County, NY",NY,2017,28539,27119,1420,5.0,324
"Otsego County, NY",NY,2016,28215,26806,1409,5.0,-442
"Otsego County, NY",NY,2015,28657,27100,1557,5.4,-1309
"Otsego County, NY",NY,2014,29966,28240,1726,5.8,-1128
"Otsego County, NY",NY,2013,31094,28920,2174,7.0,-317
"Otsego County, NY",NY,2012,31411,28909,2502,8.0,-9
"Otsego County, NY",NY,2011,31420,28972,2448,7.8,-487
"Otsego County, NY",NY,2010,31907,29443,2464,7.7,0
"Ottawa County, KS",KS,2021,2967,2885,82,2.8,-4
"Ottawa County, KS",KS,2020,2971,2852,119,4.0,-53
"Ottawa County, KS",KS,2019,3024,2943,81,2.7,3
"Ottawa County, KS",KS,2018,3021,2937,84,2.8,-48
"Ottawa County, KS",KS,2017,3069,2974,95,3.1,-108
"Ottawa County, KS",KS,2016,3177,3057,120,3.8,-61
"Ottawa County, KS",KS,2015,3238,3116,122,3.8,-9
"Ottawa County, KS",KS,2014,3247,3114,133,4.1,2
"Ottawa County, KS",KS,2013,3245,3099,146,4.5,13
"Ottawa County, KS",KS,2012,3232,3058,174,5.4,-54
"Ottawa County, KS",KS,2011,3286,3100,186,5.7,0
"Ottawa County, KS",KS,2010,3286,3093,193,5.9,0
"Ottawa County, MI",MI,2021,156739,150355,6384,4.1,-2541
"Ottawa County, MI",MI,2020,159280,147975,11305,7.1,-2581
"Ottawa County, MI",MI,2019,161861,157317,4544,2.8,822
"Ottawa County, MI",MI,2018,161039,156454,4585,2.8,2878
"Ottawa County, MI",MI,2017,158161,153056,5105,3.2,2373
"Ottawa County, MI",MI,2016,155788,150491,5297,3.4,2678
"Ottawa County, MI",MI,2015,153110,147476,5634,3.7,3530
"Ottawa County, MI",MI,2014,149580,142408,7172,4.8,4336
"Ottawa County, MI",MI,2013,145244,136483,8761,6.0,3083
"Ottawa County, MI",MI,2012,142161,132919,9242,6.5,2768
"Ottawa County, MI",MI,2011,139393,128745,10648,7.6,72
"Ottawa County, MI",MI,2010,139321,125410,13911,10.0,0
"Ottawa County, OH",OH,2021,20630,19371,1259,6.1,64
"Ottawa County, OH",OH,2020,20566,18690,1876,9.1,-638
"Ottawa County, OH",OH,2019,21204,19991,1213,5.7,-1
"Ottawa County, OH",OH,2018,21205,19873,1332,6.3,-124
"Ottawa County, OH",OH,2017,21329,19898,1431,6.7,211
"Ottawa County, OH",OH,2016,21118,19744,1374,6.5,17
"Ottawa County, OH",OH,2015,21101,19691,1410,6.7,-447
"Ottawa County, OH",OH,2014,21548,19902,1646,7.6,-404
"Ottawa County, OH",OH,2013,21952,19828,2124,9.7,-52
"Ottawa County, OH",OH,2012,22004,19910,2094,9.5,-406
"Ottawa County, OH",OH,2011,22410,19934,2476,11.0,-301
"Ottawa County, OH",OH,2010,22711,19906,2805,12.4,0
"Ottawa County, OK",OK,2021,14418,13957,461,3.2,192
"Ottawa County, OK",OK,2020,14226,13408,818,5.8,53
"Ottawa County, OK",OK,2019,14173,13723,450,3.2,-142
"Ottawa County, OK",OK,2018,14315,13839,476,3.3,-114
"Ottawa County, OK",OK,2017,14429,13835,594,4.1,-21
"Ottawa County, OK",OK,2016,14450,13749,701,4.9,91
"Ottawa County, OK",OK,2015,14359,13641,718,5.0,573
"Ottawa County, OK",OK,2014,13786,12887,899,6.5,-324
"Ottawa County, OK",OK,2013,14110,13008,1102,7.8,-380
"Ottawa County, OK",OK,2012,14490,13385,1105,7.6,230
"Ottawa County, OK",OK,2011,14260,13233,1027,7.2,-273
"Ottawa County, OK",OK,2010,14533,13405,1128,7.8,0
"Otter Tail County, MN",MN,2021,30602,29566,1036,3.4,-1133
"Otter Tail County, MN",MN,2020,31735,29957,1778,5.6,-38
"Otter Tail County, MN",MN,2019,31773,30364,1409,4.4,263
"Otter Tail County, MN",MN,2018,31510,30295,1215,3.9,-173
"Otter Tail County, MN",MN,2017,31683,30413,1270,4.0,408
"Otter Tail County, MN",MN,2016,31275,29913,1362,4.4,81
"Otter Tail County, MN",MN,2015,31194,29856,1338,4.3,239
"Otter Tail County, MN",MN,2014,30955,29517,1438,4.6,56
"Otter Tail County, MN",MN,2013,30899,29252,1647,5.3,89
"Otter Tail County, MN",MN,2012,30810,29088,1722,5.6,-147
"Otter Tail County, MN",MN,2011,30957,28969,1988,6.4,61
"Otter Tail County, MN",MN,2010,30896,28673,2223,7.2,0
"Ouachita County, AR",AR,2021,9716,9340,376,3.9,-124
"Ouachita County, AR",AR,2020,9840,9243,597,6.1,-6
"Ouachita County, AR",AR,2019,9846,9351,495,5.0,90
"Ouachita County, AR",AR,2018,9756,9313,443,4.5,34
"Ouachita County, AR",AR,2017,9722,9275,447,4.6,-175
"Ouachita County, AR",AR,2016,9897,9399,498,5.0,-80
"Ouachita County, AR",AR,2015,9977,9357,620,6.2,-108
"Ouachita County, AR",AR,2014,10085,9304,781,7.7,-295
"Ouachita County, AR",AR,2013,10380,9406,974,9.4,-234
"Ouachita County, AR",AR,2012,10614,9550,1064,10.0,-476
"Ouachita County, AR",AR,2011,11090,9982,1108,10.0,-296
"Ouachita County, AR",AR,2010,11386,10346,1040,9.1,0
"Ouachita Parish, LA",LA,2021,69404,65924,3480,5.0,30
"Ouachita Parish, LA",LA,2020,69374,63914,5460,7.9,-1072
"Ouachita Parish, LA",LA,2019,70446,66849,3597,5.1,-657
"Ouachita Parish, LA",LA,2018,71103,67486,3617,5.1,370
"Ouachita Parish, LA",LA,2017,70733,67017,3716,5.3,-907
"Ouachita Parish, LA",LA,2016,71640,67279,4361,6.1,-343
"Ouachita Parish, LA",LA,2015,71983,67230,4753,6.6,315
"Ouachita Parish, LA",LA,2014,71668,66761,4907,6.8,692
"Ouachita Parish, LA",LA,2013,70976,66065,4911,6.9,-30
"Ouachita Parish, LA",LA,2012,71006,65785,5221,7.4,926
"Ouachita Parish, LA",LA,2011,70080,64533,5547,7.9,-587
"Ouachita Parish, LA",LA,2010,70667,65154,5513,7.8,0
"Ouray County, CO",CO,2021,2708,2586,122,4.5,227
"Ouray County, CO",CO,2020,2481,2291,190,7.7,64
"Ouray County, CO",CO,2019,2417,2350,67,2.8,54
"Ouray County, CO",CO,2018,2363,2287,76,3.2,121
"Ouray County, CO",CO,2017,2242,2182,60,2.7,76
"Ouray County, CO",CO,2016,2166,2088,78,3.6,12
"Ouray County, CO",CO,2015,2154,2064,90,4.2,21
"Ouray County, CO",CO,2014,2133,2010,123,5.8,7
"Ouray County, CO",CO,2013,2126,1967,159,7.5,47
"Ouray County, CO",CO,2012,2079,1882,197,9.5,57
"Ouray County, CO",CO,2011,2022,1807,215,10.6,-126
"Ouray County, CO",CO,2010,2148,1925,223,10.4,0
"Outagamie County, WI",WI,2021,105055,101769,3286,3.1,903
"Outagamie County, WI",WI,2020,104152,98393,5759,5.5,431
"Outagamie County, WI",WI,2019,103721,100792,2929,2.8,15
"Outagamie County, WI",WI,2018,103706,100823,2883,2.8,-589
"Outagamie County, WI",WI,2017,104295,101177,3118,3.0,678
"Outagamie County, WI",WI,2016,103617,100040,3577,3.5,1900
"Outagamie County, WI",WI,2015,101717,97778,3939,3.9,541
"Outagamie County, WI",WI,2014,101176,96425,4751,4.7,715
"Outagamie County, WI",WI,2013,100461,94378,6083,6.1,249
"Outagamie County, WI",WI,2012,100212,93883,6329,6.3,70
"Outagamie County, WI",WI,2011,100142,93255,6887,6.9,-522
"Outagamie County, WI",WI,2010,100664,92663,8001,7.9,0
"Overton County, TN",TN,2021,9950,9594,356,3.6,210
"Overton County, TN",TN,2020,9740,9129,611,6.3,-234
"Overton County, TN",TN,2019,9974,9595,379,3.8,161
"Overton County, TN",TN,2018,9813,9444,369,3.8,278
"Overton County, TN",TN,2017,9535,9140,395,4.1,313
"Overton County, TN",TN,2016,9222,8727,495,5.4,115
"Overton County, TN",TN,2015,9107,8463,644,7.1,-35
"Overton County, TN",TN,2014,9142,8418,724,7.9,-384
"Overton County, TN",TN,2013,9526,8671,855,9.0,-200
"Overton County, TN",TN,2012,9726,8844,882,9.1,-267
"Overton County, TN",TN,2011,9993,8956,1037,10.4,-262
"Overton County, TN",TN,2010,10255,9141,1114,10.9,0
"Owen County, IN",IN,2021,9156,8830,326,3.6,141
"Owen County, IN",IN,2020,9015,8436,579,6.4,-319
"Owen County, IN",IN,2019,9334,8965,369,4.0,-13
"Owen County, IN",IN,2018,9347,8945,402,4.3,157
"Owen County, IN",IN,2017,9190,8794,396,4.3,-78
"Owen County, IN",IN,2016,9268,8759,509,5.5,-15
"Owen County, IN",IN,2015,9283,8701,582,6.3,-203
"Owen County, IN",IN,2014,9486,8719,767,8.1,-163
"Owen County, IN",IN,2013,9649,8695,954,9.9,-187
"Owen County, IN",IN,2012,9836,8782,1054,10.7,-323
"Owen County, IN",IN,2011,10159,9037,1122,11.0,-157
"Owen County, IN",IN,2010,10316,9155,1161,11.3,0
"Owen County, KY",KY,2021,5092,4875,217,4.3,7
"Owen County, KY",KY,2020,5085,4770,315,6.2,-57
"Owen County, KY",KY,2019,5142,4919,223,4.3,-62
"Owen County, KY",KY,2018,5204,4954,250,4.8,-249
"Owen County, KY",KY,2017,5453,5217,236,4.3,-37
"Owen County, KY",KY,2016,5490,5257,233,4.2,120
"Owen County, KY",KY,2015,5370,5150,220,4.1,-157
"Owen County, KY",KY,2014,5527,5251,276,5.0,-156
"Owen County, KY",KY,2013,5683,5327,356,6.3,-68
"Owen County, KY",KY,2012,5751,5373,378,6.6,38
"Owen County, KY",KY,2011,5713,5281,432,7.6,-231
"Owen County, KY",KY,2010,5944,5440,504,8.5,0
"Owsley County, KY",KY,2021,1054,980,74,7.0,-24
"Owsley County, KY",KY,2020,1078,978,100,9.3,-13
"Owsley County, KY",KY,2019,1091,1016,75,6.9,-45
"Owsley County, KY",KY,2018,1136,1055,81,7.1,36
"Owsley County, KY",KY,2017,1100,1010,90,8.2,-20
"Owsley County, KY",KY,2016,1120,1012,108,9.6,-17
"Owsley County, KY",KY,2015,1137,1023,114,10.0,-42
"Owsley County, KY",KY,2014,1179,1056,123,10.4,-111
"Owsley County, KY",KY,2013,1290,1129,161,12.5,-38
"Owsley County, KY",KY,2012,1328,1157,171,12.9,-66
"Owsley County, KY",KY,2011,1394,1209,185,13.3,24
"Owsley County, KY",KY,2010,1370,1186,184,13.4,0
"Owyhee County, ID",ID,2021,5604,5361,243,4.3,48
"Owyhee County, ID",ID,2020,5556,5221,335,6.0,87
"Owyhee County, ID",ID,2019,5469,5280,189,3.5,25
"Owyhee County, ID",ID,2018,5444,5244,200,3.7,103
"Owyhee County, ID",ID,2017,5341,5129,212,4.0,65
"Owyhee County, ID",ID,2016,5276,5042,234,4.4,61
"Owyhee County, ID",ID,2015,5215,4983,232,4.4,213
"Owyhee County, ID",ID,2014,5002,4838,164,3.3,-150
"Owyhee County, ID",ID,2013,5152,4930,222,4.3,34
"Owyhee County, ID",ID,2012,5118,4901,217,4.2,235
"Owyhee County, ID",ID,2011,4883,4676,207,4.2,-179
"Owyhee County, ID",ID,2010,5062,4856,206,4.1,0
"Oxford County, ME",ME,2021,26298,24828,1470,5.6,522
"Oxford County, ME",ME,2020,25776,24197,1579,6.1,-1007
"Oxford County, ME",ME,2019,26783,25908,875,3.3,-114
"Oxford County, ME",ME,2018,26897,25912,985,3.7,-155
"Oxford County, ME",ME,2017,27052,26006,1046,3.9,417
"Oxford County, ME",ME,2016,26635,25409,1226,4.6,-72
"Oxford County, ME",ME,2015,26707,25250,1457,5.5,-706
"Oxford County, ME",ME,2014,27413,25504,1909,7.0,-312
"Oxford County, ME",ME,2013,27725,25412,2313,8.3,-79
"Oxford County, ME",ME,2012,27804,25205,2599,9.3,-33
"Oxford County, ME",ME,2011,27837,24977,2860,10.3,-218
"Oxford County, ME",ME,2010,28055,24947,3108,11.1,0
"Ozark County, MO",MO,2021,3442,3254,188,5.5,-21
"Ozark County, MO",MO,2020,3463,3214,249,7.2,52
"Ozark County, MO",MO,2019,3411,3225,186,5.5,-26
"Ozark County, MO",MO,2018,3437,3263,174,5.1,-127
"Ozark County, MO",MO,2017,3564,3358,206,5.8,-63
"Ozark County, MO",MO,2016,3627,3364,263,7.3,-1
"Ozark County, MO",MO,2015,3628,3333,295,8.1,-25
"Ozark County, MO",MO,2014,3653,3324,329,9.0,-15
"Ozark County, MO",MO,2013,3668,3285,383,10.4,93
"Ozark County, MO",MO,2012,3575,3200,375,10.5,7
"Ozark County, MO",MO,2011,3568,3136,432,12.1,-19
"Ozark County, MO",MO,2010,3587,3168,419,11.7,0
"Ozaukee County, WI",WI,2021,49395,47882,1513,3.1,420
"Ozaukee County, WI",WI,2020,48975,46310,2665,5.4,-308
"Ozaukee County, WI",WI,2019,49283,47943,1340,2.7,-148
"Ozaukee County, WI",WI,2018,49431,48192,1239,2.5,121
"Ozaukee County, WI",WI,2017,49310,47960,1350,2.7,386
"Ozaukee County, WI",WI,2016,48924,47327,1597,3.3,795
"Ozaukee County, WI",WI,2015,48129,46393,1736,3.6,234
"Ozaukee County, WI",WI,2014,47895,45896,1999,4.2,375
"Ozaukee County, WI",WI,2013,47520,45048,2472,5.2,186
"Ozaukee County, WI",WI,2012,47334,44774,2560,5.4,-22
"Ozaukee County, WI",WI,2011,47356,44532,2824,6.0,-104
"Ozaukee County, WI",WI,2010,47460,44157,3303,7.0,0
"Pacific County, WA",WA,2021,8569,7894,675,7.9,273
"Pacific County, WA",WA,2020,8296,7385,911,11.0,-332
"Pacific County, WA",WA,2019,8628,8012,616,7.1,167
"Pacific County, WA",WA,2018,8461,7881,580,6.9,86
"Pacific County, WA",WA,2017,8375,7793,582,6.9,80
"Pacific County, WA",WA,2016,8295,7637,658,7.9,204
"Pacific County, WA",WA,2015,8091,7385,706,8.7,253
"Pacific County, WA",WA,2014,7838,7084,754,9.6,-148
"Pacific County, WA",WA,2013,7986,7103,883,11.1,-150
"Pacific County, WA",WA,2012,8136,7235,901,11.1,33
"Pacific County, WA",WA,2011,8103,7119,984,12.1,-471
"Pacific County, WA",WA,2010,8574,7483,1091,12.7,0
"Page County, IA",IA,2021,6279,6022,257,4.1,40
"Page County, IA",IA,2020,6239,5935,304,4.9,-268
"Page County, IA",IA,2019,6507,6350,157,2.4,21
"Page County, IA",IA,2018,6486,6324,162,2.5,77
"Page County, IA",IA,2017,6409,6164,245,3.8,-89
"Page County, IA",IA,2016,6498,6176,322,5.0,-72
"Page County, IA",IA,2015,6570,6301,269,4.1,-28
"Page County, IA",IA,2014,6598,6306,292,4.4,35
"Page County, IA",IA,2013,6563,6216,347,5.3,-140
"Page County, IA",IA,2012,6703,6340,363,5.4,-186
"Page County, IA",IA,2011,6889,6487,402,5.8,-227
"Page County, IA",IA,2010,7116,6623,493,6.9,0
"Page County, VA",VA,2021,11897,11344,553,4.6,-125
"Page County, VA",VA,2020,12022,11143,879,7.3,-168
"Page County, VA",VA,2019,12190,11726,464,3.8,181
"Page County, VA",VA,2018,12009,11512,497,4.1,28
"Page County, VA",VA,2017,11981,11373,608,5.1,375
"Page County, VA",VA,2016,11606,10971,635,5.5,-78
"Page County, VA",VA,2015,11684,10891,793,6.8,-179
"Page County, VA",VA,2014,11863,10925,938,7.9,-71
"Page County, VA",VA,2013,11934,10860,1074,9.0,-238
"Page County, VA",VA,2012,12172,10955,1217,10.0,-294
"Page County, VA",VA,2011,12466,11091,1375,11.0,106
"Page County, VA",VA,2010,12360,10894,1466,11.9,0
"Palm Beach County, FL",FL,2021,734055,702386,31669,4.3,18640
"Palm Beach County, FL",FL,2020,715415,656556,58859,8.2,-13404
"Palm Beach County, FL",FL,2019,728819,704365,24454,3.4,7398
"Palm Beach County, FL",FL,2018,721421,694667,26754,3.7,4893
"Palm Beach County, FL",FL,2017,716528,686091,30437,4.2,4919
"Palm Beach County, FL",FL,2016,711609,677839,33770,4.7,18027
"Palm Beach County, FL",FL,2015,693582,657771,35811,5.2,9861
"Palm Beach County, FL",FL,2014,683721,642418,41303,6.0,13136
"Palm Beach County, FL",FL,2013,670585,620621,49964,7.5,14172
"Palm Beach County, FL",FL,2012,656413,598903,57510,8.8,7472
"Palm Beach County, FL",FL,2011,648941,583845,65096,10.0,8633
"Palm Beach County, FL",FL,2010,640308,572130,68178,10.6,0
"Palo Alto County, IA",IA,2021,4486,4336,150,3.3,-96
"Palo Alto County, IA",IA,2020,4582,4377,205,4.5,-313
"Palo Alto County, IA",IA,2019,4895,4792,103,2.1,-38
"Palo Alto County, IA",IA,2018,4933,4825,108,2.2,-8
"Palo Alto County, IA",IA,2017,4941,4811,130,2.6,-51
"Palo Alto County, IA",IA,2016,4992,4839,153,3.1,127
"Palo Alto County, IA",IA,2015,4865,4716,149,3.1,11
"Palo Alto County, IA",IA,2014,4854,4679,175,3.6,71
"Palo Alto County, IA",IA,2013,4783,4604,179,3.7,7
"Palo Alto County, IA",IA,2012,4776,4571,205,4.3,-19
"Palo Alto County, IA",IA,2011,4795,4565,230,4.8,-38
"Palo Alto County, IA",IA,2010,4833,4536,297,6.1,0
"Palo Pinto County, TX",TX,2021,12902,12161,741,5.7,-179
"Palo Pinto County, TX",TX,2020,13081,12161,920,7.0,-333
"Palo Pinto County, TX",TX,2019,13414,12990,424,3.2,42
"Palo Pinto County, TX",TX,2018,13372,12920,452,3.4,71
"Palo Pinto County, TX",TX,2017,13301,12751,550,4.1,45
"Palo Pinto County, TX",TX,2016,13256,12530,726,5.5,83
"Palo Pinto County, TX",TX,2015,13173,12482,691,5.2,-184
"Palo Pinto County, TX",TX,2014,13357,12660,697,5.2,-2
"Palo Pinto County, TX",TX,2013,13359,12478,881,6.6,-26
"Palo Pinto County, TX",TX,2012,13385,12489,896,6.7,-91
"Palo Pinto County, TX",TX,2011,13476,12375,1101,8.2,202
"Palo Pinto County, TX",TX,2010,13274,12123,1151,8.7,0
"Pamlico County, NC",NC,2021,5296,5069,227,4.3,140
"Pamlico County, NC",NC,2020,5156,4878,278,5.4,-188
"Pamlico County, NC",NC,2019,5344,5146,198,3.7,95
"Pamlico County, NC",NC,2018,5249,5029,220,4.2,-62
"Pamlico County, NC",NC,2017,5311,5066,245,4.6,-81
"Pamlico County, NC",NC,2016,5392,5107,285,5.3,62
"Pamlico County, NC",NC,2015,5330,5016,314,5.9,28
"Pamlico County, NC",NC,2014,5302,4960,342,6.5,-37
"Pamlico County, NC",NC,2013,5339,4903,436,8.2,-79
"Pamlico County, NC",NC,2012,5418,4917,501,9.2,-92
"Pamlico County, NC",NC,2011,5510,4975,535,9.7,-13
"Pamlico County, NC",NC,2010,5523,4966,557,10.1,0
"Panola County, MS",MS,2021,12578,11686,892,7.1,24
"Panola County, MS",MS,2020,12554,11350,1204,9.6,-106
"Panola County, MS",MS,2019,12660,11823,837,6.6,-162
"Panola County, MS",MS,2018,12822,12024,798,6.2,-213
"Panola County, MS",MS,2017,13035,12135,900,6.9,-93
"Panola County, MS",MS,2016,13128,12143,985,7.5,-276
"Panola County, MS",MS,2015,13404,12222,1182,8.8,27
"Panola County, MS",MS,2014,13377,11951,1426,10.7,-302
"Panola County, MS",MS,2013,13679,12058,1621,11.9,-770
"Panola County, MS",MS,2012,14449,12728,1721,11.9,-282
"Panola County, MS",MS,2011,14731,12830,1901,12.9,309
"Panola County, MS",MS,2010,14422,12521,1901,13.2,0
"Panola County, TX",TX,2021,9691,9040,651,6.7,353
"Panola County, TX",TX,2020,9338,8554,784,8.4,-661
"Panola County, TX",TX,2019,9999,9594,405,4.1,-598
"Panola County, TX",TX,2018,10597,10151,446,4.2,266
"Panola County, TX",TX,2017,10331,9766,565,5.5,96
"Panola County, TX",TX,2016,10235,9500,735,7.2,-1339
"Panola County, TX",TX,2015,11574,10965,609,5.3,-967
"Panola County, TX",TX,2014,12541,11913,628,5.0,-182
"Panola County, TX",TX,2013,12723,11930,793,6.2,431
"Panola County, TX",TX,2012,12292,11454,838,6.8,350
"Panola County, TX",TX,2011,11942,10933,1009,8.4,521
"Panola County, TX",TX,2010,11421,10383,1038,9.1,0
"Park County, CO",CO,2021,11273,10810,463,4.1,304
"Park County, CO",CO,2020,10969,10370,599,5.5,-198
"Park County, CO",CO,2019,11167,10905,262,2.3,245
"Park County, CO",CO,2018,10922,10636,286,2.6,547
"Park County, CO",CO,2017,10375,10147,228,2.2,539
"Park County, CO",CO,2016,9836,9574,262,2.7,466
"Park County, CO",CO,2015,9370,9060,310,3.3,18
"Park County, CO",CO,2014,9352,8924,428,4.6,103
"Park County, CO",CO,2013,9249,8698,551,6.0,-21
"Park County, CO",CO,2012,9270,8627,643,6.9,-107
"Park County, CO",CO,2011,9377,8636,741,7.9,-228
"Park County, CO",CO,2010,9605,8786,819,8.5,0
"Park County, MT",MT,2021,9253,8926,327,3.5,245
"Park County, MT",MT,2020,9008,8354,654,7.3,-63
"Park County, MT",MT,2019,9071,8755,316,3.5,151
"Park County, MT",MT,2018,8920,8576,344,3.9,241
"Park County, MT",MT,2017,8679,8334,345,4.0,273
"Park County, MT",MT,2016,8406,8032,374,4.4,102
"Park County, MT",MT,2015,8304,7895,409,4.9,236
"Park County, MT",MT,2014,8068,7617,451,5.6,52
"Park County, MT",MT,2013,8016,7513,503,6.3,-5
"Park County, MT",MT,2012,8021,7479,542,6.8,144
"Park County, MT",MT,2011,7877,7250,627,8.0,-18
"Park County, MT",MT,2010,7895,7212,683,8.7,0
"Park County, WY",WY,2021,15562,14926,636,4.1,359
"Park County, WY",WY,2020,15203,14385,818,5.4,-163
"Park County, WY",WY,2019,15366,14720,646,4.2,-297
"Park County, WY",WY,2018,15663,14979,684,4.4,-72
"Park County, WY",WY,2017,15735,15045,690,4.4,-196
"Park County, WY",WY,2016,15931,15174,757,4.8,294
"Park County, WY",WY,2015,15637,14974,663,4.2,68
"Park County, WY",WY,2014,15569,14842,727,4.7,-67
"Park County, WY",WY,2013,15636,14832,804,5.1,-439
"Park County, WY",WY,2012,16075,15157,918,5.7,187
"Park County, WY",WY,2011,15888,14913,975,6.1,116
"Park County, WY",WY,2010,15772,14730,1042,6.6,0
"Parke County, IN",IN,2021,6916,6715,201,2.9,63
"Parke County, IN",IN,2020,6853,6474,379,5.5,-201
"Parke County, IN",IN,2019,7054,6789,265,3.8,-105
"Parke County, IN",IN,2018,7159,6875,284,4.0,-31
"Parke County, IN",IN,2017,7190,6905,285,4.0,-83
"Parke County, IN",IN,2016,7273,6899,374,5.1,222
"Parke County, IN",IN,2015,7051,6655,396,5.6,98
"Parke County, IN",IN,2014,6953,6469,484,7.0,12
"Parke County, IN",IN,2013,6941,6312,629,9.1,-53
"Parke County, IN",IN,2012,6994,6288,706,10.1,-214
"Parke County, IN",IN,2011,7208,6470,738,10.2,-125
"Parke County, IN",IN,2010,7333,6552,781,10.7,0
"Parker County, TX",TX,2021,71585,68413,3172,4.4,2516
"Parker County, TX",TX,2020,69069,65054,4015,5.8,1146
"Parker County, TX",TX,2019,67923,65947,1976,2.9,2612
"Parker County, TX",TX,2018,65311,63271,2040,3.1,2549
"Parker County, TX",TX,2017,62762,60568,2194,3.5,1465
"Parker County, TX",TX,2016,61297,58798,2499,4.1,1708
"Parker County, TX",TX,2015,59589,57095,2494,4.2,571
"Parker County, TX",TX,2014,59018,56288,2730,4.6,452
"Parker County, TX",TX,2013,58566,55298,3268,5.6,783
"Parker County, TX",TX,2012,57783,54376,3407,5.9,472
"Parker County, TX",TX,2011,57311,53236,4075,7.1,827
"Parker County, TX",TX,2010,56484,52163,4321,7.6,0
"Parmer County, TX",TX,2021,4976,4834,142,2.9,162
"Parmer County, TX",TX,2020,4814,4691,123,2.6,3
"Parmer County, TX",TX,2019,4811,4705,106,2.2,-28
"Parmer County, TX",TX,2018,4839,4725,114,2.4,-44
"Parmer County, TX",TX,2017,4883,4761,122,2.5,-67
"Parmer County, TX",TX,2016,4950,4825,125,2.5,-19
"Parmer County, TX",TX,2015,4969,4851,118,2.4,-150
"Parmer County, TX",TX,2014,5119,4960,159,3.1,63
"Parmer County, TX",TX,2013,5056,4859,197,3.9,62
"Parmer County, TX",TX,2012,4994,4790,204,4.1,-289
"Parmer County, TX",TX,2011,5283,5040,243,4.6,-76
"Parmer County, TX",TX,2010,5359,5122,237,4.4,0
"Pasco County, FL",FL,2021,246350,235484,10866,4.4,5624
"Pasco County, FL",FL,2020,240726,222182,18544,7.7,2555
"Pasco County, FL",FL,2019,238171,229604,8567,3.6,6416
"Pasco County, FL",FL,2018,231755,222514,9241,4.0,5246
"Pasco County, FL",FL,2017,226509,216222,10287,4.5,3259
"Pasco County, FL",FL,2016,223250,211693,11557,5.2,7008
"Pasco County, FL",FL,2015,216242,203402,12840,5.9,3512
"Pasco County, FL",FL,2014,212730,198120,14610,6.9,2812
"Pasco County, FL",FL,2013,209918,193095,16823,8.0,2506
"Pasco County, FL",FL,2012,207412,188053,19359,9.3,1909
"Pasco County, FL",FL,2011,205503,183302,22201,10.8,-47
"Pasco County, FL",FL,2010,205550,181719,23831,11.6,0
"Pasquotank County, NC",NC,2021,16273,15397,876,5.4,188
"Pasquotank County, NC",NC,2020,16085,14941,1144,7.1,-572
"Pasquotank County, NC",NC,2019,16657,15903,754,4.5,-123
"Pasquotank County, NC",NC,2018,16780,15969,811,4.8,-328
"Pasquotank County, NC",NC,2017,17108,16162,946,5.5,-236
"Pasquotank County, NC",NC,2016,17344,16252,1092,6.3,-86
"Pasquotank County, NC",NC,2015,17430,16181,1249,7.2,162
"Pasquotank County, NC",NC,2014,17268,15916,1352,7.8,-428
"Pasquotank County, NC",NC,2013,17696,16041,1655,9.4,-586
"Pasquotank County, NC",NC,2012,18282,16402,1880,10.3,-80
"Pasquotank County, NC",NC,2011,18362,16472,1890,10.3,-199
"Pasquotank County, NC",NC,2010,18561,16739,1822,9.8,0
"Passaic County, NJ",NJ,2021,250345,229429,20916,8.4,-2776
"Passaic County, NJ",NJ,2020,253121,222250,30871,12.2,353
"Passaic County, NJ",NJ,2019,252768,242385,10383,4.1,4041
"Passaic County, NJ",NJ,2018,248727,236540,12187,4.9,-1445
"Passaic County, NJ",NJ,2017,250172,236165,14007,5.6,5588
"Passaic County, NJ",NJ,2016,244584,229603,14981,6.1,-2272
"Passaic County, NJ",NJ,2015,246856,229613,17243,7.0,-715
"Passaic County, NJ",NJ,2014,247571,227260,20311,8.2,-2729
"Passaic County, NJ",NJ,2013,250300,224904,25396,10.1,-3466
"Passaic County, NJ",NJ,2012,253766,225598,28168,11.1,-198
"Passaic County, NJ",NJ,2011,253964,226023,27941,11.0,-304
"Passaic County, NJ",NJ,2010,254268,225034,29234,11.5,0
"Patillas Municipio, PR",PR,2021,4507,4013,494,11.0,
"Patillas Municipio, PR",PR,2020,N.A.,N.A.,N.A.,N.A.,
"Patillas Municipio, PR",PR,2019,4339,3662,677,15.6,-41
"Patillas Municipio, PR",PR,2018,4380,3611,769,17.6,-263
"Patillas Municipio, PR",PR,2017,4643,3728,915,19.7,-170
"Patillas Municipio, PR",PR,2016,4813,3820,993,20.6,-34
"Patillas Municipio, PR",PR,2015,4847,3837,1010,20.8,-68
"Patillas Municipio, PR",PR,2014,4915,3747,1168,23.8,-224
"Patillas Municipio, PR",PR,2013,5139,3886,1253,24.4,-323
"Patillas Municipio, PR",PR,2012,5462,4090,1372,25.1,-230
"Patillas Municipio, PR",PR,2011,5692,4222,1470,25.8,-332
"Patillas Municipio, PR",PR,2010,6024,4441,1583,26.3,0
"Patrick County, VA",VA,2021,7016,6701,315,4.5,-220
"Patrick County, VA",VA,2020,7236,6743,493,6.8,-228
"Patrick County, VA",VA,2019,7464,7209,255,3.4,-44
"Patrick County, VA",VA,2018,7508,7221,287,3.8,-254
"Patrick County, VA",VA,2017,7762,7436,326,4.2,-200
"Patrick County, VA",VA,2016,7962,7582,380,4.8,295
"Patrick County, VA",VA,2015,7667,7258,409,5.3,-80
"Patrick County, VA",VA,2014,7747,7239,508,6.6,-51
"Patrick County, VA",VA,2013,7798,7166,632,8.1,-170
"Patrick County, VA",VA,2012,7968,7255,713,8.9,-68
"Patrick County, VA",VA,2011,8036,7169,867,10.8,-310
"Patrick County, VA",VA,2010,8346,7262,1084,13.0,0
"Paulding County, GA",GA,2021,89362,86668,2694,3.0,2555
"Paulding County, GA",GA,2020,86807,82242,4565,5.3,-958
"Paulding County, GA",GA,2019,87765,85070,2695,3.1,2169
"Paulding County, GA",GA,2018,85596,82609,2987,3.5,1984
"Paulding County, GA",GA,2017,83612,80127,3485,4.2,3964
"Paulding County, GA",GA,2016,79648,75914,3734,4.7,4194
"Paulding County, GA",GA,2015,75454,71460,3994,5.3,739
"Paulding County, GA",GA,2014,74715,70102,4613,6.2,275
"Paulding County, GA",GA,2013,74440,69117,5323,7.2,225
"Paulding County, GA",GA,2012,74215,68145,6070,8.2,70
"Paulding County, GA",GA,2011,74145,67149,6996,9.4,222
"Paulding County, GA",GA,2010,73923,66434,7489,10.1,0
"Paulding County, OH",OH,2021,8600,8227,373,4.3,-81
"Paulding County, OH",OH,2020,8681,8033,648,7.5,-20
"Paulding County, OH",OH,2019,8701,8365,336,3.9,-94
"Paulding County, OH",OH,2018,8795,8438,357,4.1,-142
"Paulding County, OH",OH,2017,8937,8543,394,4.4,27
"Paulding County, OH",OH,2016,8910,8498,412,4.6,-24
"Paulding County, OH",OH,2015,8934,8501,433,4.8,-102
"Paulding County, OH",OH,2014,9036,8539,497,5.5,20
"Paulding County, OH",OH,2013,9016,8328,688,7.6,-201
"Paulding County, OH",OH,2012,9217,8508,709,7.7,-213
"Paulding County, OH",OH,2011,9430,8512,918,9.7,-280
"Paulding County, OH",OH,2010,9710,8487,1223,12.6,0
"Pawnee County, KS",KS,2021,2831,2768,63,2.2,-19
"Pawnee County, KS",KS,2020,2850,2751,99,3.5,-10
"Pawnee County, KS",KS,2019,2860,2780,80,2.8,-62
"Pawnee County, KS",KS,2018,2922,2832,90,3.1,-120
"Pawnee County, KS",KS,2017,3042,2941,101,3.3,-182
"Pawnee County, KS",KS,2016,3224,3118,106,3.3,-92
"Pawnee County, KS",KS,2015,3316,3193,123,3.7,-79
"Pawnee County, KS",KS,2014,3395,3267,128,3.8,-27
"Pawnee County, KS",KS,2013,3422,3273,149,4.4,-12
"Pawnee County, KS",KS,2012,3434,3294,140,4.1,-65
"Pawnee County, KS",KS,2011,3499,3341,158,4.5,-110
"Pawnee County, KS",KS,2010,3609,3442,167,4.6,0
"Pawnee County, NE",NE,2021,1529,1501,28,1.8,26
"Pawnee County, NE",NE,2020,1503,1463,40,2.7,10
"Pawnee County, NE",NE,2019,1493,1451,42,2.8,5
"Pawnee County, NE",NE,2018,1488,1449,39,2.6,-29
"Pawnee County, NE",NE,2017,1517,1471,46,3.0,-146
"Pawnee County, NE",NE,2016,1663,1626,37,2.2,-15
"Pawnee County, NE",NE,2015,1678,1635,43,2.6,24
"Pawnee County, NE",NE,2014,1654,1608,46,2.8,-25
"Pawnee County, NE",NE,2013,1679,1628,51,3.0,41
"Pawnee County, NE",NE,2012,1638,1585,53,3.2,-16
"Pawnee County, NE",NE,2011,1654,1592,62,3.7,71
"Pawnee County, NE",NE,2010,1583,1519,64,4.0,0
"Pawnee County, OK",OK,2021,7283,6983,300,4.1,60
"Pawnee County, OK",OK,2020,7223,6742,481,6.7,-97
"Pawnee County, OK",OK,2019,7320,7046,274,3.7,-2
"Pawnee County, OK",OK,2018,7322,7031,291,4.0,-48
"Pawnee County, OK",OK,2017,7370,6997,373,5.1,-108
"Pawnee County, OK",OK,2016,7478,6999,479,6.4,14
"Pawnee County, OK",OK,2015,7464,7039,425,5.7,164
"Pawnee County, OK",OK,2014,7300,6926,374,5.1,-77
"Pawnee County, OK",OK,2013,7377,6943,434,5.9,-90
"Pawnee County, OK",OK,2012,7467,6991,476,6.4,-104
"Pawnee County, OK",OK,2011,7571,7009,562,7.4,-85
"Pawnee County, OK",OK,2010,7656,6985,671,8.8,0
"Payette County, ID",ID,2021,12081,11598,483,4.0,69
"Payette County, ID",ID,2020,12012,11362,650,5.4,204
"Payette County, ID",ID,2019,11808,11381,427,3.6,185
"Payette County, ID",ID,2018,11623,11200,423,3.6,60
"Payette County, ID",ID,2017,11563,11104,459,4.0,316
"Payette County, ID",ID,2016,11247,10742,505,4.5,146
"Payette County, ID",ID,2015,11101,10589,512,4.6,196
"Payette County, ID",ID,2014,10905,10345,560,5.1,-12
"Payette County, ID",ID,2013,10917,10128,789,7.2,31
"Payette County, ID",ID,2012,10886,10009,877,8.1,-270
"Payette County, ID",ID,2011,11156,10165,991,8.9,-10
"Payette County, ID",ID,2010,11166,10102,1064,9.5,0
"Payne County, OK",OK,2021,38102,36873,1229,3.2,562
"Payne County, OK",OK,2020,37540,35533,2007,5.3,-463
"Payne County, OK",OK,2019,38003,36964,1039,2.7,-533
"Payne County, OK",OK,2018,38536,37445,1091,2.8,-212
"Payne County, OK",OK,2017,38748,37438,1310,3.4,-134
"Payne County, OK",OK,2016,38882,37488,1394,3.6,514
"Payne County, OK",OK,2015,38368,37049,1319,3.4,-4
"Payne County, OK",OK,2014,38372,36984,1388,3.6,876
"Payne County, OK",OK,2013,37496,35885,1611,4.3,-254
"Payne County, OK",OK,2012,37750,36030,1720,4.6,1022
"Payne County, OK",OK,2011,36728,34985,1743,4.7,-110
"Payne County, OK",OK,2010,36838,34808,2030,5.5,0
"Peach County, GA",GA,2021,12060,11498,562,4.7,225
"Peach County, GA",GA,2020,11835,11102,733,6.2,-78
"Peach County, GA",GA,2019,11913,11405,508,4.3,23
"Peach County, GA",GA,2018,11890,11266,624,5.2,15
"Peach County, GA",GA,2017,11875,11174,701,5.9,434
"Peach County, GA",GA,2016,11441,10630,811,7.1,278
"Peach County, GA",GA,2015,11163,10263,900,8.1,-307
"Peach County, GA",GA,2014,11470,10379,1091,9.5,-403
"Peach County, GA",GA,2013,11873,10615,1258,10.6,-626
"Peach County, GA",GA,2012,12499,11127,1372,11.0,-164
"Peach County, GA",GA,2011,12663,11178,1485,11.7,-295
"Peach County, GA",GA,2010,12958,11373,1585,12.2,0
"Pearl River County, MS",MS,2021,23318,22005,1313,5.6,392
"Pearl River County, MS",MS,2020,22926,21303,1623,7.1,-803
"Pearl River County, MS",MS,2019,23729,22472,1257,5.3,238
"Pearl River County, MS",MS,2018,23491,22346,1145,4.9,88
"Pearl River County, MS",MS,2017,23403,22137,1266,5.4,287
"Pearl River County, MS",MS,2016,23116,21706,1410,6.1,322
"Pearl River County, MS",MS,2015,22794,21374,1420,6.2,538
"Pearl River County, MS",MS,2014,22256,20754,1502,6.7,-582
"Pearl River County, MS",MS,2013,22838,21155,1683,7.4,-1194
"Pearl River County, MS",MS,2012,24032,22093,1939,8.1,-341
"Pearl River County, MS",MS,2011,24373,22152,2221,9.1,899
"Pearl River County, MS",MS,2010,23474,21307,2167,9.2,0
"Pecos County, TX",TX,2021,6164,5724,440,7.1,-197
"Pecos County, TX",TX,2020,6361,5836,525,8.3,62
"Pecos County, TX",TX,2019,6299,6092,207,3.3,-56
"Pecos County, TX",TX,2018,6355,6122,233,3.7,131
"Pecos County, TX",TX,2017,6224,5931,293,4.7,-274
"Pecos County, TX",TX,2016,6498,6116,382,5.9,-371
"Pecos County, TX",TX,2015,6869,6512,357,5.2,16
"Pecos County, TX",TX,2014,6853,6565,288,4.2,161
"Pecos County, TX",TX,2013,6692,6327,365,5.5,-286
"Pecos County, TX",TX,2012,6978,6622,356,5.1,-214
"Pecos County, TX",TX,2011,7192,6746,446,6.2,5
"Pecos County, TX",TX,2010,7187,6659,528,7.3,0
"Pembina County, ND",ND,2021,3327,3166,161,4.8,-78
"Pembina County, ND",ND,2020,3405,3215,190,5.6,28
"Pembina County, ND",ND,2019,3377,3274,103,3.1,-50
"Pembina County, ND",ND,2018,3427,3303,124,3.6,-136
"Pembina County, ND",ND,2017,3563,3415,148,4.2,-89
"Pembina County, ND",ND,2016,3652,3469,183,5.0,72
"Pembina County, ND",ND,2015,3580,3389,191,5.3,21
"Pembina County, ND",ND,2014,3559,3364,195,5.5,-26
"Pembina County, ND",ND,2013,3585,3369,216,6.0,-96
"Pembina County, ND",ND,2012,3681,3455,226,6.1,-232
"Pembina County, ND",ND,2011,3913,3652,261,6.7,-116
"Pembina County, ND",ND,2010,4029,3778,251,6.2,0
"Pemiscot County, MO",MO,2021,6078,5633,445,7.3,-180
"Pemiscot County, MO",MO,2020,6258,5760,498,8.0,-33
"Pemiscot County, MO",MO,2019,6291,5993,298,4.7,-12
"Pemiscot County, MO",MO,2018,6303,5964,339,5.4,-248
"Pemiscot County, MO",MO,2017,6551,6065,486,7.4,-472
"Pemiscot County, MO",MO,2016,7023,6401,622,8.9,17
"Pemiscot County, MO",MO,2015,7006,6359,647,9.2,-68
"Pemiscot County, MO",MO,2014,7074,6413,661,9.3,-9
"Pemiscot County, MO",MO,2013,7083,6344,739,10.4,16
"Pemiscot County, MO",MO,2012,7067,6365,702,9.9,-98
"Pemiscot County, MO",MO,2011,7165,6314,851,11.9,-22
"Pemiscot County, MO",MO,2010,7187,6300,887,12.3,0
"Pend Oreille County, WA",WA,2021,5138,4747,391,7.6,-37
"Pend Oreille County, WA",WA,2020,5175,4652,523,10.1,77
"Pend Oreille County, WA",WA,2019,5098,4687,411,8.1,227
"Pend Oreille County, WA",WA,2018,4871,4525,346,7.1,119
"Pend Oreille County, WA",WA,2017,4752,4405,347,7.3,89
"Pend Oreille County, WA",WA,2016,4663,4254,409,8.8,67
"Pend Oreille County, WA",WA,2015,4596,4165,431,9.4,26
"Pend Oreille County, WA",WA,2014,4570,4125,445,9.7,-104
"Pend Oreille County, WA",WA,2013,4674,4128,546,11.7,-102
"Pend Oreille County, WA",WA,2012,4776,4216,560,11.7,-14
"Pend Oreille County, WA",WA,2011,4790,4184,606,12.7,-224
"Pend Oreille County, WA",WA,2010,5014,4316,698,13.9,0
"Pender County, NC",NC,2021,29066,27841,1225,4.2,1236
"Pender County, NC",NC,2020,27830,26077,1753,6.3,-698
"Pender County, NC",NC,2019,28528,27410,1118,3.9,671
"Pender County, NC",NC,2018,27857,26682,1175,4.2,283
"Pender County, NC",NC,2017,27574,26298,1276,4.6,805
"Pender County, NC",NC,2016,26769,25350,1419,5.3,780
"Pender County, NC",NC,2015,25989,24423,1566,6.0,685
"Pender County, NC",NC,2014,25304,23562,1742,6.9,242
"Pender County, NC",NC,2013,25062,22861,2201,8.8,-39
"Pender County, NC",NC,2012,25101,22419,2682,10.7,345
"Pender County, NC",NC,2011,24756,21949,2807,11.3,218
"Pender County, NC",NC,2010,24538,21756,2782,11.3,0
"Pendleton County, KY",KY,2021,6897,6612,285,4.1,138
"Pendleton County, KY",KY,2020,6759,6417,342,5.1,-284
"Pendleton County, KY",KY,2019,7043,6790,253,3.6,61
"Pendleton County, KY",KY,2018,6982,6701,281,4.0,-5
"Pendleton County, KY",KY,2017,6987,6664,323,4.6,136
"Pendleton County, KY",KY,2016,6851,6526,325,4.7,179
"Pendleton County, KY",KY,2015,6672,6321,351,5.3,-91
"Pendleton County, KY",KY,2014,6763,6314,449,6.6,-254
"Pendleton County, KY",KY,2013,7017,6434,583,8.3,-51
"Pendleton County, KY",KY,2012,7068,6440,628,8.9,-150
"Pendleton County, KY",KY,2011,7218,6439,779,10.8,-209
"Pendleton County, KY",KY,2010,7427,6507,920,12.4,0
"Pendleton County, WV",WV,2021,3763,3651,112,3.0,128
"Pendleton County, WV",WV,2020,3635,3460,175,4.8,-64
"Pendleton County, WV",WV,2019,3699,3555,144,3.9,130
"Pendleton County, WV",WV,2018,3569,3438,131,3.7,-13
"Pendleton County, WV",WV,2017,3582,3447,135,3.8,-83
"Pendleton County, WV",WV,2016,3665,3523,142,3.9,47
"Pendleton County, WV",WV,2015,3618,3454,164,4.5,103
"Pendleton County, WV",WV,2014,3515,3346,169,4.8,-69
"Pendleton County, WV",WV,2013,3584,3390,194,5.4,-54
"Pendleton County, WV",WV,2012,3638,3399,239,6.6,-9
"Pendleton County, WV",WV,2011,3647,3391,256,7.0,-8
"Pendleton County, WV",WV,2010,3655,3339,316,8.6,0
"Pennington County, MN",MN,2021,8527,8211,316,3.7,-205
"Pennington County, MN",MN,2020,8732,8175,557,6.4,-78
"Pennington County, MN",MN,2019,8810,8384,426,4.8,-2
"Pennington County, MN",MN,2018,8812,8419,393,4.5,-25
"Pennington County, MN",MN,2017,8837,8333,504,5.7,-202
"Pennington County, MN",MN,2016,9039,8518,521,5.8,-63
"Pennington County, MN",MN,2015,9102,8626,476,5.2,237
"Pennington County, MN",MN,2014,8865,8399,466,5.3,198
"Pennington County, MN",MN,2013,8667,8111,556,6.4,66
"Pennington County, MN",MN,2012,8601,8028,573,6.7,22
"Pennington County, MN",MN,2011,8579,7917,662,7.7,173
"Pennington County, MN",MN,2010,8406,7643,763,9.1,0
"Pennington County, SD",SD,2021,58416,56546,1870,3.2,1353
"Pennington County, SD",SD,2020,57063,54232,2831,5.0,349
"Pennington County, SD",SD,2019,56714,55059,1655,2.9,843
"Pennington County, SD",SD,2018,55871,54285,1586,2.8,252
"Pennington County, SD",SD,2017,55619,53883,1736,3.1,632
"Pennington County, SD",SD,2016,54987,53277,1710,3.1,282
"Pennington County, SD",SD,2015,54705,53010,1695,3.1,294
"Pennington County, SD",SD,2014,54411,52602,1809,3.3,705
"Pennington County, SD",SD,2013,53706,51654,2052,3.8,-135
"Pennington County, SD",SD,2012,53841,51602,2239,4.2,267
"Pennington County, SD",SD,2011,53574,51058,2516,4.7,462
"Pennington County, SD",SD,2010,53112,50376,2736,5.2,0
"Penobscot County, ME",ME,2021,74855,71312,3543,4.7,645
"Penobscot County, ME",ME,2020,74210,70505,3705,5.0,-3230
"Penobscot County, ME",ME,2019,77440,75115,2325,3.0,27
"Penobscot County, ME",ME,2018,77413,74730,2683,3.5,-169
"Penobscot County, ME",ME,2017,77582,74621,2961,3.8,399
"Penobscot County, ME",ME,2016,77183,73852,3331,4.3,-191
"Penobscot County, ME",ME,2015,77374,73700,3674,4.7,-1776
"Penobscot County, ME",ME,2014,79150,74358,4792,6.1,-804
"Penobscot County, ME",ME,2013,79954,74438,5516,6.9,254
"Penobscot County, ME",ME,2012,79700,73746,5954,7.5,173
"Penobscot County, ME",ME,2011,79527,73076,6451,8.1,202
"Penobscot County, ME",ME,2010,79325,72360,6965,8.8,0
"Penuelas Municipio, PR",PR,2021,6091,5427,664,10.9,
"Penuelas Municipio, PR",PR,2020,N.A.,N.A.,N.A.,N.A.,
"Penuelas Municipio, PR",PR,2019,5885,5053,832,14.1,126
"Penuelas Municipio, PR",PR,2018,5759,4965,794,13.8,-235
"Penuelas Municipio, PR",PR,2017,5994,4946,1048,17.5,-126
"Penuelas Municipio, PR",PR,2016,6120,5099,1021,16.7,-127
"Penuelas Municipio, PR",PR,2015,6247,5155,1092,17.5,-249
"Penuelas Municipio, PR",PR,2014,6496,5126,1370,21.1,-186
"Penuelas Municipio, PR",PR,2013,6682,5309,1373,20.5,-161
"Penuelas Municipio, PR",PR,2012,6843,5444,1399,20.4,-283
"Penuelas Municipio, PR",PR,2011,7126,5514,1612,22.6,-379
"Penuelas Municipio, PR",PR,2010,7505,5686,1819,24.2,0
"Peoria County, IL",IL,2021,82725,76764,5961,7.2,-685
"Peoria County, IL",IL,2020,83410,74688,8722,10.5,-1762
"Peoria County, IL",IL,2019,85172,81021,4151,4.9,-1471
"Peoria County, IL",IL,2018,86643,81849,4794,5.5,347
"Peoria County, IL",IL,2017,86296,81231,5065,5.9,-2116
"Peoria County, IL",IL,2016,88412,82310,6102,6.9,-1671
"Peoria County, IL",IL,2015,90083,83891,6192,6.9,-1405
"Peoria County, IL",IL,2014,91488,84396,7092,7.8,-1903
"Peoria County, IL",IL,2013,93391,84411,8980,9.6,-2360
"Peoria County, IL",IL,2012,95751,87671,8080,8.4,-407
"Peoria County, IL",IL,2011,96158,87252,8906,9.3,327
"Peoria County, IL",IL,2010,95831,85660,10171,10.6,0
"Pepin County, WI",WI,2021,4129,3990,139,3.4,-11
"Pepin County, WI",WI,2020,4140,3897,243,5.9,-26
"Pepin County, WI",WI,2019,4166,4020,146,3.5,-72
"Pepin County, WI",WI,2018,4238,4102,136,3.2,10
"Pepin County, WI",WI,2017,4228,4081,147,3.5,73
"Pepin County, WI",WI,2016,4155,4001,154,3.7,58
"Pepin County, WI",WI,2015,4097,3930,167,4.1,71
"Pepin County, WI",WI,2014,4026,3837,189,4.7,-4
"Pepin County, WI",WI,2013,4030,3803,227,5.6,-43
"Pepin County, WI",WI,2012,4073,3844,229,5.6,-19
"Pepin County, WI",WI,2011,4092,3838,254,6.2,-6
"Pepin County, WI",WI,2010,4098,3798,300,7.3,0
"Perkins County, NE",NE,2021,1874,1848,26,1.4,13
"Perkins County, NE",NE,2020,1861,1828,33,1.8,22
"Perkins County, NE",NE,2019,1839,1798,41,2.2,2
"Perkins County, NE",NE,2018,1837,1801,36,2.0,14
"Perkins County, NE",NE,2017,1823,1788,35,1.9,-7
"Perkins County, NE",NE,2016,1830,1790,40,2.2,-12
"Perkins County, NE",NE,2015,1842,1808,34,1.8,-11
"Perkins County, NE",NE,2014,1853,1814,39,2.1,36
"Perkins County, NE",NE,2013,1817,1772,45,2.5,-9
"Perkins County, NE",NE,2012,1826,1779,47,2.6,23
"Perkins County, NE",NE,2011,1803,1751,52,2.9,37
"Perkins County, NE",NE,2010,1766,1706,60,3.4,0
"Perkins County, SD",SD,2021,1392,1349,43,3.1,27
"Perkins County, SD",SD,2020,1365,1318,47,3.4,-42
"Perkins County, SD",SD,2019,1407,1370,37,2.6,-30
"Perkins County, SD",SD,2018,1437,1399,38,2.6,-153
"Perkins County, SD",SD,2017,1590,1548,42,2.6,5
"Perkins County, SD",SD,2016,1585,1539,46,2.9,0
"Perkins County, SD",SD,2015,1585,1536,49,3.1,23
"Perkins County, SD",SD,2014,1562,1511,51,3.3,16
"Perkins County, SD",SD,2013,1546,1490,56,3.6,-4
"Perkins County, SD",SD,2012,1550,1491,59,3.8,-36
"Perkins County, SD",SD,2011,1586,1520,66,4.2,-34
"Perkins County, SD",SD,2010,1620,1554,66,4.1,0
"Perquimans County, NC",NC,2021,4824,4568,256,5.3,95
"Perquimans County, NC",NC,2020,4729,4417,312,6.6,-205
"Perquimans County, NC",NC,2019,4934,4693,241,4.9,-20
"Perquimans County, NC",NC,2018,4954,4712,242,4.9,-111
"Perquimans County, NC",NC,2017,5065,4779,286,5.6,-21
"Perquimans County, NC",NC,2016,5086,4758,328,6.4,-64
"Perquimans County, NC",NC,2015,5150,4787,363,7.0,51
"Perquimans County, NC",NC,2014,5099,4713,386,7.6,-131
"Perquimans County, NC",NC,2013,5230,4743,487,9.3,-82
"Perquimans County, NC",NC,2012,5312,4745,567,10.7,-20
"Perquimans County, NC",NC,2011,5332,4747,585,11.0,-22
"Perquimans County, NC",NC,2010,5354,4790,564,10.5,0
"Perry County, AL",AL,2021,3215,2948,267,8.3,-237
"Perry County, AL",AL,2020,3452,3038,414,12.0,16
"Perry County, AL",AL,2019,3436,3248,188,5.5,-12
"Perry County, AL",AL,2018,3448,3225,223,6.5,-31
"Perry County, AL",AL,2017,3479,3202,277,8.0,41
"Perry County, AL",AL,2016,3438,3083,355,10.3,-40
"Perry County, AL",AL,2015,3478,3129,349,10.0,-16
"Perry County, AL",AL,2014,3494,3073,421,12.0,-72
"Perry County, AL",AL,2013,3566,3077,489,13.7,-125
"Perry County, AL",AL,2012,3691,3188,503,13.6,-169
"Perry County, AL",AL,2011,3860,3229,631,16.3,-25
"Perry County, AL",AL,2010,3885,3243,642,16.5,0
"Perry County, AR",AR,2021,4092,3924,168,4.1,-40
"Perry County, AR",AR,2020,4132,3899,233,5.6,-181
"Perry County, AR",AR,2019,4313,4141,172,4.0,68
"Perry County, AR",AR,2018,4245,4071,174,4.1,-1
"Perry County, AR",AR,2017,4246,4068,178,4.2,72
"Perry County, AR",AR,2016,4174,3974,200,4.8,-44
"Perry County, AR",AR,2015,4218,3963,255,6.0,-43
"Perry County, AR",AR,2014,4261,3940,321,7.5,-124
"Perry County, AR",AR,2013,4385,3986,399,9.1,-44
"Perry County, AR",AR,2012,4429,4044,385,8.7,-66
"Perry County, AR",AR,2011,4495,4095,400,8.9,-59
"Perry County, AR",AR,2010,4554,4163,391,8.6,0
"Perry County, IL",IL,2021,7928,7472,456,5.8,-140
"Perry County, IL",IL,2020,8068,7298,770,9.5,-273
"Perry County, IL",IL,2019,8341,7931,410,4.9,-134
"Perry County, IL",IL,2018,8475,7973,502,5.9,60
"Perry County, IL",IL,2017,8415,7909,506,6.0,-328
"Perry County, IL",IL,2016,8743,8121,622,7.1,-130
"Perry County, IL",IL,2015,8873,8239,634,7.1,-11
"Perry County, IL",IL,2014,8884,8127,757,8.5,-130
"Perry County, IL",IL,2013,9014,8023,991,11.0,-177
"Perry County, IL",IL,2012,9191,8211,980,10.7,-271
"Perry County, IL",IL,2011,9462,8496,966,10.2,-118
"Perry County, IL",IL,2010,9580,8511,1069,11.2,0
"Perry County, IN",IN,2021,8766,8495,271,3.1,-313
"Perry County, IN",IN,2020,9079,8480,599,6.6,-200
"Perry County, IN",IN,2019,9279,8976,303,3.3,-62
"Perry County, IN",IN,2018,9341,9000,341,3.7,77
"Perry County, IN",IN,2017,9264,8913,351,3.8,-206
"Perry County, IN",IN,2016,9470,9044,426,4.5,240
"Perry County, IN",IN,2015,9230,8798,432,4.7,49
"Perry County, IN",IN,2014,9181,8646,535,5.8,234
"Perry County, IN",IN,2013,8947,8264,683,7.6,65
"Perry County, IN",IN,2012,8882,8146,736,8.3,-204
"Perry County, IN",IN,2011,9086,8273,813,8.9,152
"Perry County, IN",IN,2010,8934,8013,921,10.3,0
"Perry County, KY",KY,2021,7994,7491,503,6.3,-138
"Perry County, KY",KY,2020,8132,7432,700,8.6,-206
"Perry County, KY",KY,2019,8338,7864,474,5.7,185
"Perry County, KY",KY,2018,8153,7654,499,6.1,-248
"Perry County, KY",KY,2017,8401,7717,684,8.1,-148
"Perry County, KY",KY,2016,8549,7634,915,10.7,-250
"Perry County, KY",KY,2015,8799,8007,792,9.0,-741
"Perry County, KY",KY,2014,9540,8560,980,10.3,-860
"Perry County, KY",KY,2013,10400,8966,1434,13.8,-561
"Perry County, KY",KY,2012,10961,9580,1381,12.6,-86
"Perry County, KY",KY,2011,11047,9903,1144,10.4,-75
"Perry County, KY",KY,2010,11122,9806,1316,11.8,0
"Perry County, MO",MO,2021,9781,9471,310,3.2,-28
"Perry County, MO",MO,2020,9809,9269,540,5.5,-171
"Perry County, MO",MO,2019,9980,9731,249,2.5,-179
"Perry County, MO",MO,2018,10159,9926,233,2.3,58
"Perry County, MO",MO,2017,10101,9834,267,2.6,33
"Perry County, MO",MO,2016,10068,9710,358,3.6,-78
"Perry County, MO",MO,2015,10146,9711,435,4.3,-97
"Perry County, MO",MO,2014,10243,9684,559,5.5,137
"Perry County, MO",MO,2013,10106,9552,554,5.5,174
"Perry County, MO",MO,2012,9932,9407,525,5.3,112
"Perry County, MO",MO,2011,9820,9154,666,6.8,26
"Perry County, MO",MO,2010,9794,9090,704,7.2,0
"Perry County, MS",MS,2021,4234,3957,277,6.5,102
"Perry County, MS",MS,2020,4132,3777,355,8.6,-166
"Perry County, MS",MS,2019,4298,4005,293,6.8,40
"Perry County, MS",MS,2018,4258,4000,258,6.1,-54
"Perry County, MS",MS,2017,4312,4032,280,6.5,-27
"Perry County, MS",MS,2016,4339,4023,316,7.3,36
"Perry County, MS",MS,2015,4303,3956,347,8.1,108
"Perry County, MS",MS,2014,4195,3807,388,9.2,-56
"Perry County, MS",MS,2013,4251,3811,440,10.4,-232
"Perry County, MS",MS,2012,4483,3977,506,11.3,-197
"Perry County, MS",MS,2011,4680,4074,606,12.9,38
"Perry County, MS",MS,2010,4642,4024,618,13.3,0
"Perry County, OH",OH,2021,15922,15034,888,5.6,136
"Perry County, OH",OH,2020,15786,14447,1339,8.5,-224
"Perry County, OH",OH,2019,16010,15168,842,5.3,177
"Perry County, OH",OH,2018,15833,14943,890,5.6,-151
"Perry County, OH",OH,2017,15984,15018,966,6.0,30
"Perry County, OH",OH,2016,15954,14929,1025,6.4,74
"Perry County, OH",OH,2015,15880,14832,1048,6.6,24
"Perry County, OH",OH,2014,15856,14687,1169,7.4,-200
"Perry County, OH",OH,2013,16056,14520,1536,9.6,-38
"Perry County, OH",OH,2012,16094,14521,1573,9.8,-284
"Perry County, OH",OH,2011,16378,14485,1893,11.6,-292
"Perry County, OH",OH,2010,16670,14431,2239,13.4,0
"Perry County, PA",PA,2021,24211,23084,1127,4.7,-119
"Perry County, PA",PA,2020,24330,22681,1649,6.8,-432
"Perry County, PA",PA,2019,24762,23820,942,3.8,268
"Perry County, PA",PA,2018,24494,23542,952,3.9,-20
"Perry County, PA",PA,2017,24514,23447,1067,4.4,198
"Perry County, PA",PA,2016,24316,23206,1110,4.6,203
"Perry County, PA",PA,2015,24113,23016,1097,4.5,129
"Perry County, PA",PA,2014,23984,22732,1252,5.2,-197
"Perry County, PA",PA,2013,24181,22652,1529,6.3,-428
"Perry County, PA",PA,2012,24609,22863,1746,7.1,-59
"Perry County, PA",PA,2011,24668,22887,1781,7.2,-240
"Perry County, PA",PA,2010,24908,22955,1953,7.8,0
"Perry County, TN",TN,2021,2889,2682,207,7.2,-73
"Perry County, TN",TN,2020,2962,2679,283,9.6,-164
"Perry County, TN",TN,2019,3126,2969,157,5.0,-129
"Perry County, TN",TN,2018,3255,3116,139,4.3,15
"Perry County, TN",TN,2017,3240,3084,156,4.8,48
"Perry County, TN",TN,2016,3192,2989,203,6.4,66
"Perry County, TN",TN,2015,3126,2917,209,6.7,73
"Perry County, TN",TN,2014,3053,2805,248,8.1,-71
"Perry County, TN",TN,2013,3124,2832,292,9.3,13
"Perry County, TN",TN,2012,3111,2802,309,9.9,88
"Perry County, TN",TN,2011,3023,2665,358,11.8,-146
"Perry County, TN",TN,2010,3169,2735,434,13.7,0
"Pershing County, NV",NV,2021,2633,2539,94,3.6,74
"Pershing County, NV",NV,2020,2559,2436,123,4.8,-49
"Pershing County, NV",NV,2019,2608,2503,105,4.0,47
"Pershing County, NV",NV,2018,2561,2458,103,4.0,41
"Pershing County, NV",NV,2017,2520,2404,116,4.6,81
"Pershing County, NV",NV,2016,2439,2293,146,6.0,10
"Pershing County, NV",NV,2015,2429,2259,170,7.0,-105
"Pershing County, NV",NV,2014,2534,2343,191,7.5,-64
"Pershing County, NV",NV,2013,2598,2357,241,9.3,9
"Pershing County, NV",NV,2012,2589,2329,260,10.0,134
"Pershing County, NV",NV,2011,2455,2185,270,11.0,134
"Pershing County, NV",NV,2010,2321,2064,257,11.1,0
"Person County, NC",NC,2021,18428,17515,913,5.0,575
"Person County, NC",NC,2020,17853,16597,1256,7.0,-384
"Person County, NC",NC,2019,18237,17482,755,4.1,333
"Person County, NC",NC,2018,17904,17149,755,4.2,136
"Person County, NC",NC,2017,17768,16940,828,4.7,-212
"Person County, NC",NC,2016,17980,16993,987,5.5,116
"Person County, NC",NC,2015,17864,16665,1199,6.7,-69
"Person County, NC",NC,2014,17933,16582,1351,7.5,-377
"Person County, NC",NC,2013,18310,16515,1795,9.8,-251
"Person County, NC",NC,2012,18561,16464,2097,11.3,-101
"Person County, NC",NC,2011,18662,16436,2226,11.9,-112
"Person County, NC",NC,2010,18774,16466,2308,12.3,0
"Petersburg Borough, AK",AK,2021,1621,1508,113,7.0,191
"Petersburg Borough, AK",AK,2020,1430,1301,129,9.0,20
"Petersburg Borough, AK",AK,2019,1410,1299,111,7.9,23
"Petersburg Borough, AK",AK,2018,1387,1277,110,7.9,-27
"Petersburg Borough, AK",AK,2017,1414,1292,122,8.6,-33
"Petersburg Borough, AK",AK,2016,1447,1322,125,8.6,-43
"Petersburg Borough, AK",AK,2015,1490,1361,129,8.7,-87
"Petersburg Borough, AK",AK,2014,1577,1430,147,9.3,-73
"Petersburg Borough, AK",AK,2013,1650,1507,143,8.7,-220
"Petersburg Borough, AK",AK,2012,1870,1716,154,8.2,21
"Petersburg Borough, AK",AK,2011,1849,1691,158,8.5,5
"Petersburg Borough, AK",AK,2010,1844,1692,152,8.2,0
"Petersburg city, VA",VA,2021,12529,11210,1319,10.5,-542
"Petersburg city, VA",VA,2020,13071,11221,1850,14.2,-1
"Petersburg city, VA",VA,2019,13072,12343,729,5.6,-37
"Petersburg city, VA",VA,2018,13109,12311,798,6.1,-160
"Petersburg city, VA",VA,2017,13269,12308,961,7.2,55
"Petersburg city, VA",VA,2016,13214,12194,1020,7.7,-333
"Petersburg city, VA",VA,2015,13547,12320,1227,9.1,-280
"Petersburg city, VA",VA,2014,13827,12371,1456,10.5,67
"Petersburg city, VA",VA,2013,13760,12190,1570,11.4,175
"Petersburg city, VA",VA,2012,13585,11992,1593,11.7,-105
"Petersburg city, VA",VA,2011,13690,11934,1756,12.8,-232
"Petersburg city, VA",VA,2010,13922,11933,1989,14.3,0
"Petroleum County, MT",MT,2021,271,264,7,2.6,0
"Petroleum County, MT",MT,2020,271,262,9,3.3,1
"Petroleum County, MT",MT,2019,270,260,10,3.7,-14
"Petroleum County, MT",MT,2018,284,272,12,4.2,-10
"Petroleum County, MT",MT,2017,294,281,13,4.4,17
"Petroleum County, MT",MT,2016,277,264,13,4.7,-7
"Petroleum County, MT",MT,2015,284,269,15,5.3,0
"Petroleum County, MT",MT,2014,284,272,12,4.2,-9
"Petroleum County, MT",MT,2013,293,280,13,4.4,-7
"Petroleum County, MT",MT,2012,300,287,13,4.3,20
"Petroleum County, MT",MT,2011,280,265,15,5.4,-19
"Petroleum County, MT",MT,2010,299,284,15,5.0,0
"Pettis County, MO",MO,2021,20298,19349,949,4.7,-275
"Pettis County, MO",MO,2020,20573,19188,1385,6.7,-220
"Pettis County, MO",MO,2019,20793,20098,695,3.3,80
"Pettis County, MO",MO,2018,20713,19871,842,4.1,-137
"Pettis County, MO",MO,2017,20850,19987,863,4.1,248
"Pettis County, MO",MO,2016,20602,19588,1014,4.9,-198
"Pettis County, MO",MO,2015,20800,19684,1116,5.4,217
"Pettis County, MO",MO,2014,20583,19315,1268,6.2,562
"Pettis County, MO",MO,2013,20021,18693,1328,6.6,163
"Pettis County, MO",MO,2012,19858,18411,1447,7.3,-214
"Pettis County, MO",MO,2011,20072,18382,1690,8.4,80
"Pettis County, MO",MO,2010,19992,18155,1837,9.2,0
"Phelps County, MO",MO,2021,20030,19284,746,3.7,303
"Phelps County, MO",MO,2020,19727,18792,935,4.7,88
"Phelps County, MO",MO,2019,19639,19030,609,3.1,-3
"Phelps County, MO",MO,2018,19642,19046,596,3.0,-36
"Phelps County, MO",MO,2017,19678,18947,731,3.7,193
"Phelps County, MO",MO,2016,19485,18562,923,4.7,33
"Phelps County, MO",MO,2015,19452,18396,1056,5.4,81
"Phelps County, MO",MO,2014,19371,18110,1261,6.5,74
"Phelps County, MO",MO,2013,19297,17929,1368,7.1,-244
"Phelps County, MO",MO,2012,19541,18115,1426,7.3,-298
"Phelps County, MO",MO,2011,19839,18131,1708,8.6,108
"Phelps County, MO",MO,2010,19731,17965,1766,9.0,0
"Phelps County, NE",NE,2021,4972,4885,87,1.7,-39
"Phelps County, NE",NE,2020,5011,4866,145,2.9,-22
"Phelps County, NE",NE,2019,5033,4901,132,2.6,96
"Phelps County, NE",NE,2018,4937,4823,114,2.3,-13
"Phelps County, NE",NE,2017,4950,4834,116,2.3,-7
"Phelps County, NE",NE,2016,4957,4833,124,2.5,-56
"Phelps County, NE",NE,2015,5013,4893,120,2.4,-43
"Phelps County, NE",NE,2014,5056,4926,130,2.6,-21
"Phelps County, NE",NE,2013,5077,4930,147,2.9,37
"Phelps County, NE",NE,2012,5040,4893,147,2.9,25
"Phelps County, NE",NE,2011,5015,4831,184,3.7,65
"Phelps County, NE",NE,2010,4950,4770,180,3.6,0
"Philadelphia County/city, PA",PA,2021,721225,655154,66071,9.2,-14842
"Philadelphia County/city, PA",PA,2020,736067,644480,91587,12.4,4023
"Philadelphia County/city, PA",PA,2019,732044,690507,41537,5.7,14020
"Philadelphia County/city, PA",PA,2018,718024,676682,41342,5.8,6274
"Philadelphia County/city, PA",PA,2017,711750,666564,45186,6.3,7466
"Philadelphia County/city, PA",PA,2016,704284,657187,47097,6.7,8211
"Philadelphia County/city, PA",PA,2015,696073,645690,50383,7.2,5548
"Philadelphia County/city, PA",PA,2014,690525,633841,56684,8.2,-4668
"Philadelphia County/city, PA",PA,2013,695193,625827,69366,10.0,-2111
"Philadelphia County/city, PA",PA,2012,697304,623042,74262,10.6,8299
"Philadelphia County/city, PA",PA,2011,689005,616991,72014,10.5,3897
"Philadelphia County/city, PA",PA,2010,685108,614806,70302,10.3,0
"Phillips County, AR",AR,2021,5865,5412,453,7.7,-438
"Phillips County, AR",AR,2020,6303,5723,580,9.2,-58
"Phillips County, AR",AR,2019,6361,5992,369,5.8,-211
"Phillips County, AR",AR,2018,6572,6178,394,6.0,40
"Phillips County, AR",AR,2017,6532,6151,381,5.8,-136
"Phillips County, AR",AR,2016,6668,6274,394,5.9,-355
"Phillips County, AR",AR,2015,7023,6498,525,7.5,-254
"Phillips County, AR",AR,2014,7277,6593,684,9.4,-356
"Phillips County, AR",AR,2013,7633,6785,848,11.1,-357
"Phillips County, AR",AR,2012,7990,7100,890,11.1,-401
"Phillips County, AR",AR,2011,8391,7415,976,11.6,-181
"Phillips County, AR",AR,2010,8572,7699,873,10.2,0
"Phillips County, CO",CO,2021,2490,2419,71,2.9,31
"Phillips County, CO",CO,2020,2459,2396,63,2.6,-119
"Phillips County, CO",CO,2019,2578,2539,39,1.5,8
"Phillips County, CO",CO,2018,2570,2524,46,1.8,18
"Phillips County, CO",CO,2017,2552,2514,38,1.5,80
"Phillips County, CO",CO,2016,2472,2426,46,1.9,114
"Phillips County, CO",CO,2015,2358,2304,54,2.3,106
"Phillips County, CO",CO,2014,2252,2178,74,3.3,128
"Phillips County, CO",CO,2013,2124,2028,96,4.5,-10
"Phillips County, CO",CO,2012,2134,2022,112,5.2,-14
"Phillips County, CO",CO,2011,2148,2028,120,5.6,-39
"Phillips County, CO",CO,2010,2187,2065,122,5.6,0
"Phillips County, KS",KS,2021,2637,2581,56,2.1,-4
"Phillips County, KS",KS,2020,2641,2556,85,3.2,-13
"Phillips County, KS",KS,2019,2654,2586,68,2.6,-131
"Phillips County, KS",KS,2018,2785,2717,68,2.4,-36
"Phillips County, KS",KS,2017,2821,2738,83,2.9,-49
"Phillips County, KS",KS,2016,2870,2780,90,3.1,-92
"Phillips County, KS",KS,2015,2962,2867,95,3.2,50
"Phillips County, KS",KS,2014,2912,2811,101,3.5,-59
"Phillips County, KS",KS,2013,2971,2845,126,4.2,-52
"Phillips County, KS",KS,2012,3023,2888,135,4.5,-11
"Phillips County, KS",KS,2011,3034,2883,151,5.0,-3
"Phillips County, KS",KS,2010,3037,2883,154,5.1,0
"Phillips County, MT",MT,2021,1852,1782,70,3.8,-44
"Phillips County, MT",MT,2020,1896,1805,91,4.8,-5
"Phillips County, MT",MT,2019,1901,1829,72,3.8,-19
"Phillips County, MT",MT,2018,1920,1833,87,4.5,16
"Phillips County, MT",MT,2017,1904,1816,88,4.6,-31
"Phillips County, MT",MT,2016,1935,1829,106,5.5,-44
"Phillips County, MT",MT,2015,1979,1876,103,5.2,-15
"Phillips County, MT",MT,2014,1994,1888,106,5.3,-65
"Phillips County, MT",MT,2013,2059,1939,120,5.8,0
"Phillips County, MT",MT,2012,2059,1940,119,5.8,-66
"Phillips County, MT",MT,2011,2125,1985,140,6.6,-85
"Phillips County, MT",MT,2010,2210,2062,148,6.7,0
"Piatt County, IL",IL,2021,8495,8153,342,4.0,144
"Piatt County, IL",IL,2020,8351,7887,464,5.6,-268
"Piatt County, IL",IL,2019,8619,8320,299,3.5,28
"Piatt County, IL",IL,2018,8591,8230,361,4.2,34
"Piatt County, IL",IL,2017,8557,8209,348,4.1,-172
"Piatt County, IL",IL,2016,8729,8305,424,4.9,173
"Piatt County, IL",IL,2015,8556,8135,421,4.9,-25
"Piatt County, IL",IL,2014,8581,8107,474,5.5,-35
"Piatt County, IL",IL,2013,8616,8019,597,6.9,-190
"Piatt County, IL",IL,2012,8806,8212,594,6.7,-208
"Piatt County, IL",IL,2011,9014,8392,622,6.9,-143
"Piatt County, IL",IL,2010,9157,8434,723,7.9,0
"Pickaway County, OH",OH,2021,26648,25460,1188,4.5,385
"Pickaway County, OH",OH,2020,26263,24464,1799,6.8,-448
"Pickaway County, OH",OH,2019,26711,25633,1078,4.0,419
"Pickaway County, OH",OH,2018,26292,25162,1130,4.3,-145
"Pickaway County, OH",OH,2017,26437,25208,1229,4.6,128
"Pickaway County, OH",OH,2016,26309,25028,1281,4.9,481
"Pickaway County, OH",OH,2015,25828,24585,1243,4.8,-40
"Pickaway County, OH",OH,2014,25868,24406,1462,5.7,226
"Pickaway County, OH",OH,2013,25642,23771,1871,7.3,-63
"Pickaway County, OH",OH,2012,25705,23794,1911,7.4,-104
"Pickaway County, OH",OH,2011,25809,23442,2367,9.2,-334
"Pickaway County, OH",OH,2010,26143,23366,2777,10.6,0
"Pickens County, AL",AL,2021,7501,7194,307,4.1,-187
"Pickens County, AL",AL,2020,7688,7128,560,7.3,-340
"Pickens County, AL",AL,2019,8028,7732,296,3.7,199
"Pickens County, AL",AL,2018,7829,7472,357,4.6,21
"Pickens County, AL",AL,2017,7808,7380,428,5.5,106
"Pickens County, AL",AL,2016,7702,7172,530,6.9,-285
"Pickens County, AL",AL,2015,7987,7445,542,6.8,217
"Pickens County, AL",AL,2014,7770,7139,631,8.1,355
"Pickens County, AL",AL,2013,7415,6713,702,9.5,-62
"Pickens County, AL",AL,2012,7477,6701,776,10.4,-87
"Pickens County, AL",AL,2011,7564,6666,898,11.9,-132
"Pickens County, AL",AL,2010,7696,6701,995,12.9,0
"Pickens County, GA",GA,2021,15533,15099,434,2.8,502
"Pickens County, GA",GA,2020,15031,14319,712,4.7,-438
"Pickens County, GA",GA,2019,15469,14981,488,3.2,241
"Pickens County, GA",GA,2018,15228,14681,547,3.6,105
"Pickens County, GA",GA,2017,15123,14471,652,4.3,719
"Pickens County, GA",GA,2016,14404,13692,712,4.9,688
"Pickens County, GA",GA,2015,13716,12972,744,5.4,-87
"Pickens County, GA",GA,2014,13803,12878,925,6.7,10
"Pickens County, GA",GA,2013,13793,12701,1092,7.9,-58
"Pickens County, GA",GA,2012,13851,12611,1240,9.0,-188
"Pickens County, GA",GA,2011,14039,12569,1470,10.5,-47
"Pickens County, GA",GA,2010,14086,12521,1565,11.1,0
"Pickens County, SC",SC,2021,56837,54866,1971,3.5,1262
"Pickens County, SC",SC,2020,55575,52706,2869,5.2,-735
"Pickens County, SC",SC,2019,56310,54750,1560,2.8,811
"Pickens County, SC",SC,2018,55499,53669,1830,3.3,431
"Pickens County, SC",SC,2017,55068,52830,2238,4.1,-1121
"Pickens County, SC",SC,2016,56189,53455,2734,4.9,159
"Pickens County, SC",SC,2015,56030,52833,3197,5.7,1180
"Pickens County, SC",SC,2014,54850,51482,3368,6.1,25
"Pickens County, SC",SC,2013,54825,50883,3942,7.2,-15
"Pickens County, SC",SC,2012,54840,50028,4812,8.8,-147
"Pickens County, SC",SC,2011,54987,49620,5367,9.8,77
"Pickens County, SC",SC,2010,54910,48849,6061,11.0,0
"Pickett County, TN",TN,2021,2200,2116,84,3.8,-37
"Pickett County, TN",TN,2020,2237,2103,134,6.0,-116
"Pickett County, TN",TN,2019,2353,2243,110,4.7,-89
"Pickett County, TN",TN,2018,2442,2348,94,3.8,-8
"Pickett County, TN",TN,2017,2450,2342,108,4.4,122
"Pickett County, TN",TN,2016,2328,2173,155,6.7,-77
"Pickett County, TN",TN,2015,2405,2222,183,7.6,120
"Pickett County, TN",TN,2014,2285,2081,204,8.9,-42
"Pickett County, TN",TN,2013,2327,2106,221,9.5,-117
"Pickett County, TN",TN,2012,2444,2211,233,9.5,16
"Pickett County, TN",TN,2011,2428,2150,278,11.4,18
"Pickett County, TN",TN,2010,2410,2137,273,11.3,0
"Pierce County, GA",GA,2021,8623,8354,269,3.1,110
"Pierce County, GA",GA,2020,8513,8129,384,4.5,-188
"Pierce County, GA",GA,2019,8701,8392,309,3.6,-43
"Pierce County, GA",GA,2018,8744,8409,335,3.8,-133
"Pierce County, GA",GA,2017,8877,8471,406,4.6,321
"Pierce County, GA",GA,2016,8556,8097,459,5.4,602
"Pierce County, GA",GA,2015,7954,7449,505,6.3,-123
"Pierce County, GA",GA,2014,8077,7471,606,7.5,-72
"Pierce County, GA",GA,2013,8149,7458,691,8.5,-158
"Pierce County, GA",GA,2012,8307,7534,773,9.3,224
"Pierce County, GA",GA,2011,8083,7228,855,10.6,-187
"Pierce County, GA",GA,2010,8270,7396,874,10.6,0
"Pierce County, ND",ND,2021,1681,1624,57,3.4,-34
"Pierce County, ND",ND,2020,1715,1642,73,4.3,-27
"Pierce County, ND",ND,2019,1742,1692,50,2.9,-61
"Pierce County, ND",ND,2018,1803,1750,53,2.9,-102
"Pierce County, ND",ND,2017,1905,1845,60,3.1,11
"Pierce County, ND",ND,2016,1894,1819,75,4.0,70
"Pierce County, ND",ND,2015,1824,1747,77,4.2,40
"Pierce County, ND",ND,2014,1784,1710,74,4.1,-25
"Pierce County, ND",ND,2013,1809,1733,76,4.2,-54
"Pierce County, ND",ND,2012,1863,1786,77,4.1,-66
"Pierce County, ND",ND,2011,1929,1840,89,4.6,-71
"Pierce County, ND",ND,2010,2000,1896,104,5.2,0
"Pierce County, NE",NE,2021,4193,4104,89,2.1,17
"Pierce County, NE",NE,2020,4176,4044,132,3.2,27
"Pierce County, NE",NE,2019,4149,4038,111,2.7,9
"Pierce County, NE",NE,2018,4140,4029,111,2.7,-15
"Pierce County, NE",NE,2017,4155,4041,114,2.7,-13
"Pierce County, NE",NE,2016,4168,4059,109,2.6,-15
"Pierce County, NE",NE,2015,4183,4077,106,2.5,-59
"Pierce County, NE",NE,2014,4242,4121,121,2.9,32
"Pierce County, NE",NE,2013,4210,4072,138,3.3,22
"Pierce County, NE",NE,2012,4188,4052,136,3.2,-25
"Pierce County, NE",NE,2011,4213,4064,149,3.5,44
"Pierce County, NE",NE,2010,4169,4013,156,3.7,0
"Pierce County, WA",WA,2021,448785,421606,27179,6.1,-4856
"Pierce County, WA",WA,2020,453641,410559,43082,9.5,6345
"Pierce County, WA",WA,2019,447296,423850,23446,5.2,19046
"Pierce County, WA",WA,2018,428250,406220,22030,5.1,10361
"Pierce County, WA",WA,2017,417889,395846,22043,5.3,12919
"Pierce County, WA",WA,2016,404970,380954,24016,5.9,12691
"Pierce County, WA",WA,2015,392279,367880,24399,6.2,7445
"Pierce County, WA",WA,2014,384834,358653,26181,6.8,1065
"Pierce County, WA",WA,2013,383769,352522,31247,8.1,-1329
"Pierce County, WA",WA,2012,385098,352308,32790,8.5,2195
"Pierce County, WA",WA,2011,382903,348050,34853,9.1,-4927
"Pierce County, WA",WA,2010,387830,351104,36726,9.5,0
"Pierce County, WI",WI,2021,25048,24184,864,3.4,38
"Pierce County, WI",WI,2020,25010,23256,1754,7.0,-435
"Pierce County, WI",WI,2019,25445,24626,819,3.2,-107
"Pierce County, WI",WI,2018,25552,24743,809,3.2,314
"Pierce County, WI",WI,2017,25238,24398,840,3.3,621
"Pierce County, WI",WI,2016,24617,23645,972,3.9,540
"Pierce County, WI",WI,2015,24077,23152,925,3.8,86
"Pierce County, WI",WI,2014,23991,22945,1046,4.4,-2
"Pierce County, WI",WI,2013,23993,22737,1256,5.2,119
"Pierce County, WI",WI,2012,23874,22576,1298,5.4,-76
"Pierce County, WI",WI,2011,23950,22542,1408,5.9,-52
"Pierce County, WI",WI,2010,24002,22368,1634,6.8,0
"Pike County, AL",AL,2021,16017,15504,513,3.2,176
"Pike County, AL",AL,2020,15841,14976,865,5.5,271
"Pike County, AL",AL,2019,15570,15033,537,3.4,146
"Pike County, AL",AL,2018,15424,14731,693,4.5,-45
"Pike County, AL",AL,2017,15469,14700,769,5.0,644
"Pike County, AL",AL,2016,14825,13860,965,6.5,-79
"Pike County, AL",AL,2015,14904,13918,986,6.6,-71
"Pike County, AL",AL,2014,14975,13877,1098,7.3,64
"Pike County, AL",AL,2013,14911,13755,1156,7.8,-123
"Pike County, AL",AL,2012,15034,13802,1232,8.2,-413
"Pike County, AL",AL,2011,15447,14077,1370,8.9,-251
"Pike County, AL",AL,2010,15698,14229,1469,9.4,0
"Pike County, AR",AR,2021,4183,3999,184,4.4,-87
"Pike County, AR",AR,2020,4270,4016,254,5.9,22
"Pike County, AR",AR,2019,4248,4089,159,3.7,-49
"Pike County, AR",AR,2018,4297,4124,173,4.0,4
"Pike County, AR",AR,2017,4293,4120,173,4.0,65
"Pike County, AR",AR,2016,4228,4048,180,4.3,-3
"Pike County, AR",AR,2015,4231,3987,244,5.8,-42
"Pike County, AR",AR,2014,4273,3970,303,7.1,13
"Pike County, AR",AR,2013,4260,3898,362,8.5,-173
"Pike County, AR",AR,2012,4433,4052,381,8.6,-258
"Pike County, AR",AR,2011,4691,4248,443,9.4,-209
"Pike County, AR",AR,2010,4900,4475,425,8.7,0
"Pike County, GA",GA,2021,8981,8728,253,2.8,284
"Pike County, GA",GA,2020,8697,8271,426,4.9,-302
"Pike County, GA",GA,2019,8999,8714,285,3.2,118
"Pike County, GA",GA,2018,8881,8557,324,3.6,135
"Pike County, GA",GA,2017,8746,8352,394,4.5,344
"Pike County, GA",GA,2016,8402,7961,441,5.2,268
"Pike County, GA",GA,2015,8134,7660,474,5.8,-47
"Pike County, GA",GA,2014,8181,7605,576,7.0,-111
"Pike County, GA",GA,2013,8292,7594,698,8.4,-100
"Pike County, GA",GA,2012,8392,7628,764,9.1,-28
"Pike County, GA",GA,2011,8420,7569,851,10.1,-108
"Pike County, GA",GA,2010,8528,7608,920,10.8,0
"Pike County, IL",IL,2021,6787,6510,277,4.1,56
"Pike County, IL",IL,2020,6731,6323,408,6.1,-323
"Pike County, IL",IL,2019,7054,6762,292,4.1,-181
"Pike County, IL",IL,2018,7235,6889,346,4.8,-67
"Pike County, IL",IL,2017,7302,6971,331,4.5,-240
"Pike County, IL",IL,2016,7542,7155,387,5.1,-86
"Pike County, IL",IL,2015,7628,7232,396,5.2,-120
"Pike County, IL",IL,2014,7748,7298,450,5.8,61
"Pike County, IL",IL,2013,7687,7111,576,7.5,-76
"Pike County, IL",IL,2012,7763,7173,590,7.6,-151
"Pike County, IL",IL,2011,7914,7276,638,8.1,-195
"Pike County, IL",IL,2010,8109,7378,731,9.0,0
"Pike County, IN",IN,2021,5782,5586,196,3.4,-389
"Pike County, IN",IN,2020,6171,5808,363,5.9,27
"Pike County, IN",IN,2019,6144,5944,200,3.3,0
"Pike County, IN",IN,2018,6144,5932,212,3.5,-305
"Pike County, IN",IN,2017,6449,6236,213,3.3,112
"Pike County, IN",IN,2016,6337,6065,272,4.3,149
"Pike County, IN",IN,2015,6188,5920,268,4.3,-162
"Pike County, IN",IN,2014,6350,6029,321,5.1,77
"Pike County, IN",IN,2013,6273,5855,418,6.7,136
"Pike County, IN",IN,2012,6137,5691,446,7.3,-113
"Pike County, IN",IN,2011,6250,5769,481,7.7,45
"Pike County, IN",IN,2010,6205,5630,575,9.3,0
"Pike County, KY",KY,2021,19105,17891,1214,6.4,7
"Pike County, KY",KY,2020,19098,17552,1546,8.1,-955
"Pike County, KY",KY,2019,20053,18967,1086,5.4,87
"Pike County, KY",KY,2018,19966,18825,1141,5.7,-387
"Pike County, KY",KY,2017,20353,18804,1549,7.6,128
"Pike County, KY",KY,2016,20225,18052,2173,10.7,-617
"Pike County, KY",KY,2015,20842,18924,1918,9.2,-1158
"Pike County, KY",KY,2014,22000,19696,2304,10.5,-1290
"Pike County, KY",KY,2013,23290,20548,2742,11.8,-919
"Pike County, KY",KY,2012,24209,21853,2356,9.7,-176
"Pike County, KY",KY,2011,24385,22156,2229,9.1,-254
"Pike County, KY",KY,2010,24639,22039,2600,10.6,0
"Pike County, MO",MO,2021,7382,7092,290,3.9,-76
"Pike County, MO",MO,2020,7458,7059,399,5.3,-14
"Pike County, MO",MO,2019,7472,7222,250,3.3,-190
"Pike County, MO",MO,2018,7662,7390,272,3.5,-263
"Pike County, MO",MO,2017,7925,7653,272,3.4,-131
"Pike County, MO",MO,2016,8056,7694,362,4.5,-4
"Pike County, MO",MO,2015,8060,7684,376,4.7,-58
"Pike County, MO",MO,2014,8118,7654,464,5.7,45
"Pike County, MO",MO,2013,8073,7542,531,6.6,-7
"Pike County, MO",MO,2012,8080,7508,572,7.1,-86
"Pike County, MO",MO,2011,8166,7473,693,8.5,-37
"Pike County, MO",MO,2010,8203,7407,796,9.7,0
"Pike County, MS",MS,2021,14405,13381,1024,7.1,1
"Pike County, MS",MS,2020,14404,13142,1262,8.8,-127
"Pike County, MS",MS,2019,14531,13577,954,6.6,83
"Pike County, MS",MS,2018,14448,13586,862,6.0,7
"Pike County, MS",MS,2017,14441,13539,902,6.2,-167
"Pike County, MS",MS,2016,14608,13597,1011,6.9,-44
"Pike County, MS",MS,2015,14652,13568,1084,7.4,154
"Pike County, MS",MS,2014,14498,13285,1213,8.4,-152
"Pike County, MS",MS,2013,14650,13219,1431,9.8,-776
"Pike County, MS",MS,2012,15426,13834,1592,10.3,-369
"Pike County, MS",MS,2011,15795,14010,1785,11.3,159
"Pike County, MS",MS,2010,15636,13871,1765,11.3,0
"Pike County, OH",OH,2021,10912,10225,687,6.3,55
"Pike County, OH",OH,2020,10857,9837,1020,9.4,-32
"Pike County, OH",OH,2019,10889,10210,679,6.2,-33
"Pike County, OH",OH,2018,10922,10214,708,6.5,2
"Pike County, OH",OH,2017,10920,10160,760,7.0,69
"Pike County, OH",OH,2016,10851,10031,820,7.6,340
"Pike County, OH",OH,2015,10511,9734,777,7.4,-18
"Pike County, OH",OH,2014,10529,9575,954,9.1,-229
"Pike County, OH",OH,2013,10758,9446,1312,12.2,187
"Pike County, OH",OH,2012,10571,9194,1377,13.0,-430
"Pike County, OH",OH,2011,11001,9332,1669,15.2,-603
"Pike County, OH",OH,2010,11604,9881,1723,14.8,0
"Pike County, PA",PA,2021,25175,23327,1848,7.3,-240
"Pike County, PA",PA,2020,25415,22737,2678,10.5,-225
"Pike County, PA",PA,2019,25640,24181,1459,5.7,266
"Pike County, PA",PA,2018,25374,23975,1399,5.5,372
"Pike County, PA",PA,2017,25002,23496,1506,6.0,34
"Pike County, PA",PA,2016,24968,23395,1573,6.3,-30
"Pike County, PA",PA,2015,24998,23335,1663,6.7,-137
"Pike County, PA",PA,2014,25135,23209,1926,7.7,-652
"Pike County, PA",PA,2013,25787,23380,2407,9.3,-216
"Pike County, PA",PA,2012,26003,23431,2572,9.9,-37
"Pike County, PA",PA,2011,26040,23515,2525,9.7,-5
"Pike County, PA",PA,2010,26045,23592,2453,9.4,0
"Pima County, AZ",AZ,2021,480903,457095,23808,5.0,1558
"Pima County, AZ",AZ,2020,479345,443416,35929,7.5,-3112
"Pima County, AZ",AZ,2019,482457,460572,21885,4.5,11671
"Pima County, AZ",AZ,2018,470786,449984,20802,4.4,6556
"Pima County, AZ",AZ,2017,464230,443046,21184,4.6,-7222
"Pima County, AZ",AZ,2016,471452,447695,23757,5.0,3626
"Pima County, AZ",AZ,2015,467826,442099,25727,5.5,1928
"Pima County, AZ",AZ,2014,465898,437713,28185,6.0,3631
"Pima County, AZ",AZ,2013,462267,430789,31478,6.8,-4537
"Pima County, AZ",AZ,2012,466804,432392,34412,7.4,-2528
"Pima County, AZ",AZ,2011,469332,429711,39621,8.4,-10652
"Pima County, AZ",AZ,2010,479984,435352,44632,9.3,0
"Pinal County, AZ",AZ,2021,192406,183334,9072,4.7,4407
"Pinal County, AZ",AZ,2020,187999,174319,13680,7.3,3866
"Pinal County, AZ",AZ,2019,184133,174883,9250,5.0,9300
"Pinal County, AZ",AZ,2018,174833,166124,8709,5.0,7552
"Pinal County, AZ",AZ,2017,167281,158730,8551,5.1,2676
"Pinal County, AZ",AZ,2016,164605,155330,9275,5.6,6556
"Pinal County, AZ",AZ,2015,158049,148079,9970,6.3,3371
"Pinal County, AZ",AZ,2014,154678,143829,10849,7.0,4671
"Pinal County, AZ",AZ,2013,150007,137820,12187,8.1,67
"Pinal County, AZ",AZ,2012,149940,137136,12804,8.5,-424
"Pinal County, AZ",AZ,2011,150364,135795,14569,9.7,-3674
"Pinal County, AZ",AZ,2010,154038,137636,16402,10.6,0
"Pine County, MN",MN,2021,13970,13277,693,5.0,-719
"Pine County, MN",MN,2020,14689,13379,1310,8.9,-553
"Pine County, MN",MN,2019,15242,14351,891,5.8,290
"Pine County, MN",MN,2018,14952,14176,776,5.2,-106
"Pine County, MN",MN,2017,15058,14191,867,5.8,228
"Pine County, MN",MN,2016,14830,13963,867,5.8,5
"Pine County, MN",MN,2015,14825,13983,842,5.7,180
"Pine County, MN",MN,2014,14645,13726,919,6.3,-206
"Pine County, MN",MN,2013,14851,13808,1043,7.0,-50
"Pine County, MN",MN,2012,14901,13771,1130,7.6,-285
"Pine County, MN",MN,2011,15186,13843,1343,8.8,-185
"Pine County, MN",MN,2010,15371,13856,1515,9.9,0
"Pinellas County, FL",FL,2021,486173,466708,19465,4.0,9504
"Pinellas County, FL",FL,2020,476669,440134,36535,7.7,-5283
"Pinellas County, FL",FL,2019,481952,467042,14910,3.1,647
"Pinellas County, FL",FL,2018,481305,464814,16491,3.4,955
"Pinellas County, FL",FL,2017,480350,461683,18667,3.9,578
"Pinellas County, FL",FL,2016,479772,458724,21048,4.4,7306
"Pinellas County, FL",FL,2015,472466,448842,23624,5.0,1571
"Pinellas County, FL",FL,2014,470895,442921,27974,5.9,2012
"Pinellas County, FL",FL,2013,468883,436393,32490,6.9,4932
"Pinellas County, FL",FL,2012,463951,425850,38101,8.2,2702
"Pinellas County, FL",FL,2011,461249,416575,44674,9.7,-16
"Pinellas County, FL",FL,2010,461265,412869,48396,10.5,0
"Pipestone County, MN",MN,2021,4444,4317,127,2.9,-267
"Pipestone County, MN",MN,2020,4711,4513,198,4.2,-257
"Pipestone County, MN",MN,2019,4968,4784,184,3.7,16
"Pipestone County, MN",MN,2018,4952,4800,152,3.1,72
"Pipestone County, MN",MN,2017,4880,4716,164,3.4,-19
"Pipestone County, MN",MN,2016,4899,4712,187,3.8,-89
"Pipestone County, MN",MN,2015,4988,4818,170,3.4,196
"Pipestone County, MN",MN,2014,4792,4607,185,3.9,99
"Pipestone County, MN",MN,2013,4693,4474,219,4.7,-218
"Pipestone County, MN",MN,2012,4911,4665,246,5.0,-130
"Pipestone County, MN",MN,2011,5041,4712,329,6.5,-111
"Pipestone County, MN",MN,2010,5152,4812,340,6.6,0
"Piscataquis County, ME",ME,2021,7440,7067,373,5.0,283
"Piscataquis County, ME",ME,2020,7157,6798,359,5.0,-193
"Piscataquis County, ME",ME,2019,7350,7098,252,3.4,-166
"Piscataquis County, ME",ME,2018,7516,7229,287,3.8,-45
"Piscataquis County, ME",ME,2017,7561,7252,309,4.1,67
"Piscataquis County, ME",ME,2016,7494,7123,371,5.0,-7
"Piscataquis County, ME",ME,2015,7501,7087,414,5.5,-213
"Piscataquis County, ME",ME,2014,7714,7157,557,7.2,-167
"Piscataquis County, ME",ME,2013,7881,7182,699,8.9,31
"Piscataquis County, ME",ME,2012,7850,7134,716,9.1,-84
"Piscataquis County, ME",ME,2011,7934,7146,788,9.9,-66
"Piscataquis County, ME",ME,2010,8000,7114,886,11.1,0
"Pitkin County, CO",CO,2021,11127,10514,613,5.5,5
"Pitkin County, CO",CO,2020,11122,10017,1105,9.9,90
"Pitkin County, CO",CO,2019,11032,10704,328,3.0,-85
"Pitkin County, CO",CO,2018,11117,10727,390,3.5,228
"Pitkin County, CO",CO,2017,10889,10578,311,2.9,153
"Pitkin County, CO",CO,2016,10736,10390,346,3.2,-1
"Pitkin County, CO",CO,2015,10737,10337,400,3.7,-283
"Pitkin County, CO",CO,2014,11020,10486,534,4.8,241
"Pitkin County, CO",CO,2013,10779,10092,687,6.4,-98
"Pitkin County, CO",CO,2012,10877,10085,792,7.3,-27
"Pitkin County, CO",CO,2011,10904,10016,888,8.1,59
"Pitkin County, CO",CO,2010,10845,9922,923,8.5,0
"Pitt County, NC",NC,2021,87237,82839,4398,5.0,1605
"Pitt County, NC",NC,2020,85632,80018,5614,6.6,-3225
"Pitt County, NC",NC,2019,88857,85148,3709,4.2,569
"Pitt County, NC",NC,2018,88288,84456,3832,4.3,259
"Pitt County, NC",NC,2017,88029,83743,4286,4.9,94
"Pitt County, NC",NC,2016,87935,83032,4903,5.6,343
"Pitt County, NC",NC,2015,87592,82352,5240,6.0,121
"Pitt County, NC",NC,2014,87471,82000,5471,6.3,-563
"Pitt County, NC",NC,2013,88034,81135,6899,7.8,-431
"Pitt County, NC",NC,2012,88465,80207,8258,9.3,2237
"Pitt County, NC",NC,2011,86228,77504,8724,10.1,-6
"Pitt County, NC",NC,2010,86234,77553,8681,10.1,0
"Pittsburg County, OK",OK,2021,16392,15535,857,5.2,-218
"Pittsburg County, OK",OK,2020,16610,15332,1278,7.7,-507
"Pittsburg County, OK",OK,2019,17117,16438,679,4.0,-683
"Pittsburg County, OK",OK,2018,17800,17140,660,3.7,114
"Pittsburg County, OK",OK,2017,17686,16804,882,5.0,82
"Pittsburg County, OK",OK,2016,17604,16561,1043,5.9,190
"Pittsburg County, OK",OK,2015,17414,16446,968,5.6,273
"Pittsburg County, OK",OK,2014,17141,16124,1017,5.9,-810
"Pittsburg County, OK",OK,2013,17951,16678,1273,7.1,-997
"Pittsburg County, OK",OK,2012,18948,17661,1287,6.8,-31
"Pittsburg County, OK",OK,2011,18979,17651,1328,7.0,87
"Pittsburg County, OK",OK,2010,18892,17410,1482,7.8,0
"Pittsylvania County, VA",VA,2021,29293,28119,1174,4.0,-679
"Pittsylvania County, VA",VA,2020,29972,28049,1923,6.4,-475
"Pittsylvania County, VA",VA,2019,30447,29440,1007,3.3,-342
"Pittsylvania County, VA",VA,2018,30789,29709,1080,3.5,-156
"Pittsylvania County, VA",VA,2017,30945,29632,1313,4.2,1213
"Pittsylvania County, VA",VA,2016,29732,28343,1389,4.7,-453
"Pittsylvania County, VA",VA,2015,30185,28606,1579,5.2,-168
"Pittsylvania County, VA",VA,2014,30353,28461,1892,6.2,-84
"Pittsylvania County, VA",VA,2013,30437,28347,2090,6.9,-247
"Pittsylvania County, VA",VA,2012,30684,28344,2340,7.6,-429
"Pittsylvania County, VA",VA,2011,31113,28290,2823,9.1,150
"Pittsylvania County, VA",VA,2010,30963,27529,3434,11.1,0
"Piute County, UT",UT,2021,479,458,21,4.4,-2
"Piute County, UT",UT,2020,481,451,30,6.2,-3
"Piute County, UT",UT,2019,484,462,22,4.5,0
"Piute County, UT",UT,2018,484,460,24,5.0,-1
"Piute County, UT",UT,2017,485,462,23,4.7,29
"Piute County, UT",UT,2016,456,430,26,5.7,-6
"Piute County, UT",UT,2015,462,433,29,6.3,7
"Piute County, UT",UT,2014,455,424,31,6.8,-22
"Piute County, UT",UT,2013,477,443,34,7.1,-5
"Piute County, UT",UT,2012,482,446,36,7.5,-45
"Piute County, UT",UT,2011,527,472,55,10.4,-41
"Piute County, UT",UT,2010,568,511,57,10.0,0
"Placer County, CA",CA,2021,188045,178657,9388,5.0,1381
"Placer County, CA",CA,2020,186664,172621,14043,7.5,-2236
"Placer County, CA",CA,2019,188900,182933,5967,3.2,3295
"Placer County, CA",CA,2018,185605,179626,5979,3.2,4374
"Placer County, CA",CA,2017,181231,174177,7054,3.9,1597
"Placer County, CA",CA,2016,179634,171550,8084,4.5,3295
"Placer County, CA",CA,2015,176339,167367,8972,5.1,1242
"Placer County, CA",CA,2014,175097,163994,11103,6.3,-92
"Placer County, CA",CA,2013,175189,161492,13697,7.8,655
"Placer County, CA",CA,2012,174534,157910,16624,9.5,1064
"Placer County, CA",CA,2011,173470,154313,19157,11.0,37
"Placer County, CA",CA,2010,173433,152847,20586,11.9,0
"Plaquemines Parish, LA",LA,2021,9539,9126,413,4.3,11
"Plaquemines Parish, LA",LA,2020,9528,8817,711,7.5,-513
"Plaquemines Parish, LA",LA,2019,10041,9621,420,4.2,-47
"Plaquemines Parish, LA",LA,2018,10088,9626,462,4.6,61
"Plaquemines Parish, LA",LA,2017,10027,9560,467,4.7,-170
"Plaquemines Parish, LA",LA,2016,10197,9651,546,5.4,-89
"Plaquemines Parish, LA",LA,2015,10286,9714,572,5.6,91
"Plaquemines Parish, LA",LA,2014,10195,9626,569,5.6,130
"Plaquemines Parish, LA",LA,2013,10065,9516,549,5.5,-114
"Plaquemines Parish, LA",LA,2012,10179,9602,577,5.7,49
"Plaquemines Parish, LA",LA,2011,10130,9522,608,6.0,99
"Plaquemines Parish, LA",LA,2010,10031,9458,573,5.7,0
"Platte County, MO",MO,2021,59458,57052,2406,4.0,705
"Platte County, MO",MO,2020,58753,55594,3159,5.4,-148
"Platte County, MO",MO,2019,58901,57419,1482,2.5,996
"Platte County, MO",MO,2018,57905,56436,1469,2.5,309
"Platte County, MO",MO,2017,57596,55769,1827,3.2,950
"Platte County, MO",MO,2016,56646,54601,2045,3.6,1552
"Platte County, MO",MO,2015,55094,52734,2360,4.3,1303
"Platte County, MO",MO,2014,53791,51030,2761,5.1,1212
"Platte County, MO",MO,2013,52579,49573,3006,5.7,481
"Platte County, MO",MO,2012,52098,49141,2957,5.7,333
"Platte County, MO",MO,2011,51765,48111,3654,7.1,399
"Platte County, MO",MO,2010,51366,47425,3941,7.7,0
"Platte County, NE",NE,2021,18327,17934,393,2.1,382
"Platte County, NE",NE,2020,17945,17295,650,3.6,47
"Platte County, NE",NE,2019,17898,17376,522,2.9,306
"Platte County, NE",NE,2018,17592,17111,481,2.7,186
"Platte County, NE",NE,2017,17406,16900,506,2.9,338
"Platte County, NE",NE,2016,17068,16476,592,3.5,-141
"Platte County, NE",NE,2015,17209,16698,511,3.0,-116
"Platte County, NE",NE,2014,17325,16812,513,3.0,-368
"Platte County, NE",NE,2013,17693,17093,600,3.4,-316
"Platte County, NE",NE,2012,18009,17369,640,3.6,177
"Platte County, NE",NE,2011,17832,17088,744,4.2,203
"Platte County, NE",NE,2010,17629,16871,758,4.3,0
"Platte County, WY",WY,2021,4508,4327,181,4.0,-72
"Platte County, WY",WY,2020,4580,4351,229,5.0,13
"Platte County, WY",WY,2019,4567,4403,164,3.6,-238
"Platte County, WY",WY,2018,4805,4625,180,3.7,18
"Platte County, WY",WY,2017,4787,4605,182,3.8,12
"Platte County, WY",WY,2016,4775,4544,231,4.8,-96
"Platte County, WY",WY,2015,4871,4683,188,3.9,146
"Platte County, WY",WY,2014,4725,4534,191,4.0,-10
"Platte County, WY",WY,2013,4735,4525,210,4.4,3
"Platte County, WY",WY,2012,4732,4493,239,5.1,-166
"Platte County, WY",WY,2011,4898,4637,261,5.3,-40
"Platte County, WY",WY,2010,4938,4644,294,6.0,0
"Pleasants County, WV",WV,2021,2696,2503,193,7.2,19
"Pleasants County, WV",WV,2020,2677,2384,293,10.9,-235
"Pleasants County, WV",WV,2019,2912,2712,200,6.9,40
"Pleasants County, WV",WV,2018,2872,2696,176,6.1,38
"Pleasants County, WV",WV,2017,2834,2634,200,7.1,-130
"Pleasants County, WV",WV,2016,2964,2721,243,8.2,-55
"Pleasants County, WV",WV,2015,3019,2768,251,8.3,16
"Pleasants County, WV",WV,2014,3003,2793,210,7.0,107
"Pleasants County, WV",WV,2013,2896,2688,208,7.2,18
"Pleasants County, WV",WV,2012,2878,2635,243,8.4,-37
"Pleasants County, WV",WV,2011,2915,2638,277,9.5,-19
"Pleasants County, WV",WV,2010,2934,2623,311,10.6,0
"Plumas County, CA",CA,2021,7382,6682,700,9.5,-233
"Plumas County, CA",CA,2020,7615,6768,847,11.1,-276
"Plumas County, CA",CA,2019,7891,7275,616,7.8,76
"Plumas County, CA",CA,2018,7815,7219,596,7.6,51
"Plumas County, CA",CA,2017,7764,7070,694,8.9,-87
"Plumas County, CA",CA,2016,7851,7085,766,9.8,-40
"Plumas County, CA",CA,2015,7891,7076,815,10.3,-197
"Plumas County, CA",CA,2014,8088,7144,944,11.7,-144
"Plumas County, CA",CA,2013,8232,7080,1152,14.0,-245
"Plumas County, CA",CA,2012,8477,7087,1390,16.4,-409
"Plumas County, CA",CA,2011,8886,7297,1589,17.9,-286
"Plumas County, CA",CA,2010,9172,7460,1712,18.7,0
"Plymouth County, IA",IA,2021,14441,14005,436,3.0,10
"Plymouth County, IA",IA,2020,14431,13923,508,3.5,-710
"Plymouth County, IA",IA,2019,15141,14819,322,2.1,263
"Plymouth County, IA",IA,2018,14878,14595,283,1.9,61
"Plymouth County, IA",IA,2017,14817,14469,348,2.3,-270
"Plymouth County, IA",IA,2016,15087,14705,382,2.5,294
"Plymouth County, IA",IA,2015,14793,14380,413,2.8,128
"Plymouth County, IA",IA,2014,14665,14163,502,3.4,156
"Plymouth County, IA",IA,2013,14509,13928,581,4.0,261
"Plymouth County, IA",IA,2012,14248,13663,585,4.1,-59
"Plymouth County, IA",IA,2011,14307,13658,649,4.5,-220
"Plymouth County, IA",IA,2010,14527,13865,662,4.6,0
"Plymouth County, MA",MA,2021,283684,266284,17400,6.1,50
"Plymouth County, MA",MA,2020,283634,255314,28320,10.0,-5236
"Plymouth County, MA",MA,2019,288870,279665,9205,3.2,4177
"Plymouth County, MA",MA,2018,284693,274377,10316,3.6,6869
"Plymouth County, MA",MA,2017,277824,266641,11183,4.0,7281
"Plymouth County, MA",MA,2016,270543,259120,11423,4.2,2553
"Plymouth County, MA",MA,2015,267990,254463,13527,5.0,1156
"Plymouth County, MA",MA,2014,266834,250815,16019,6.0,3994
"Plymouth County, MA",MA,2013,262840,244681,18159,6.9,1004
"Plymouth County, MA",MA,2012,261836,243400,18436,7.0,-34
"Plymouth County, MA",MA,2011,261870,241599,20271,7.7,-57
"Plymouth County, MA",MA,2010,261927,239166,22761,8.7,0
"Pocahontas County, IA",IA,2021,4228,4099,129,3.1,-14
"Pocahontas County, IA",IA,2020,4242,4097,145,3.4,-347
"Pocahontas County, IA",IA,2019,4589,4506,83,1.8,180
"Pocahontas County, IA",IA,2018,4409,4329,80,1.8,195
"Pocahontas County, IA",IA,2017,4214,4114,100,2.4,-126
"Pocahontas County, IA",IA,2016,4340,4217,123,2.8,29
"Pocahontas County, IA",IA,2015,4311,4181,130,3.0,-17
"Pocahontas County, IA",IA,2014,4328,4177,151,3.5,130
"Pocahontas County, IA",IA,2013,4198,4038,160,3.8,19
"Pocahontas County, IA",IA,2012,4179,4010,169,4.0,81
"Pocahontas County, IA",IA,2011,4098,3915,183,4.5,53
"Pocahontas County, IA",IA,2010,4045,3835,210,5.2,0
"Pocahontas County, WV",WV,2021,3920,3724,196,5.0,123
"Pocahontas County, WV",WV,2020,3797,3455,342,9.0,-104
"Pocahontas County, WV",WV,2019,3901,3680,221,5.7,63
"Pocahontas County, WV",WV,2018,3838,3605,233,6.1,69
"Pocahontas County, WV",WV,2017,3769,3545,224,5.9,30
"Pocahontas County, WV",WV,2016,3739,3490,249,6.7,107
"Pocahontas County, WV",WV,2015,3632,3343,289,8.0,63
"Pocahontas County, WV",WV,2014,3569,3265,304,8.5,-30
"Pocahontas County, WV",WV,2013,3599,3294,305,8.5,-20
"Pocahontas County, WV",WV,2012,3619,3264,355,9.8,-58
"Pocahontas County, WV",WV,2011,3677,3280,397,10.8,-118
"Pocahontas County, WV",WV,2010,3795,3358,437,11.5,0
"Poinsett County, AR",AR,2021,9676,9299,377,3.9,-77
"Poinsett County, AR",AR,2020,9753,9206,547,5.6,-284
"Poinsett County, AR",AR,2019,10037,9698,339,3.4,-93
"Poinsett County, AR",AR,2018,10130,9746,384,3.8,-125
"Poinsett County, AR",AR,2017,10255,9826,429,4.2,147
"Poinsett County, AR",AR,2016,10108,9675,433,4.3,3
"Poinsett County, AR",AR,2015,10105,9548,557,5.5,-72
"Poinsett County, AR",AR,2014,10177,9489,688,6.8,-21
"Poinsett County, AR",AR,2013,10198,9360,838,8.2,-225
"Poinsett County, AR",AR,2012,10423,9556,867,8.3,-332
"Poinsett County, AR",AR,2011,10755,9775,980,9.1,33
"Poinsett County, AR",AR,2010,10722,9758,964,9.0,0
"Pointe Coupee Parish, LA",LA,2021,9544,8997,547,5.7,98
"Pointe Coupee Parish, LA",LA,2020,9446,8653,793,8.4,-366
"Pointe Coupee Parish, LA",LA,2019,9812,9304,508,5.2,-131
"Pointe Coupee Parish, LA",LA,2018,9943,9415,528,5.3,-71
"Pointe Coupee Parish, LA",LA,2017,10014,9455,559,5.6,42
"Pointe Coupee Parish, LA",LA,2016,9972,9325,647,6.5,-113
"Pointe Coupee Parish, LA",LA,2015,10085,9423,662,6.6,24
"Pointe Coupee Parish, LA",LA,2014,10061,9366,695,6.9,152
"Pointe Coupee Parish, LA",LA,2013,9909,9187,722,7.3,-12
"Pointe Coupee Parish, LA",LA,2012,9921,9146,775,7.8,-87
"Pointe Coupee Parish, LA",LA,2011,10008,9139,869,8.7,20
"Pointe Coupee Parish, LA",LA,2010,9988,9171,817,8.2,0
"Polk County, AR",AR,2021,7771,7428,343,4.4,-234
"Polk County, AR",AR,2020,8005,7468,537,6.7,-74
"Polk County, AR",AR,2019,8079,7748,331,4.1,15
"Polk County, AR",AR,2018,8064,7737,327,4.1,37
"Polk County, AR",AR,2017,8027,7665,362,4.5,-167
"Polk County, AR",AR,2016,8194,7794,400,4.9,-168
"Polk County, AR",AR,2015,8362,7887,475,5.7,-184
"Polk County, AR",AR,2014,8546,8024,522,6.1,1
"Polk County, AR",AR,2013,8545,7950,595,7.0,-227
"Polk County, AR",AR,2012,8772,8148,624,7.1,-157
"Polk County, AR",AR,2011,8929,8246,683,7.6,-83
"Polk County, AR",AR,2010,9012,8367,645,7.2,0
"Polk County, FL",FL,2021,328590,311005,17585,5.4,8891
"Polk County, FL",FL,2020,319699,288447,31252,9.8,15831
"Polk County, FL",FL,2019,303868,292210,11658,3.8,7317
"Polk County, FL",FL,2018,296551,283912,12639,4.3,5430
"Polk County, FL",FL,2017,291121,276937,14184,4.9,3278
"Polk County, FL",FL,2016,287843,271786,16057,5.6,6784
"Polk County, FL",FL,2015,281059,263119,17940,6.4,2931
"Polk County, FL",FL,2014,278128,257543,20585,7.4,2
"Polk County, FL",FL,2013,278126,254278,23848,8.6,2724
"Polk County, FL",FL,2012,275402,248119,27283,9.9,108
"Polk County, FL",FL,2011,275294,244352,30942,11.2,-663
"Polk County, FL",FL,2010,275957,243488,32469,11.8,0
"Polk County, GA",GA,2021,18480,17823,657,3.6,200
"Polk County, GA",GA,2020,18280,17199,1081,5.9,-313
"Polk County, GA",GA,2019,18593,17889,704,3.8,2
"Polk County, GA",GA,2018,18591,17800,791,4.3,-72
"Polk County, GA",GA,2017,18663,17679,984,5.3,591
"Polk County, GA",GA,2016,18072,16948,1124,6.2,127
"Polk County, GA",GA,2015,17945,16736,1209,6.7,-368
"Polk County, GA",GA,2014,18313,16881,1432,7.8,-170
"Polk County, GA",GA,2013,18483,16848,1635,8.8,-247
"Polk County, GA",GA,2012,18730,16883,1847,9.9,75
"Polk County, GA",GA,2011,18655,16514,2141,11.5,-100
"Polk County, GA",GA,2010,18755,16464,2291,12.2,0
"Polk County, IA",IA,2021,267873,255823,12050,4.5,1667
"Polk County, IA",IA,2020,266206,250540,15666,5.9,-8734
"Polk County, IA",IA,2019,274940,267525,7415,2.7,7070
"Polk County, IA",IA,2018,267870,261016,6854,2.6,5253
"Polk County, IA",IA,2017,262617,254702,7915,3.0,3928
"Polk County, IA",IA,2016,258689,249790,8899,3.4,3020
"Polk County, IA",IA,2015,255669,246352,9317,3.6,10
"Polk County, IA",IA,2014,255659,244872,10787,4.2,4930
"Polk County, IA",IA,2013,250729,238664,12065,4.8,5597
"Polk County, IA",IA,2012,245132,232379,12753,5.2,1086
"Polk County, IA",IA,2011,244046,229969,14077,5.8,-268
"Polk County, IA",IA,2010,244314,229491,14823,6.1,0
"Polk County, MN",MN,2021,15699,15100,599,3.8,-691
"Polk County, MN",MN,2020,16390,15434,956,5.8,-491
"Polk County, MN",MN,2019,16881,16172,709,4.2,100
"Polk County, MN",MN,2018,16781,16119,662,3.9,-291
"Polk County, MN",MN,2017,17072,16348,724,4.2,-64
"Polk County, MN",MN,2016,17136,16392,744,4.3,-72
"Polk County, MN",MN,2015,17208,16466,742,4.3,80
"Polk County, MN",MN,2014,17128,16320,808,4.7,9
"Polk County, MN",MN,2013,17119,16184,935,5.5,-408
"Polk County, MN",MN,2012,17527,16430,1097,6.3,66
"Polk County, MN",MN,2011,17461,16227,1234,7.1,290
"Polk County, MN",MN,2010,17171,16028,1143,6.7,0
"Polk County, MO",MO,2021,14576,14067,509,3.5,286
"Polk County, MO",MO,2020,14290,13623,667,4.7,-105
"Polk County, MO",MO,2019,14395,13923,472,3.3,17
"Polk County, MO",MO,2018,14378,13861,517,3.6,200
"Polk County, MO",MO,2017,14178,13615,563,4.0,-27
"Polk County, MO",MO,2016,14205,13516,689,4.9,32
"Polk County, MO",MO,2015,14173,13410,763,5.4,108
"Polk County, MO",MO,2014,14065,13166,899,6.4,187
"Polk County, MO",MO,2013,13878,12880,998,7.2,-112
"Polk County, MO",MO,2012,13990,12876,1114,8.0,-273
"Polk County, MO",MO,2011,14263,12903,1360,9.5,-80
"Polk County, MO",MO,2010,14343,12879,1464,10.2,0
"Polk County, NC",NC,2021,9029,8607,422,4.7,310
"Polk County, NC",NC,2020,8719,8192,527,6.0,-312
"Polk County, NC",NC,2019,9031,8697,334,3.7,207
"Polk County, NC",NC,2018,8824,8485,339,3.8,33
"Polk County, NC",NC,2017,8791,8425,366,4.2,-7
"Polk County, NC",NC,2016,8798,8389,409,4.6,145
"Polk County, NC",NC,2015,8653,8217,436,5.0,245
"Polk County, NC",NC,2014,8408,7971,437,5.2,-278
"Polk County, NC",NC,2013,8686,8126,560,6.4,269
"Polk County, NC",NC,2012,8417,7686,731,8.7,-73
"Polk County, NC",NC,2011,8490,7699,791,9.3,-103
"Polk County, NC",NC,2010,8593,7730,863,10.0,0
"Polk County, NE",NE,2021,2951,2896,55,1.9,4
"Polk County, NE",NE,2020,2947,2860,87,3.0,-9
"Polk County, NE",NE,2019,2956,2874,82,2.8,32
"Polk County, NE",NE,2018,2924,2853,71,2.4,5
"Polk County, NE",NE,2017,2919,2849,70,2.4,21
"Polk County, NE",NE,2016,2898,2821,77,2.7,-23
"Polk County, NE",NE,2015,2921,2847,74,2.5,-43
"Polk County, NE",NE,2014,2964,2870,94,3.2,-27
"Polk County, NE",NE,2013,2991,2891,100,3.3,4
"Polk County, NE",NE,2012,2987,2898,89,3.0,-14
"Polk County, NE",NE,2011,3001,2898,103,3.4,47
"Polk County, NE",NE,2010,2954,2833,121,4.1,0
"Polk County, OR",OR,2021,42006,39974,2032,4.8,1362
"Polk County, OR",OR,2020,40644,37994,2650,6.5,626
"Polk County, OR",OR,2019,40018,38420,1598,4.0,660
"Polk County, OR",OR,2018,39358,37694,1664,4.2,295
"Polk County, OR",OR,2017,39063,37397,1666,4.3,827
"Polk County, OR",OR,2016,38236,36337,1899,5.0,1629
"Polk County, OR",OR,2015,36607,34598,2009,5.5,878
"Polk County, OR",OR,2014,35729,33335,2394,6.7,785
"Polk County, OR",OR,2013,34944,32158,2786,8.0,-486
"Polk County, OR",OR,2012,35430,32281,3149,8.9,-901
"Polk County, OR",OR,2011,36331,32928,3403,9.4,-192
"Polk County, OR",OR,2010,36523,32940,3583,9.8,0
"Polk County, TN",TN,2021,7119,6826,293,4.1,-265
"Polk County, TN",TN,2020,7384,6883,501,6.8,-85
"Polk County, TN",TN,2019,7469,7169,300,4.0,156
"Polk County, TN",TN,2018,7313,7006,307,4.2,-84
"Polk County, TN",TN,2017,7397,7061,336,4.5,3
"Polk County, TN",TN,2016,7394,6970,424,5.7,53
"Polk County, TN",TN,2015,7341,6862,479,6.5,-73
"Polk County, TN",TN,2014,7414,6827,587,7.9,-146
"Polk County, TN",TN,2013,7560,6867,693,9.2,81
"Polk County, TN",TN,2012,7479,6733,746,10.0,68
"Polk County, TN",TN,2011,7411,6573,838,11.3,67
"Polk County, TN",TN,2010,7344,6507,837,11.4,0
"Polk County, TX",TX,2021,18571,17079,1492,8.0,341
"Polk County, TX",TX,2020,18230,16625,1605,8.8,412
"Polk County, TX",TX,2019,17818,16962,856,4.8,150
"Polk County, TX",TX,2018,17668,16768,900,5.1,269
"Polk County, TX",TX,2017,17399,16330,1069,6.1,11
"Polk County, TX",TX,2016,17388,16287,1101,6.3,339
"Polk County, TX",TX,2015,17049,16009,1040,6.1,-159
"Polk County, TX",TX,2014,17208,16084,1124,6.5,-133
"Polk County, TX",TX,2013,17341,15990,1351,7.8,-159
"Polk County, TX",TX,2012,17500,16103,1397,8.0,-160
"Polk County, TX",TX,2011,17660,15954,1706,9.7,62
"Polk County, TX",TX,2010,17598,15877,1721,9.8,0
"Polk County, WI",WI,2021,25025,23985,1040,4.2,253
"Polk County, WI",WI,2020,24772,22992,1780,7.2,128
"Polk County, WI",WI,2019,24644,23700,944,3.8,-18
"Polk County, WI",WI,2018,24662,23758,904,3.7,-250
"Polk County, WI",WI,2017,24912,23984,928,3.7,106
"Polk County, WI",WI,2016,24806,23701,1105,4.5,262
"Polk County, WI",WI,2015,24544,23386,1158,4.7,136
"Polk County, WI",WI,2014,24408,23030,1378,5.6,106
"Polk County, WI",WI,2013,24302,22582,1720,7.1,333
"Polk County, WI",WI,2012,23969,22070,1899,7.9,-114
"Polk County, WI",WI,2011,24083,22063,2020,8.4,29
"Polk County, WI",WI,2010,24054,21702,2352,9.8,0
"Ponce Municipio, PR",PR,2021,48561,44233,4328,8.9,
"Ponce Municipio, PR",PR,2020,N.A.,N.A.,N.A.,N.A.,
"Ponce Municipio, PR",PR,2019,45327,40931,4396,9.7,596
"Ponce Municipio, PR",PR,2018,44731,40331,4400,9.8,-867
"Ponce Municipio, PR",PR,2017,45598,40291,5307,11.6,-2214
"Ponce Municipio, PR",PR,2016,47812,41397,6415,13.4,-596
"Ponce Municipio, PR",PR,2015,48408,41686,6722,13.9,-556
"Ponce Municipio, PR",PR,2014,48964,41435,7529,15.4,-1873
"Ponce Municipio, PR",PR,2013,50837,42728,8109,16.0,-1342
"Ponce Municipio, PR",PR,2012,52179,43880,8299,15.9,-1447
"Ponce Municipio, PR",PR,2011,53626,44602,9024,16.8,-1985
"Ponce Municipio, PR",PR,2010,55611,46076,9535,17.1,0
"Pondera County, MT",MT,2021,2633,2549,84,3.2,-38
"Pondera County, MT",MT,2020,2671,2543,128,4.8,-39
"Pondera County, MT",MT,2019,2710,2607,103,3.8,-30
"Pondera County, MT",MT,2018,2740,2629,111,4.1,-18
"Pondera County, MT",MT,2017,2758,2651,107,3.9,-106
"Pondera County, MT",MT,2016,2864,2739,125,4.4,-3
"Pondera County, MT",MT,2015,2867,2736,131,4.6,23
"Pondera County, MT",MT,2014,2844,2704,140,4.9,-60
"Pondera County, MT",MT,2013,2904,2762,142,4.9,-37
"Pondera County, MT",MT,2012,2941,2801,140,4.8,12
"Pondera County, MT",MT,2011,2929,2761,168,5.7,-26
"Pondera County, MT",MT,2010,2955,2785,170,5.8,0
"Pontotoc County, MS",MS,2021,15007,14341,666,4.4,164
"Pontotoc County, MS",MS,2020,14843,13723,1120,7.5,-135
"Pontotoc County, MS",MS,2019,14978,14324,654,4.4,387
"Pontotoc County, MS",MS,2018,14591,14013,578,4.0,-28
"Pontotoc County, MS",MS,2017,14619,14040,579,4.0,252
"Pontotoc County, MS",MS,2016,14367,13673,694,4.8,536
"Pontotoc County, MS",MS,2015,13831,13050,781,5.6,392
"Pontotoc County, MS",MS,2014,13439,12518,921,6.9,-237
"Pontotoc County, MS",MS,2013,13676,12671,1005,7.3,-554
"Pontotoc County, MS",MS,2012,14230,13143,1087,7.6,178
"Pontotoc County, MS",MS,2011,14052,12772,1280,9.1,352
"Pontotoc County, MS",MS,2010,13700,12344,1356,9.9,0
"Pontotoc County, OK",OK,2021,19191,18552,639,3.3,80
"Pontotoc County, OK",OK,2020,19111,18110,1001,5.2,224
"Pontotoc County, OK",OK,2019,18887,18323,564,3.0,286
"Pontotoc County, OK",OK,2018,18601,18050,551,3.0,85
"Pontotoc County, OK",OK,2017,18516,17856,660,3.6,74
"Pontotoc County, OK",OK,2016,18442,17717,725,3.9,210
"Pontotoc County, OK",OK,2015,18232,17524,708,3.9,479
"Pontotoc County, OK",OK,2014,17753,17011,742,4.2,11
"Pontotoc County, OK",OK,2013,17742,16800,942,5.3,-448
"Pontotoc County, OK",OK,2012,18190,17294,896,4.9,117
"Pontotoc County, OK",OK,2011,18073,17140,933,5.2,360
"Pontotoc County, OK",OK,2010,17713,16661,1052,5.9,0
"Pope County, AR",AR,2021,27266,26186,1080,4.0,-604
"Pope County, AR",AR,2020,27870,26218,1652,5.9,-1198
"Pope County, AR",AR,2019,29068,27848,1220,4.2,90
"Pope County, AR",AR,2018,28978,27710,1268,4.4,-111
"Pope County, AR",AR,2017,29089,27789,1300,4.5,-243
"Pope County, AR",AR,2016,29332,27981,1351,4.6,-554
"Pope County, AR",AR,2015,29886,28333,1553,5.2,-35
"Pope County, AR",AR,2014,29921,28094,1827,6.1,20
"Pope County, AR",AR,2013,29901,27768,2133,7.1,-297
"Pope County, AR",AR,2012,30198,28091,2107,7.0,-321
"Pope County, AR",AR,2011,30519,28246,2273,7.4,424
"Pope County, AR",AR,2010,30095,27834,2261,7.5,0
"Pope County, IL",IL,2021,1676,1591,85,5.1,38
"Pope County, IL",IL,2020,1638,1506,132,8.1,-47
"Pope County, IL",IL,2019,1685,1596,89,5.3,-80
"Pope County, IL",IL,2018,1765,1659,106,6.0,-21
"Pope County, IL",IL,2017,1786,1670,116,6.5,12
"Pope County, IL",IL,2016,1774,1647,127,7.2,5
"Pope County, IL",IL,2015,1769,1645,124,7.0,-27
"Pope County, IL",IL,2014,1796,1646,150,8.4,-34
"Pope County, IL",IL,2013,1830,1661,169,9.2,-53
"Pope County, IL",IL,2012,1883,1721,162,8.6,-87
"Pope County, IL",IL,2011,1970,1796,174,8.8,-59
"Pope County, IL",IL,2010,2029,1835,194,9.6,0
"Pope County, MN",MN,2021,6285,6109,176,2.8,-297
"Pope County, MN",MN,2020,6582,6280,302,4.6,-15
"Pope County, MN",MN,2019,6597,6378,219,3.3,159
"Pope County, MN",MN,2018,6438,6258,180,2.8,50
"Pope County, MN",MN,2017,6388,6190,198,3.1,89
"Pope County, MN",MN,2016,6299,6075,224,3.6,-104
"Pope County, MN",MN,2015,6403,6176,227,3.5,166
"Pope County, MN",MN,2014,6237,6004,233,3.7,268
"Pope County, MN",MN,2013,5969,5711,258,4.3,18
"Pope County, MN",MN,2012,5951,5671,280,4.7,78
"Pope County, MN",MN,2011,5873,5526,347,5.9,-11
"Pope County, MN",MN,2010,5884,5464,420,7.1,0
"Poquoson city, VA",VA,2021,6130,5960,170,2.8,-111
"Poquoson city, VA",VA,2020,6241,5980,261,4.2,-291
"Poquoson city, VA",VA,2019,6532,6376,156,2.4,107
"Poquoson city, VA",VA,2018,6425,6255,170,2.6,99
"Poquoson city, VA",VA,2017,6326,6113,213,3.4,150
"Poquoson city, VA",VA,2016,6176,5963,213,3.4,-50
"Poquoson city, VA",VA,2015,6226,5988,238,3.8,-95
"Poquoson city, VA",VA,2014,6321,6039,282,4.5,-28
"Poquoson city, VA",VA,2013,6349,6041,308,4.9,-4
"Poquoson city, VA",VA,2012,6353,6016,337,5.3,-7
"Poquoson city, VA",VA,2011,6360,5998,362,5.7,-42
"Poquoson city, VA",VA,2010,6402,6004,398,6.2,0
"Portage County, OH",OH,2021,84767,80765,4002,4.7,-613
"Portage County, OH",OH,2020,85380,79156,6224,7.3,-2633
"Portage County, OH",OH,2019,88013,84259,3754,4.3,623
"Portage County, OH",OH,2018,87390,83413,3977,4.6,-571
"Portage County, OH",OH,2017,87961,83542,4419,5.0,489
"Portage County, OH",OH,2016,87472,83048,4424,5.1,361
"Portage County, OH",OH,2015,87111,82825,4286,4.9,55
"Portage County, OH",OH,2014,87056,81956,5100,5.9,-595
"Portage County, OH",OH,2013,87651,80915,6736,7.7,-349
"Portage County, OH",OH,2012,88000,81596,6404,7.3,-1145
"Portage County, OH",OH,2011,89145,81246,7899,8.9,-1724
"Portage County, OH",OH,2010,90869,81455,9414,10.4,0
"Portage County, WI",WI,2021,38366,37021,1345,3.5,425
"Portage County, WI",WI,2020,37941,35883,2058,5.4,-736
"Portage County, WI",WI,2019,38677,37481,1196,3.1,-529
"Portage County, WI",WI,2018,39206,38039,1167,3.0,-531
"Portage County, WI",WI,2017,39737,38527,1210,3.0,351
"Portage County, WI",WI,2016,39386,37920,1466,3.7,-98
"Portage County, WI",WI,2015,39484,37715,1769,4.5,237
"Portage County, WI",WI,2014,39247,37092,2155,5.5,308
"Portage County, WI",WI,2013,38939,36266,2673,6.9,67
"Portage County, WI",WI,2012,38872,36071,2801,7.2,-48
"Portage County, WI",WI,2011,38920,36062,2858,7.3,-965
"Portage County, WI",WI,2010,39885,36752,3133,7.9,0
"Porter County, IN",IN,2021,83182,79974,3208,3.9,-1128
"Porter County, IN",IN,2020,84310,77433,6877,8.2,-2270
"Porter County, IN",IN,2019,86580,83354,3226,3.7,-889
"Porter County, IN",IN,2018,87469,84168,3301,3.8,1507
"Porter County, IN",IN,2017,85962,82509,3453,4.0,-395
"Porter County, IN",IN,2016,86357,81990,4367,5.1,1668
"Porter County, IN",IN,2015,84689,80174,4515,5.3,612
"Porter County, IN",IN,2014,84077,78881,5196,6.2,760
"Porter County, IN",IN,2013,83317,77418,5899,7.1,852
"Porter County, IN",IN,2012,82465,76282,6183,7.5,-32
"Porter County, IN",IN,2011,82497,75892,6605,8.0,839
"Porter County, IN",IN,2010,81658,74116,7542,9.2,0
"Portsmouth city, VA",VA,2021,43482,40574,2908,6.7,-1471
"Portsmouth city, VA",VA,2020,44953,40715,4238,9.4,63
"Portsmouth city, VA",VA,2019,44890,43153,1737,3.9,296
"Portsmouth city, VA",VA,2018,44594,42790,1804,4.0,-87
"Portsmouth city, VA",VA,2017,44681,42308,2373,5.3,578
"Portsmouth city, VA",VA,2016,44103,41436,2667,6.0,-314
"Portsmouth city, VA",VA,2015,44417,41689,2728,6.1,-809
"Portsmouth city, VA",VA,2014,45226,41996,3230,7.1,-235
"Portsmouth city, VA",VA,2013,45461,41847,3614,7.9,-169
"Portsmouth city, VA",VA,2012,45630,41689,3941,8.6,-71
"Portsmouth city, VA",VA,2011,45701,41440,4261,9.3,146
"Portsmouth city, VA",VA,2010,45555,41082,4473,9.8,0
"Posey County, IN",IN,2021,12821,12484,337,2.6,47
"Posey County, IN",IN,2020,12774,12136,638,5.0,-742
"Posey County, IN",IN,2019,13516,13149,367,2.7,-218
"Posey County, IN",IN,2018,13734,13351,383,2.8,199
"Posey County, IN",IN,2017,13535,13133,402,3.0,70
"Posey County, IN",IN,2016,13465,12941,524,3.9,166
"Posey County, IN",IN,2015,13299,12774,525,3.9,138
"Posey County, IN",IN,2014,13161,12534,627,4.8,191
"Posey County, IN",IN,2013,12970,12164,806,6.2,-235
"Posey County, IN",IN,2012,13205,12326,879,6.7,-252
"Posey County, IN",IN,2011,13457,12552,905,6.7,-45
"Posey County, IN",IN,2010,13502,12481,1021,7.6,0
"Pottawatomie County, KS",KS,2021,12242,11935,307,2.5,110
"Pottawatomie County, KS",KS,2020,12132,11642,490,4.0,-323
"Pottawatomie County, KS",KS,2019,12455,12107,348,2.8,-73
"Pottawatomie County, KS",KS,2018,12528,12191,337,2.7,278
"Pottawatomie County, KS",KS,2017,12250,11875,375,3.1,43
"Pottawatomie County, KS",KS,2016,12207,11782,425,3.5,220
"Pottawatomie County, KS",KS,2015,11987,11550,437,3.6,-61
"Pottawatomie County, KS",KS,2014,12048,11582,466,3.9,97
"Pottawatomie County, KS",KS,2013,11951,11401,550,4.6,325
"Pottawatomie County, KS",KS,2012,11626,11081,545,4.7,4
"Pottawatomie County, KS",KS,2011,11622,11051,571,4.9,-271
"Pottawatomie County, KS",KS,2010,11893,11278,615,5.2,0
"Pottawatomie County, OK",OK,2021,32707,31444,1263,3.9,535
"Pottawatomie County, OK",OK,2020,32172,30179,1993,6.2,-102
"Pottawatomie County, OK",OK,2019,32274,31166,1108,3.4,-199
"Pottawatomie County, OK",OK,2018,32473,31313,1160,3.6,-433
"Pottawatomie County, OK",OK,2017,32906,31619,1287,3.9,-120
"Pottawatomie County, OK",OK,2016,33026,31553,1473,4.5,311
"Pottawatomie County, OK",OK,2015,32715,31279,1436,4.4,614
"Pottawatomie County, OK",OK,2014,32101,30633,1468,4.6,27
"Pottawatomie County, OK",OK,2013,32074,30376,1698,5.3,160
"Pottawatomie County, OK",OK,2012,31914,30271,1643,5.1,648
"Pottawatomie County, OK",OK,2011,31266,29488,1778,5.7,313
"Pottawatomie County, OK",OK,2010,30953,28886,2067,6.7,0
"Pottawattamie County, IA",IA,2021,47038,45036,2002,4.3,-370
"Pottawattamie County, IA",IA,2020,47408,44961,2447,5.2,-1669
"Pottawattamie County, IA",IA,2019,49077,47929,1148,2.3,720
"Pottawattamie County, IA",IA,2018,48357,47222,1135,2.3,346
"Pottawattamie County, IA",IA,2017,48011,46692,1319,2.7,-506
"Pottawattamie County, IA",IA,2016,48517,46887,1630,3.4,-484
"Pottawattamie County, IA",IA,2015,49001,47227,1774,3.6,-192
"Pottawattamie County, IA",IA,2014,49193,47086,2107,4.3,497
"Pottawattamie County, IA",IA,2013,48696,46470,2226,4.6,39
"Pottawattamie County, IA",IA,2012,48657,46186,2471,5.1,-1098
"Pottawattamie County, IA",IA,2011,49755,46925,2830,5.7,-457
"Pottawattamie County, IA",IA,2010,50212,47261,2951,5.9,0
"Potter County, PA",PA,2021,7122,6635,487,6.8,-167
"Potter County, PA",PA,2020,7289,6607,682,9.4,-22
"Potter County, PA",PA,2019,7311,6871,440,6.0,54
"Potter County, PA",PA,2018,7257,6855,402,5.5,-80
"Potter County, PA",PA,2017,7337,6852,485,6.6,-53
"Potter County, PA",PA,2016,7390,6816,574,7.8,10
"Potter County, PA",PA,2015,7380,6852,528,7.2,-182
"Potter County, PA",PA,2014,7562,6998,564,7.5,-154
"Potter County, PA",PA,2013,7716,7022,694,9.0,-193
"Potter County, PA",PA,2012,7909,7204,705,8.9,94
"Potter County, PA",PA,2011,7815,7115,700,9.0,42
"Potter County, PA",PA,2010,7773,6988,785,10.1,0
"Potter County, SD",SD,2021,1050,1018,32,3.0,32
"Potter County, SD",SD,2020,1018,987,31,3.0,-10
"Potter County, SD",SD,2019,1028,1000,28,2.7,-57
"Potter County, SD",SD,2018,1085,1050,35,3.2,-36
"Potter County, SD",SD,2017,1121,1086,35,3.1,-42
"Potter County, SD",SD,2016,1163,1131,32,2.8,-27
"Potter County, SD",SD,2015,1190,1152,38,3.2,-18
"Potter County, SD",SD,2014,1208,1169,39,3.2,-3
"Potter County, SD",SD,2013,1211,1165,46,3.8,-12
"Potter County, SD",SD,2012,1223,1176,47,3.8,-28
"Potter County, SD",SD,2011,1251,1186,65,5.2,-31
"Potter County, SD",SD,2010,1282,1221,61,4.8,0
"Potter County, TX",TX,2021,54259,51926,2333,4.3,1455
"Potter County, TX",TX,2020,52804,49882,2922,5.5,-910
"Potter County, TX",TX,2019,53714,52240,1474,2.7,-652
"Potter County, TX",TX,2018,54366,52762,1604,3.0,-653
"Potter County, TX",TX,2017,55019,53236,1783,3.2,-1158
"Potter County, TX",TX,2016,56177,54294,1883,3.4,-94
"Potter County, TX",TX,2015,56271,54382,1889,3.4,-482
"Potter County, TX",TX,2014,56753,54476,2277,4.0,-665
"Potter County, TX",TX,2013,57418,54506,2912,5.1,-782
"Potter County, TX",TX,2012,58200,55107,3093,5.3,-494
"Potter County, TX",TX,2011,58694,55092,3602,6.1,582
"Potter County, TX",TX,2010,58112,54437,3675,6.3,0
"Powder River County, MT",MT,2021,977,951,26,2.7,11
"Powder River County, MT",MT,2020,966,936,30,3.1,-2
"Powder River County, MT",MT,2019,968,945,23,2.4,-8
"Powder River County, MT",MT,2018,976,948,28,2.9,-36
"Powder River County, MT",MT,2017,1012,986,26,2.6,-54
"Powder River County, MT",MT,2016,1066,1040,26,2.4,10
"Powder River County, MT",MT,2015,1056,1028,28,2.7,-20
"Powder River County, MT",MT,2014,1076,1043,33,3.1,-50
"Powder River County, MT",MT,2013,1126,1089,37,3.3,48
"Powder River County, MT",MT,2012,1078,1039,39,3.6,19
"Powder River County, MT",MT,2011,1059,1011,48,4.5,13
"Powder River County, MT",MT,2010,1046,1007,39,3.7,0
"Powell County, KY",KY,2021,5135,4888,247,4.8,90
"Powell County, KY",KY,2020,5045,4684,361,7.2,2
"Powell County, KY",KY,2019,5043,4788,255,5.1,31
"Powell County, KY",KY,2018,5012,4722,290,5.8,-15
"Powell County, KY",KY,2017,5027,4699,328,6.5,69
"Powell County, KY",KY,2016,4958,4607,351,7.1,101
"Powell County, KY",KY,2015,4857,4516,341,7.0,-116
"Powell County, KY",KY,2014,4973,4553,420,8.4,-83
"Powell County, KY",KY,2013,5056,4517,539,10.7,-17
"Powell County, KY",KY,2012,5073,4516,557,11.0,-91
"Powell County, KY",KY,2011,5164,4499,665,12.9,-157
"Powell County, KY",KY,2010,5321,4487,834,15.7,0
"Powell County, MT",MT,2021,2979,2903,76,2.6,51
"Powell County, MT",MT,2020,2928,2793,135,4.6,-70
"Powell County, MT",MT,2019,2998,2886,112,3.7,56
"Powell County, MT",MT,2018,2942,2819,123,4.2,35
"Powell County, MT",MT,2017,2907,2779,128,4.4,39
"Powell County, MT",MT,2016,2868,2718,150,5.2,-94
"Powell County, MT",MT,2015,2962,2827,135,4.6,25
"Powell County, MT",MT,2014,2937,2790,147,5.0,-11
"Powell County, MT",MT,2013,2948,2786,162,5.5,-66
"Powell County, MT",MT,2012,3014,2825,189,6.3,26
"Powell County, MT",MT,2011,2988,2769,219,7.3,24
"Powell County, MT",MT,2010,2964,2740,224,7.6,0
"Power County, ID",ID,2021,4159,3999,160,3.8,20
"Power County, ID",ID,2020,4139,3968,171,4.1,24
"Power County, ID",ID,2019,4115,3986,129,3.1,10
"Power County, ID",ID,2018,4105,3984,121,2.9,123
"Power County, ID",ID,2017,3982,3847,135,3.4,55
"Power County, ID",ID,2016,3927,3772,155,3.9,50
"Power County, ID",ID,2015,3877,3710,167,4.3,-83
"Power County, ID",ID,2014,3960,3786,174,4.4,-56
"Power County, ID",ID,2013,4016,3723,293,7.3,-90
"Power County, ID",ID,2012,4106,3778,328,8.0,183
"Power County, ID",ID,2011,3923,3585,338,8.6,47
"Power County, ID",ID,2010,3876,3528,348,9.0,0
"Poweshiek County, IA",IA,2021,10031,9586,445,4.4,199
"Poweshiek County, IA",IA,2020,9832,9360,472,4.8,-734
"Poweshiek County, IA",IA,2019,10566,10301,265,2.5,-47
"Poweshiek County, IA",IA,2018,10613,10364,249,2.3,96
"Poweshiek County, IA",IA,2017,10517,10194,323,3.1,39
"Poweshiek County, IA",IA,2016,10478,10122,356,3.4,-32
"Poweshiek County, IA",IA,2015,10510,10134,376,3.6,104
"Poweshiek County, IA",IA,2014,10406,9964,442,4.2,48
"Poweshiek County, IA",IA,2013,10358,9878,480,4.6,159
"Poweshiek County, IA",IA,2012,10199,9700,499,4.9,-243
"Poweshiek County, IA",IA,2011,10442,9850,592,5.7,-101
"Poweshiek County, IA",IA,2010,10543,9922,621,5.9,0
"Powhatan County, VA",VA,2021,13893,13492,401,2.9,-279
"Powhatan County, VA",VA,2020,14172,13491,681,4.8,-345
"Powhatan County, VA",VA,2019,14517,14153,364,2.5,350
"Powhatan County, VA",VA,2018,14167,13792,375,2.6,304
"Powhatan County, VA",VA,2017,13863,13408,455,3.3,207
"Powhatan County, VA",VA,2016,13656,13180,476,3.5,214
"Powhatan County, VA",VA,2015,13442,12915,527,3.9,-269
"Powhatan County, VA",VA,2014,13711,13101,610,4.4,144
"Powhatan County, VA",VA,2013,13567,12894,673,5.0,27
"Powhatan County, VA",VA,2012,13540,12791,749,5.5,7
"Powhatan County, VA",VA,2011,13533,12691,842,6.2,4
"Powhatan County, VA",VA,2010,13529,12550,979,7.2,0
"Prairie County, AR",AR,2021,3527,3397,130,3.7,-84
"Prairie County, AR",AR,2020,3611,3417,194,5.4,0
"Prairie County, AR",AR,2019,3611,3459,152,4.2,56
"Prairie County, AR",AR,2018,3555,3420,135,3.8,-141
"Prairie County, AR",AR,2017,3696,3544,152,4.1,40
"Prairie County, AR",AR,2016,3656,3516,140,3.8,-88
"Prairie County, AR",AR,2015,3744,3571,173,4.6,-97
"Prairie County, AR",AR,2014,3841,3624,217,5.6,14
"Prairie County, AR",AR,2013,3827,3564,263,6.9,-15
"Prairie County, AR",AR,2012,3842,3563,279,7.3,-74
"Prairie County, AR",AR,2011,3916,3591,325,8.3,-48
"Prairie County, AR",AR,2010,3964,3613,351,8.9,0
"Prairie County, MT",MT,2021,494,476,18,3.6,23
"Prairie County, MT",MT,2020,471,440,31,6.6,-9
"Prairie County, MT",MT,2019,480,462,18,3.8,-11
"Prairie County, MT",MT,2018,491,473,18,3.7,2
"Prairie County, MT",MT,2017,489,471,18,3.7,-37
"Prairie County, MT",MT,2016,526,508,18,3.4,-3
"Prairie County, MT",MT,2015,529,507,22,4.2,15
"Prairie County, MT",MT,2014,514,492,22,4.3,-7
"Prairie County, MT",MT,2013,521,498,23,4.4,-8
"Prairie County, MT",MT,2012,529,507,22,4.2,-2
"Prairie County, MT",MT,2011,531,504,27,5.1,-36
"Prairie County, MT",MT,2010,567,539,28,4.9,0
"Pratt County, KS",KS,2021,4913,4803,110,2.2,-8
"Pratt County, KS",KS,2020,4921,4751,170,3.5,-7
"Pratt County, KS",KS,2019,4928,4805,123,2.5,-44
"Pratt County, KS",KS,2018,4972,4840,132,2.7,0
"Pratt County, KS",KS,2017,4972,4811,161,3.2,-156
"Pratt County, KS",KS,2016,5128,4920,208,4.1,-177
"Pratt County, KS",KS,2015,5305,5091,214,4.0,-203
"Pratt County, KS",KS,2014,5508,5331,177,3.2,57
"Pratt County, KS",KS,2013,5451,5235,216,4.0,-6
"Pratt County, KS",KS,2012,5457,5212,245,4.5,67
"Pratt County, KS",KS,2011,5390,5121,269,5.0,100
"Pratt County, KS",KS,2010,5290,4998,292,5.5,0
"Preble County, OH",OH,2021,21552,20677,875,4.1,538
"Preble County, OH",OH,2020,21014,19589,1425,6.8,-316
"Preble County, OH",OH,2019,21330,20521,809,3.8,58
"Preble County, OH",OH,2018,21272,20408,864,4.1,-34
"Preble County, OH",OH,2017,21306,20358,948,4.4,203
"Preble County, OH",OH,2016,21103,20090,1013,4.8,49
"Preble County, OH",OH,2015,21054,20028,1026,4.9,-135
"Preble County, OH",OH,2014,21189,19981,1208,5.7,-103
"Preble County, OH",OH,2013,21292,19690,1602,7.5,-192
"Preble County, OH",OH,2012,21484,19824,1660,7.7,-181
"Preble County, OH",OH,2011,21665,19596,2069,9.5,-750
"Preble County, OH",OH,2010,22415,19941,2474,11.0,0
"Prentiss County, MS",MS,2021,11272,10777,495,4.4,234
"Prentiss County, MS",MS,2020,11038,10290,748,6.8,-327
"Prentiss County, MS",MS,2019,11365,10812,553,4.9,139
"Prentiss County, MS",MS,2018,11226,10729,497,4.4,47
"Prentiss County, MS",MS,2017,11179,10656,523,4.7,168
"Prentiss County, MS",MS,2016,11011,10398,613,5.6,51
"Prentiss County, MS",MS,2015,10960,10287,673,6.1,138
"Prentiss County, MS",MS,2014,10822,10004,818,7.6,-130
"Prentiss County, MS",MS,2013,10952,10032,920,8.4,-591
"Prentiss County, MS",MS,2012,11543,10568,975,8.4,-215
"Prentiss County, MS",MS,2011,11758,10562,1196,10.2,137
"Prentiss County, MS",MS,2010,11621,10288,1333,11.5,0
"Presidio County, TX",TX,2021,3101,2774,327,10.5,-74
"Presidio County, TX",TX,2020,3175,2704,471,14.8,100
"Presidio County, TX",TX,2019,3075,2877,198,6.4,63
"Presidio County, TX",TX,2018,3012,2802,210,7.0,-8
"Presidio County, TX",TX,2017,3020,2733,287,9.5,-61
"Presidio County, TX",TX,2016,3081,2751,330,10.7,-37
"Presidio County, TX",TX,2015,3118,2784,334,10.7,-292
"Presidio County, TX",TX,2014,3410,3008,402,11.8,-341
"Presidio County, TX",TX,2013,3751,3265,486,13.0,-65
"Presidio County, TX",TX,2012,3816,3312,504,13.2,27
"Presidio County, TX",TX,2011,3789,3197,592,15.6,39
"Presidio County, TX",TX,2010,3750,3055,695,18.5,0
"Presque Isle County, MI",MI,2021,4796,4417,379,7.9,-143
"Presque Isle County, MI",MI,2020,4939,4364,575,11.6,-13
"Presque Isle County, MI",MI,2019,4952,4573,379,7.7,-94
"Presque Isle County, MI",MI,2018,5046,4641,405,8.0,-125
"Presque Isle County, MI",MI,2017,5171,4698,473,9.1,-133
"Presque Isle County, MI",MI,2016,5304,4792,512,9.7,-83
"Presque Isle County, MI",MI,2015,5387,4831,556,10.3,-73
"Presque Isle County, MI",MI,2014,5460,4761,699,12.8,-18
"Presque Isle County, MI",MI,2013,5478,4679,799,14.6,-76
"Presque Isle County, MI",MI,2012,5554,4758,796,14.3,12
"Presque Isle County, MI",MI,2011,5542,4684,858,15.5,-146
"Presque Isle County, MI",MI,2010,5688,4724,964,16.9,0
"Preston County, WV",WV,2021,15649,14943,706,4.5,415
"Preston County, WV",WV,2020,15234,14140,1094,7.2,-331
"Preston County, WV",WV,2019,15565,14849,716,4.6,79
"Preston County, WV",WV,2018,15486,14686,800,5.2,179
"Preston County, WV",WV,2017,15307,14549,758,5.0,407
"Preston County, WV",WV,2016,14900,14044,856,5.7,89
"Preston County, WV",WV,2015,14811,13909,902,6.1,200
"Preston County, WV",WV,2014,14611,13747,864,5.9,-38
"Preston County, WV",WV,2013,14649,13702,947,6.5,-135
"Preston County, WV",WV,2012,14784,13776,1008,6.8,154
"Preston County, WV",WV,2011,14630,13544,1086,7.4,-287
"Preston County, WV",WV,2010,14917,13668,1249,8.4,0
"Price County, WI",WI,2021,6341,6075,266,4.2,52
"Price County, WI",WI,2020,6289,5860,429,6.8,-191
"Price County, WI",WI,2019,6480,6208,272,4.2,-175
"Price County, WI",WI,2018,6655,6410,245,3.7,-159
"Price County, WI",WI,2017,6814,6561,253,3.7,-50
"Price County, WI",WI,2016,6864,6576,288,4.2,30
"Price County, WI",WI,2015,6834,6537,297,4.3,64
"Price County, WI",WI,2014,6770,6410,360,5.3,-83
"Price County, WI",WI,2013,6853,6384,469,6.8,-187
"Price County, WI",WI,2012,7040,6519,521,7.4,-168
"Price County, WI",WI,2011,7208,6579,629,8.7,-356
"Price County, WI",WI,2010,7564,6751,813,10.7,0
"Prince Edward County, VA",VA,2021,9976,9498,478,4.8,-168
"Prince Edward County, VA",VA,2020,10144,9494,650,6.4,-415
"Prince Edward County, VA",VA,2019,10559,10167,392,3.7,56
"Prince Edward County, VA",VA,2018,10503,10105,398,3.8,167
"Prince Edward County, VA",VA,2017,10336,9841,495,4.8,170
"Prince Edward County, VA",VA,2016,10166,9632,534,5.3,70
"Prince Edward County, VA",VA,2015,10096,9473,623,6.2,41
"Prince Edward County, VA",VA,2014,10055,9300,755,7.5,70
"Prince Edward County, VA",VA,2013,9985,9166,819,8.2,-278
"Prince Edward County, VA",VA,2012,10263,9408,855,8.3,-105
"Prince Edward County, VA",VA,2011,10368,9437,931,9.0,70
"Prince Edward County, VA",VA,2010,10298,9280,1018,9.9,0
"Prince George County, VA",VA,2021,14660,13998,662,4.5,-321
"Prince George County, VA",VA,2020,14981,14016,965,6.4,-368
"Prince George County, VA",VA,2019,15349,14840,509,3.3,215
"Prince George County, VA",VA,2018,15134,14590,544,3.6,71
"Prince George County, VA",VA,2017,15063,14398,665,4.4,114
"Prince George County, VA",VA,2016,14949,14234,715,4.8,21
"Prince George County, VA",VA,2015,14928,14133,795,5.3,116
"Prince George County, VA",VA,2014,14812,13894,918,6.2,72
"Prince George County, VA",VA,2013,14740,13733,1007,6.8,102
"Prince George County, VA",VA,2012,14638,13574,1064,7.3,131
"Prince George County, VA",VA,2011,14507,13378,1129,7.8,522
"Prince George County, VA",VA,2010,13985,12832,1153,8.2,0
"Prince George's County, MD",MD,2021,502972,465458,37514,7.5,-9525
"Prince George's County, MD",MD,2020,512497,471489,41008,8.0,-10180
"Prince George's County, MD",MD,2019,522677,503782,18895,3.6,9334
"Prince George's County, MD",MD,2018,513343,493920,19423,3.8,-649
"Prince George's County, MD",MD,2017,513992,493342,20650,4.0,14132
"Prince George's County, MD",MD,2016,499860,478398,21462,4.3,13542
"Prince George's County, MD",MD,2015,486318,461301,25017,5.1,162
"Prince George's County, MD",MD,2014,486156,457128,29028,6.0,215
"Prince George's County, MD",MD,2013,485941,452620,33321,6.9,726
"Prince George's County, MD",MD,2012,485215,450330,34885,7.2,2121
"Prince George's County, MD",MD,2011,483094,446690,36404,7.5,2704
"Prince George's County, MD",MD,2010,480390,443412,36978,7.7,0
"Prince of Wales-Hyder Census Area, AK",AK,2021,2832,2605,227,8.0,-1
"Prince of Wales-Hyder Census Area, AK",AK,2020,2833,2558,275,9.7,-51
"Prince of Wales-Hyder Census Area, AK",AK,2019,2884,2622,262,9.1,-1
"Prince of Wales-Hyder Census Area, AK",AK,2018,2885,2601,284,9.8,42
"Prince of Wales-Hyder Census Area, AK",AK,2017,2843,2547,296,10.4,83
"Prince of Wales-Hyder Census Area, AK",AK,2016,2760,2437,323,11.7,10
"Prince of Wales-Hyder Census Area, AK",AK,2015,2750,2415,335,12.2,-75
"Prince of Wales-Hyder Census Area, AK",AK,2014,2825,2453,372,13.2,26
"Prince of Wales-Hyder Census Area, AK",AK,2013,2799,2456,343,12.3,216
"Prince of Wales-Hyder Census Area, AK",AK,2012,2583,2236,347,13.4,18
"Prince of Wales-Hyder Census Area, AK",AK,2011,2565,2241,324,12.6,21
"Prince of Wales-Hyder Census Area, AK",AK,2010,2544,2267,277,10.9,0
"Prince William County, VA",VA,2021,241803,232243,9560,4.0,-5875
"Prince William County, VA",VA,2020,247678,231644,16034,6.5,-2859
"Prince William County, VA",VA,2019,250537,244236,6301,2.5,5614
"Prince William County, VA",VA,2018,244923,238264,6659,2.7,3324
"Prince William County, VA",VA,2017,241599,233452,8147,3.4,6314
"Prince William County, VA",VA,2016,235285,226848,8437,3.6,2989
"Prince William County, VA",VA,2015,232296,222831,9465,4.1,-343
"Prince William County, VA",VA,2014,232639,221468,11171,4.8,1441
"Prince William County, VA",VA,2013,231198,219435,11763,5.1,2673
"Prince William County, VA",VA,2012,228525,216702,11823,5.2,3677
"Prince William County, VA",VA,2011,224848,212158,12690,5.6,6204
"Prince William County, VA",VA,2010,218644,204995,13649,6.2,0
"Providence County, RI",RI,2021,335620,315326,20294,6.0,988
"Providence County, RI",RI,2020,334632,301230,33402,10.0,-1498
"Providence County, RI",RI,2019,336130,323216,12914,3.8,1524
"Providence County, RI",RI,2018,334606,319949,14657,4.4,1849
"Providence County, RI",RI,2017,332757,316683,16074,4.8,9561
"Providence County, RI",RI,2016,323196,305286,17910,5.5,-1188
"Providence County, RI",RI,2015,324384,303657,20727,6.4,-638
"Providence County, RI",RI,2014,325022,298306,26716,8.2,-680
"Providence County, RI",RI,2013,325702,293165,32537,10.0,-1053
"Providence County, RI",RI,2012,326755,291552,35203,10.8,-548
"Providence County, RI",RI,2011,327303,289337,37966,11.6,-4457
"Providence County, RI",RI,2010,331760,291192,40568,12.2,0
"Prowers County, CO",CO,2021,6265,5981,284,4.5,151
"Prowers County, CO",CO,2020,6114,5856,258,4.2,-168
"Prowers County, CO",CO,2019,6282,6128,154,2.5,57
"Prowers County, CO",CO,2018,6225,6034,191,3.1,82
"Prowers County, CO",CO,2017,6143,5994,149,2.4,137
"Prowers County, CO",CO,2016,6006,5820,186,3.1,194
"Prowers County, CO",CO,2015,5812,5586,226,3.9,88
"Prowers County, CO",CO,2014,5724,5457,267,4.7,-132
"Prowers County, CO",CO,2013,5856,5493,363,6.2,-225
"Prowers County, CO",CO,2012,6081,5649,432,7.1,-147
"Prowers County, CO",CO,2011,6228,5797,431,6.9,85
"Prowers County, CO",CO,2010,6143,5691,452,7.4,0
"Pueblo County, CO",CO,2021,77498,71347,6151,7.9,1343
"Pueblo County, CO",CO,2020,76155,70230,5925,7.8,994
"Pueblo County, CO",CO,2019,75161,72263,2898,3.9,425
"Pueblo County, CO",CO,2018,74736,71382,3354,4.5,712
"Pueblo County, CO",CO,2017,74024,71082,2942,4.0,966
"Pueblo County, CO",CO,2016,73058,69714,3344,4.6,1401
"Pueblo County, CO",CO,2015,71657,67755,3902,5.4,-616
"Pueblo County, CO",CO,2014,72273,67010,5263,7.3,-997
"Pueblo County, CO",CO,2013,73270,66166,7104,9.7,-1031
"Pueblo County, CO",CO,2012,74301,66256,8045,10.8,-745
"Pueblo County, CO",CO,2011,75046,66842,8204,10.9,807
"Pueblo County, CO",CO,2010,74239,66147,8092,10.9,0
"Pulaski County, AR",AR,2021,184896,175806,9090,4.9,-4154
"Pulaski County, AR",AR,2020,189050,174991,14059,7.4,-649
"Pulaski County, AR",AR,2019,189699,183378,6321,3.3,1288
"Pulaski County, AR",AR,2018,188411,181973,6438,3.4,-25
"Pulaski County, AR",AR,2017,188436,181973,6463,3.4,1017
"Pulaski County, AR",AR,2016,187419,180752,6667,3.6,582
"Pulaski County, AR",AR,2015,186837,178413,8424,4.5,852
"Pulaski County, AR",AR,2014,185985,175968,10017,5.4,-1853
"Pulaski County, AR",AR,2013,187838,175881,11957,6.4,-1472
"Pulaski County, AR",AR,2012,189310,176846,12464,6.6,124
"Pulaski County, AR",AR,2011,189186,175745,13441,7.1,26
"Pulaski County, AR",AR,2010,189160,175899,13261,7.0,0
"Pulaski County, GA",GA,2021,4048,3902,146,3.6,95
"Pulaski County, GA",GA,2020,3953,3767,186,4.7,-117
"Pulaski County, GA",GA,2019,4070,3906,164,4.0,21
"Pulaski County, GA",GA,2018,4049,3870,179,4.4,-84
"Pulaski County, GA",GA,2017,4133,3914,219,5.3,94
"Pulaski County, GA",GA,2016,4039,3799,240,5.9,71
"Pulaski County, GA",GA,2015,3968,3702,266,6.7,-88
"Pulaski County, GA",GA,2014,4056,3738,318,7.8,-137
"Pulaski County, GA",GA,2013,4193,3823,370,8.8,-174
"Pulaski County, GA",GA,2012,4367,3979,388,8.9,-113
"Pulaski County, GA",GA,2011,4480,4051,429,9.6,-61
"Pulaski County, GA",GA,2010,4541,4117,424,9.3,0
"Pulaski County, IL",IL,2021,1702,1544,158,9.3,-55
"Pulaski County, IL",IL,2020,1757,1549,208,11.8,-196
"Pulaski County, IL",IL,2019,1953,1829,124,6.3,-124
"Pulaski County, IL",IL,2018,2077,1911,166,8.0,-50
"Pulaski County, IL",IL,2017,2127,1958,169,7.9,-76
"Pulaski County, IL",IL,2016,2203,2017,186,8.4,110
"Pulaski County, IL",IL,2015,2093,1907,186,8.9,-45
"Pulaski County, IL",IL,2014,2138,1914,224,10.5,-78
"Pulaski County, IL",IL,2013,2216,1939,277,12.5,-151
"Pulaski County, IL",IL,2012,2367,2096,271,11.4,10
"Pulaski County, IL",IL,2011,2357,2075,282,12.0,-120
"Pulaski County, IL",IL,2010,2477,2166,311,12.6,0
"Pulaski County, IN",IN,2021,6276,6091,185,2.9,-125
"Pulaski County, IN",IN,2020,6401,6009,392,6.1,-165
"Pulaski County, IN",IN,2019,6566,6369,197,3.0,51
"Pulaski County, IN",IN,2018,6515,6316,199,3.1,135
"Pulaski County, IN",IN,2017,6380,6161,219,3.4,-6
"Pulaski County, IN",IN,2016,6386,6104,282,4.4,113
"Pulaski County, IN",IN,2015,6273,5991,282,4.5,76
"Pulaski County, IN",IN,2014,6197,5864,333,5.4,70
"Pulaski County, IN",IN,2013,6127,5705,422,6.9,-150
"Pulaski County, IN",IN,2012,6277,5821,456,7.3,-140
"Pulaski County, IN",IN,2011,6417,5909,508,7.9,44
"Pulaski County, IN",IN,2010,6373,5755,618,9.7,0
"Pulaski County, KY",KY,2021,25971,24692,1279,4.9,248
"Pulaski County, KY",KY,2020,25723,23893,1830,7.1,-954
"Pulaski County, KY",KY,2019,26677,25487,1190,4.5,682
"Pulaski County, KY",KY,2018,25995,24724,1271,4.9,602
"Pulaski County, KY",KY,2017,25393,23990,1403,5.5,5
"Pulaski County, KY",KY,2016,25388,24021,1367,5.4,-56
"Pulaski County, KY",KY,2015,25444,23956,1488,5.8,-846
"Pulaski County, KY",KY,2014,26290,24365,1925,7.3,-956
"Pulaski County, KY",KY,2013,27246,24766,2480,9.1,-76
"Pulaski County, KY",KY,2012,27322,24724,2598,9.5,-275
"Pulaski County, KY",KY,2011,27597,24661,2936,10.6,-324
"Pulaski County, KY",KY,2010,27921,24934,2987,10.7,0
"Pulaski County, MO",MO,2021,14585,13938,647,4.4,61
"Pulaski County, MO",MO,2020,14524,13708,816,5.6,-80
"Pulaski County, MO",MO,2019,14604,14039,565,3.9,19
"Pulaski County, MO",MO,2018,14585,14067,518,3.6,-110
"Pulaski County, MO",MO,2017,14695,14070,625,4.3,234
"Pulaski County, MO",MO,2016,14461,13678,783,5.4,-342
"Pulaski County, MO",MO,2015,14803,13921,882,6.0,-367
"Pulaski County, MO",MO,2014,15170,14064,1106,7.3,-411
"Pulaski County, MO",MO,2013,15581,14333,1248,8.0,-200
"Pulaski County, MO",MO,2012,15781,14455,1326,8.4,-811
"Pulaski County, MO",MO,2011,16592,15121,1471,8.9,-44
"Pulaski County, MO",MO,2010,16636,15186,1450,8.7,0
"Pulaski County, VA",VA,2021,15938,15308,630,4.0,-270
"Pulaski County, VA",VA,2020,16208,14938,1270,7.8,-217
"Pulaski County, VA",VA,2019,16425,15874,551,3.4,294
"Pulaski County, VA",VA,2018,16131,15579,552,3.4,-224
"Pulaski County, VA",VA,2017,16355,15492,863,5.3,70
"Pulaski County, VA",VA,2016,16285,15331,954,5.9,-88
"Pulaski County, VA",VA,2015,16373,15556,817,5.0,-138
"Pulaski County, VA",VA,2014,16511,15523,988,6.0,-342
"Pulaski County, VA",VA,2013,16853,15605,1248,7.4,-4
"Pulaski County, VA",VA,2012,16857,15628,1229,7.3,2
"Pulaski County, VA",VA,2011,16855,15392,1463,8.7,-156
"Pulaski County, VA",VA,2010,17011,15083,1928,11.3,0
"Pushmataha County, OK",OK,2021,4708,4508,200,4.2,265
"Pushmataha County, OK",OK,2020,4443,4143,300,6.8,180
"Pushmataha County, OK",OK,2019,4263,4063,200,4.7,-216
"Pushmataha County, OK",OK,2018,4479,4255,224,5.0,-231
"Pushmataha County, OK",OK,2017,4710,4433,277,5.9,-156
"Pushmataha County, OK",OK,2016,4866,4523,343,7.0,-40
"Pushmataha County, OK",OK,2015,4906,4533,373,7.6,217
"Pushmataha County, OK",OK,2014,4689,4350,339,7.2,-11
"Pushmataha County, OK",OK,2013,4700,4293,407,8.7,-141
"Pushmataha County, OK",OK,2012,4841,4500,341,7.0,-91
"Pushmataha County, OK",OK,2011,4932,4523,409,8.3,-40
"Pushmataha County, OK",OK,2010,4972,4502,470,9.5,0
"Putnam County, FL",FL,2021,27149,25501,1648,6.1,751
"Putnam County, FL",FL,2020,26398,24111,2287,8.7,53
"Putnam County, FL",FL,2019,26345,25178,1167,4.4,-207
"Putnam County, FL",FL,2018,26552,25220,1332,5.0,-272
"Putnam County, FL",FL,2017,26824,25340,1484,5.5,-247
"Putnam County, FL",FL,2016,27071,25332,1739,6.4,-305
"Putnam County, FL",FL,2015,27376,25266,2110,7.7,-546
"Putnam County, FL",FL,2014,27922,25416,2506,9.0,-257
"Putnam County, FL",FL,2013,28179,25124,3055,10.8,-596
"Putnam County, FL",FL,2012,28775,25274,3501,12.2,-828
"Putnam County, FL",FL,2011,29603,25822,3781,12.8,-632
"Putnam County, FL",FL,2010,30235,26307,3928,13.0,0
"Putnam County, GA",GA,2021,8661,8314,347,4.0,372
"Putnam County, GA",GA,2020,8289,7756,533,6.4,-45
"Putnam County, GA",GA,2019,8334,7958,376,4.5,56
"Putnam County, GA",GA,2018,8278,7861,417,5.0,25
"Putnam County, GA",GA,2017,8253,7772,481,5.8,298
"Putnam County, GA",GA,2016,7955,7388,567,7.1,239
"Putnam County, GA",GA,2015,7716,7082,634,8.2,-363
"Putnam County, GA",GA,2014,8079,7345,734,9.1,-53
"Putnam County, GA",GA,2013,8132,7298,834,10.3,-127
"Putnam County, GA",GA,2012,8259,7321,938,11.4,-391
"Putnam County, GA",GA,2011,8650,7533,1117,12.9,-432
"Putnam County, GA",GA,2010,9082,7893,1189,13.1,0
"Putnam County, IL",IL,2021,2956,2808,148,5.0,18
"Putnam County, IL",IL,2020,2938,2689,249,8.5,-103
"Putnam County, IL",IL,2019,3041,2893,148,4.9,-7
"Putnam County, IL",IL,2018,3048,2888,160,5.2,41
"Putnam County, IL",IL,2017,3007,2858,149,5.0,-114
"Putnam County, IL",IL,2016,3121,2945,176,5.6,75
"Putnam County, IL",IL,2015,3046,2858,188,6.2,13
"Putnam County, IL",IL,2014,3033,2799,234,7.7,-19
"Putnam County, IL",IL,2013,3052,2750,302,9.9,-71
"Putnam County, IL",IL,2012,3123,2830,293,9.4,-76
"Putnam County, IL",IL,2011,3199,2869,330,10.3,-105
"Putnam County, IL",IL,2010,3304,2905,399,12.1,0
"Putnam County, IN",IN,2021,16353,15854,499,3.1,165
"Putnam County, IN",IN,2020,16188,15155,1033,6.4,-518
"Putnam County, IN",IN,2019,16706,16136,570,3.4,-82
"Putnam County, IN",IN,2018,16788,16160,628,3.7,192
"Putnam County, IN",IN,2017,16596,15998,598,3.6,-23
"Putnam County, IN",IN,2016,16619,15880,739,4.4,221
"Putnam County, IN",IN,2015,16398,15566,832,5.1,123
"Putnam County, IN",IN,2014,16275,15199,1076,6.6,92
"Putnam County, IN",IN,2013,16183,14808,1375,8.5,-165
"Putnam County, IN",IN,2012,16348,14753,1595,9.8,-278
"Putnam County, IN",IN,2011,16626,14863,1763,10.6,-47
"Putnam County, IN",IN,2010,16673,14780,1893,11.4,0
"Putnam County, MO",MO,2021,2233,2163,70,3.1,-33
"Putnam County, MO",MO,2020,2266,2167,99,4.4,5
"Putnam County, MO",MO,2019,2261,2184,77,3.4,-156
"Putnam County, MO",MO,2018,2417,2335,82,3.4,-27
"Putnam County, MO",MO,2017,2444,2352,92,3.8,-8
"Putnam County, MO",MO,2016,2452,2340,112,4.6,-33
"Putnam County, MO",MO,2015,2485,2384,101,4.1,2
"Putnam County, MO",MO,2014,2483,2357,126,5.1,40
"Putnam County, MO",MO,2013,2443,2297,146,6.0,107
"Putnam County, MO",MO,2012,2336,2192,144,6.2,-25
"Putnam County, MO",MO,2011,2361,2196,165,7.0,-17
"Putnam County, MO",MO,2010,2378,2188,190,8.0,0
"Putnam County, NY",NY,2021,50366,48268,2098,4.2,-838
"Putnam County, NY",NY,2020,51204,47520,3684,7.2,-1108
"Putnam County, NY",NY,2019,52312,50452,1860,3.6,140
"Putnam County, NY",NY,2018,52172,50259,1913,3.7,365
"Putnam County, NY",NY,2017,51807,49642,2165,4.2,1107
"Putnam County, NY",NY,2016,50700,48646,2054,4.1,175
"Putnam County, NY",NY,2015,50525,48354,2171,4.3,326
"Putnam County, NY",NY,2014,50199,47713,2486,5.0,-1101
"Putnam County, NY",NY,2013,51300,48099,3201,6.2,-225
"Putnam County, NY",NY,2012,51525,47769,3756,7.3,-157
"Putnam County, NY",NY,2011,51682,48016,3666,7.1,-951
"Putnam County, NY",NY,2010,52633,48765,3868,7.3,0
"Putnam County, OH",OH,2021,18877,18240,637,3.4,347
"Putnam County, OH",OH,2020,18530,17493,1037,5.6,-450
"Putnam County, OH",OH,2019,18980,18387,593,3.1,224
"Putnam County, OH",OH,2018,18756,18130,626,3.3,-235
"Putnam County, OH",OH,2017,18991,18319,672,3.5,16
"Putnam County, OH",OH,2016,18975,18275,700,3.7,251
"Putnam County, OH",OH,2015,18724,17990,734,3.9,28
"Putnam County, OH",OH,2014,18696,17847,849,4.5,-108
"Putnam County, OH",OH,2013,18804,17676,1128,6.0,4
"Putnam County, OH",OH,2012,18800,17710,1090,5.8,-398
"Putnam County, OH",OH,2011,19198,17772,1426,7.4,-164
"Putnam County, OH",OH,2010,19362,17552,1810,9.3,0
"Putnam County, TN",TN,2021,35527,34214,1313,3.7,434
"Putnam County, TN",TN,2020,35093,32839,2254,6.4,-150
"Putnam County, TN",TN,2019,35243,34004,1239,3.5,754
"Putnam County, TN",TN,2018,34489,33257,1232,3.6,466
"Putnam County, TN",TN,2017,34023,32725,1298,3.8,741
"Putnam County, TN",TN,2016,33282,31644,1638,4.9,765
"Putnam County, TN",TN,2015,32517,30633,1884,5.8,395
"Putnam County, TN",TN,2014,32122,29904,2218,6.9,-461
"Putnam County, TN",TN,2013,32583,29982,2601,8.0,-296
"Putnam County, TN",TN,2012,32879,30192,2687,8.2,-1422
"Putnam County, TN",TN,2011,34301,31202,3099,9.0,264
"Putnam County, TN",TN,2010,34037,30785,3252,9.6,0
"Putnam County, WV",WV,2021,26881,25751,1130,4.2,40
"Putnam County, WV",WV,2020,26841,24901,1940,7.2,-104
"Putnam County, WV",WV,2019,26945,25768,1177,4.4,307
"Putnam County, WV",WV,2018,26638,25347,1291,4.8,242
"Putnam County, WV",WV,2017,26396,25153,1243,4.7,537
"Putnam County, WV",WV,2016,25859,24594,1265,4.9,17
"Putnam County, WV",WV,2015,25842,24430,1412,5.5,-309
"Putnam County, WV",WV,2014,26151,24725,1426,5.5,158
"Putnam County, WV",WV,2013,25993,24532,1461,5.6,-394
"Putnam County, WV",WV,2012,26387,24751,1636,6.2,102
"Putnam County, WV",WV,2011,26285,24411,1874,7.1,-71
"Putnam County, WV",WV,2010,26356,24356,2000,7.6,0
"Quay County, NM",NM,2021,2956,2747,209,7.1,-79
"Quay County, NM",NM,2020,3035,2816,219,7.2,-213
"Quay County, NM",NM,2019,3248,3076,172,5.3,6
"Quay County, NM",NM,2018,3242,3088,154,4.8,-47
"Quay County, NM",NM,2017,3289,3089,200,6.1,54
"Quay County, NM",NM,2016,3235,3013,222,6.9,-58
"Quay County, NM",NM,2015,3293,3056,237,7.2,-30
"Quay County, NM",NM,2014,3323,3106,217,6.5,-3
"Quay County, NM",NM,2013,3326,3085,241,7.2,-67
"Quay County, NM",NM,2012,3393,3123,270,8.0,22
"Quay County, NM",NM,2011,3371,3058,313,9.3,-99
"Quay County, NM",NM,2010,3470,3157,313,9.0,0
"Quebradillas Municipio, PR",PR,2021,6487,5894,593,9.1,
"Quebradillas Municipio, PR",PR,2020,N.A.,N.A.,N.A.,N.A.,
"Quebradillas Municipio, PR",PR,2019,6090,5381,709,11.6,92
"Quebradillas Municipio, PR",PR,2018,5998,5171,827,13.8,-64
"Quebradillas Municipio, PR",PR,2017,6062,5105,957,15.8,-17
"Quebradillas Municipio, PR",PR,2016,6079,5109,970,16.0,41
"Quebradillas Municipio, PR",PR,2015,6038,5025,1013,16.8,-88
"Quebradillas Municipio, PR",PR,2014,6126,4996,1130,18.4,-240
"Quebradillas Municipio, PR",PR,2013,6366,5160,1206,18.9,-6
"Quebradillas Municipio, PR",PR,2012,6372,5194,1178,18.5,-176
"Quebradillas Municipio, PR",PR,2011,6548,5273,1275,19.5,-292
"Quebradillas Municipio, PR",PR,2010,6840,5499,1341,19.6,0
"Queen Anne's County, MD",MD,2021,27745,26534,1211,4.4,-362
"Queen Anne's County, MD",MD,2020,28107,26578,1529,5.4,-670
"Queen Anne's County, MD",MD,2019,28777,27923,854,3.0,533
"Queen Anne's County, MD",MD,2018,28244,27369,875,3.1,510
"Queen Anne's County, MD",MD,2017,27734,26759,975,3.5,1167
"Queen Anne's County, MD",MD,2016,26567,25564,1003,3.8,-45
"Queen Anne's County, MD",MD,2015,26612,25434,1178,4.4,248
"Queen Anne's County, MD",MD,2014,26364,25040,1324,5.0,-101
"Queen Anne's County, MD",MD,2013,26465,24932,1533,5.8,-281
"Queen Anne's County, MD",MD,2012,26746,25078,1668,6.2,130
"Queen Anne's County, MD",MD,2011,26616,24790,1826,6.9,435
"Queen Anne's County, MD",MD,2010,26181,24220,1961,7.5,0
"Queens County, NY",NY,2021,1127854,1019350,108504,9.6,-23112
"Queens County, NY",NY,2020,1150966,1005557,145409,12.6,-48298
"Queens County, NY",NY,2019,1199264,1158834,40430,3.4,297
"Queens County, NY",NY,2018,1198967,1156122,42845,3.6,-13350
"Queens County, NY",NY,2017,1212317,1164592,47725,3.9,61566
"Queens County, NY",NY,2016,1150751,1099048,51703,4.5,-1391
"Queens County, NY",NY,2015,1152142,1095485,56657,4.9,2871
"Queens County, NY",NY,2014,1149271,1077982,71289,6.2,11488
"Queens County, NY",NY,2013,1137783,1049995,87788,7.7,14144
"Queens County, NY",NY,2012,1123639,1029794,93845,8.4,11359
"Queens County, NY",NY,2011,1112280,1021978,90302,8.1,-2550
"Queens County, NY",NY,2010,1114830,1018207,96623,8.7,0
"Quitman County, GA",GA,2021,768,730,38,4.9,-27
"Quitman County, GA",GA,2020,795,745,50,6.3,-18
"Quitman County, GA",GA,2019,813,770,43,5.3,-15
"Quitman County, GA",GA,2018,828,781,47,5.7,-13
"Quitman County, GA",GA,2017,841,791,50,5.9,26
"Quitman County, GA",GA,2016,815,755,60,7.4,8
"Quitman County, GA",GA,2015,807,751,56,6.9,-83
"Quitman County, GA",GA,2014,890,815,75,8.4,-11
"Quitman County, GA",GA,2013,901,828,73,8.1,-39
"Quitman County, GA",GA,2012,940,852,88,9.4,-37
"Quitman County, GA",GA,2011,977,878,99,10.1,-32
"Quitman County, GA",GA,2010,1009,906,103,10.2,0
"Quitman County, MS",MS,2021,2335,2137,198,8.5,6
"Quitman County, MS",MS,2020,2329,2082,247,10.6,2
"Quitman County, MS",MS,2019,2327,2136,191,8.2,-29
"Quitman County, MS",MS,2018,2356,2170,186,7.9,-70
"Quitman County, MS",MS,2017,2426,2204,222,9.2,-181
"Quitman County, MS",MS,2016,2607,2348,259,9.9,-74
"Quitman County, MS",MS,2015,2681,2389,292,10.9,-63
"Quitman County, MS",MS,2014,2744,2382,362,13.2,-114
"Quitman County, MS",MS,2013,2858,2436,422,14.8,-141
"Quitman County, MS",MS,2012,2999,2589,410,13.7,-127
"Quitman County, MS",MS,2011,3126,2671,455,14.6,-72
"Quitman County, MS",MS,2010,3198,2735,463,14.5,0
"Rabun County, GA",GA,2021,7528,7292,236,3.1,293
"Rabun County, GA",GA,2020,7235,6854,381,5.3,-91
"Rabun County, GA",GA,2019,7326,7058,268,3.7,190
"Rabun County, GA",GA,2018,7136,6847,289,4.0,163
"Rabun County, GA",GA,2017,6973,6627,346,5.0,273
"Rabun County, GA",GA,2016,6700,6299,401,6.0,270
"Rabun County, GA",GA,2015,6430,5991,439,6.8,-110
"Rabun County, GA",GA,2014,6540,6003,537,8.2,-273
"Rabun County, GA",GA,2013,6813,6142,671,9.8,-99
"Rabun County, GA",GA,2012,6912,6131,781,11.3,-106
"Rabun County, GA",GA,2011,7018,6156,862,12.3,-144
"Rabun County, GA",GA,2010,7162,6306,856,12.0,0
"Racine County, WI",WI,2021,98979,94312,4667,4.7,464
"Racine County, WI",WI,2020,98515,91314,7201,7.3,-379
"Racine County, WI",WI,2019,98894,95042,3852,3.9,-598
"Racine County, WI",WI,2018,99492,95909,3583,3.6,-472
"Racine County, WI",WI,2017,99964,95938,4026,4.0,511
"Racine County, WI",WI,2016,99453,94662,4791,4.8,372
"Racine County, WI",WI,2015,99081,93644,5437,5.5,-632
"Racine County, WI",WI,2014,99713,93226,6487,6.5,16
"Racine County, WI",WI,2013,99697,91452,8245,8.3,-593
"Racine County, WI",WI,2012,100290,92031,8259,8.2,52
"Racine County, WI",WI,2011,100238,91402,8836,8.8,-77
"Racine County, WI",WI,2010,100315,90325,9990,10.0,0
"Radford city, VA",VA,2021,8551,8204,347,4.1,5
"Radford city, VA",VA,2020,8546,8010,536,6.3,-262
"Radford city, VA",VA,2019,8808,8498,310,3.5,109
"Radford city, VA",VA,2018,8699,8373,326,3.7,282
"Radford city, VA",VA,2017,8417,8006,411,4.9,150
"Radford city, VA",VA,2016,8267,7826,441,5.3,-56
"Radford city, VA",VA,2015,8323,7859,464,5.6,-172
"Radford city, VA",VA,2014,8495,7933,562,6.6,159
"Radford city, VA",VA,2013,8336,7722,614,7.4,244
"Radford city, VA",VA,2012,8092,7463,629,7.8,23
"Radford city, VA",VA,2011,8069,7391,678,8.4,267
"Radford city, VA",VA,2010,7802,7057,745,9.5,0
"Rains County, TX",TX,2021,6318,6073,245,3.9,364
"Rains County, TX",TX,2020,5954,5674,280,4.7,-29
"Rains County, TX",TX,2019,5983,5801,182,3.0,131
"Rains County, TX",TX,2018,5852,5646,206,3.5,193
"Rains County, TX",TX,2017,5659,5454,205,3.6,103
"Rains County, TX",TX,2016,5556,5333,223,4.0,142
"Rains County, TX",TX,2015,5414,5165,249,4.6,16
"Rains County, TX",TX,2014,5398,5128,270,5.0,70
"Rains County, TX",TX,2013,5328,4998,330,6.2,110
"Rains County, TX",TX,2012,5218,4856,362,6.9,52
"Rains County, TX",TX,2011,5166,4729,437,8.5,-7
"Rains County, TX",TX,2010,5173,4716,457,8.8,0
"Raleigh County, WV",WV,2021,30080,28502,1578,5.2,-43
"Raleigh County, WV",WV,2020,30123,27493,2630,8.7,-390
"Raleigh County, WV",WV,2019,30513,29080,1433,4.7,511
"Raleigh County, WV",WV,2018,30002,28457,1545,5.1,423
"Raleigh County, WV",WV,2017,29579,27991,1588,5.4,-452
"Raleigh County, WV",WV,2016,30031,27931,2100,7.0,-665
"Raleigh County, WV",WV,2015,30696,28484,2212,7.2,-809
"Raleigh County, WV",WV,2014,31505,29284,2221,7.0,-323
"Raleigh County, WV",WV,2013,31828,29535,2293,7.2,-1023
"Raleigh County, WV",WV,2012,32851,30546,2305,7.0,-160
"Raleigh County, WV",WV,2011,33011,30701,2310,7.0,583
"Raleigh County, WV",WV,2010,32428,29784,2644,8.2,0
"Ralls County, MO",MO,2021,5602,5412,190,3.4,-10
"Ralls County, MO",MO,2020,5612,5363,249,4.4,-48
"Ralls County, MO",MO,2019,5660,5493,167,3.0,54
"Ralls County, MO",MO,2018,5606,5451,155,2.8,-36
"Ralls County, MO",MO,2017,5642,5467,175,3.1,21
"Ralls County, MO",MO,2016,5621,5395,226,4.0,-15
"Ralls County, MO",MO,2015,5636,5393,243,4.3,16
"Ralls County, MO",MO,2014,5620,5322,298,5.3,32
"Ralls County, MO",MO,2013,5588,5261,327,5.9,-3
"Ralls County, MO",MO,2012,5591,5222,369,6.6,-28
"Ralls County, MO",MO,2011,5619,5190,429,7.6,8
"Ralls County, MO",MO,2010,5611,5122,489,8.7,0
"Ramsey County, MN",MN,2021,281343,270690,10653,3.8,-9126
"Ramsey County, MN",MN,2020,290469,269924,20545,7.1,-1676
"Ramsey County, MN",MN,2019,292145,282808,9337,3.2,2700
"Ramsey County, MN",MN,2018,289445,281073,8372,2.9,1273
"Ramsey County, MN",MN,2017,288172,278748,9424,3.3,5945
"Ramsey County, MN",MN,2016,282227,272058,10169,3.6,1985
"Ramsey County, MN",MN,2015,280242,270141,10101,3.6,2239
"Ramsey County, MN",MN,2014,278003,266524,11479,4.1,2491
"Ramsey County, MN",MN,2013,275512,261780,13732,5.0,2242
"Ramsey County, MN",MN,2012,273270,257449,15821,5.8,268
"Ramsey County, MN",MN,2011,273002,254784,18218,6.7,2733
"Ramsey County, MN",MN,2010,270269,250065,20204,7.5,0
"Ramsey County, ND",ND,2021,5730,5543,187,3.3,-24
"Ramsey County, ND",ND,2020,5754,5499,255,4.4,20
"Ramsey County, ND",ND,2019,5734,5583,151,2.6,-20
"Ramsey County, ND",ND,2018,5754,5605,149,2.6,-181
"Ramsey County, ND",ND,2017,5935,5776,159,2.7,-198
"Ramsey County, ND",ND,2016,6133,5958,175,2.9,488
"Ramsey County, ND",ND,2015,5645,5453,192,3.4,37
"Ramsey County, ND",ND,2014,5608,5413,195,3.5,-78
"Ramsey County, ND",ND,2013,5686,5473,213,3.7,-104
"Ramsey County, ND",ND,2012,5790,5561,229,4.0,-263
"Ramsey County, ND",ND,2011,6053,5830,223,3.7,0
"Ramsey County, ND",ND,2010,6053,5827,226,3.7,0
"Randall County, TX",TX,2021,74603,71978,2625,3.5,2077
"Randall County, TX",TX,2020,72526,69298,3228,4.5,279
"Randall County, TX",TX,2019,72247,70514,1733,2.4,1305
"Randall County, TX",TX,2018,70942,69078,1864,2.6,563
"Randall County, TX",TX,2017,70379,68378,2001,2.8,-306
"Randall County, TX",TX,2016,70685,68595,2090,3.0,1576
"Randall County, TX",TX,2015,69109,67092,2017,2.9,380
"Randall County, TX",TX,2014,68729,66325,2404,3.5,347
"Randall County, TX",TX,2013,68382,65414,2968,4.3,414
"Randall County, TX",TX,2012,67968,64982,2986,4.4,-58
"Randall County, TX",TX,2011,68026,64545,3481,5.1,1699
"Randall County, TX",TX,2010,66327,62880,3447,5.2,0
"Randolph County, AL",AL,2021,9408,9150,258,2.7,-162
"Randolph County, AL",AL,2020,9570,9063,507,5.3,-74
"Randolph County, AL",AL,2019,9644,9333,311,3.2,-41
"Randolph County, AL",AL,2018,9685,9299,386,4.0,91
"Randolph County, AL",AL,2017,9594,9163,431,4.5,244
"Randolph County, AL",AL,2016,9350,8827,523,5.6,-60
"Randolph County, AL",AL,2015,9410,8852,558,5.9,119
"Randolph County, AL",AL,2014,9291,8669,622,6.7,86
"Randolph County, AL",AL,2013,9205,8480,725,7.9,51
"Randolph County, AL",AL,2012,9154,8294,860,9.4,-286
"Randolph County, AL",AL,2011,9440,8378,1062,11.3,-261
"Randolph County, AL",AL,2010,9701,8428,1273,13.1,0
"Randolph County, AR",AR,2021,7313,7025,288,3.9,-136
"Randolph County, AR",AR,2020,7449,7006,443,5.9,136
"Randolph County, AR",AR,2019,7313,7036,277,3.8,152
"Randolph County, AR",AR,2018,7161,6879,282,3.9,239
"Randolph County, AR",AR,2017,6922,6632,290,4.2,388
"Randolph County, AR",AR,2016,6534,6232,302,4.6,325
"Randolph County, AR",AR,2015,6209,5772,437,7.0,-383
"Randolph County, AR",AR,2014,6592,6084,508,7.7,-135
"Randolph County, AR",AR,2013,6727,6103,624,9.3,-164
"Randolph County, AR",AR,2012,6891,6175,716,10.4,-255
"Randolph County, AR",AR,2011,7146,6376,770,10.8,-100
"Randolph County, AR",AR,2010,7246,6530,716,9.9,0
"Randolph County, GA",GA,2021,2373,2250,123,5.2,-93
"Randolph County, GA",GA,2020,2466,2320,146,5.9,-92
"Randolph County, GA",GA,2019,2558,2431,127,5.0,70
"Randolph County, GA",GA,2018,2488,2348,140,5.6,-52
"Randolph County, GA",GA,2017,2540,2374,166,6.5,65
"Randolph County, GA",GA,2016,2475,2263,212,8.6,76
"Randolph County, GA",GA,2015,2399,2177,222,9.3,-316
"Randolph County, GA",GA,2014,2715,2451,264,9.7,-72
"Randolph County, GA",GA,2013,2787,2501,286,10.3,-37
"Randolph County, GA",GA,2012,2824,2476,348,12.3,-113
"Randolph County, GA",GA,2011,2937,2566,371,12.6,-51
"Randolph County, GA",GA,2010,2988,2620,368,12.3,0
"Randolph County, IL",IL,2021,13674,13082,592,4.3,-54
"Randolph County, IL",IL,2020,13728,12740,988,7.2,-612
"Randolph County, IL",IL,2019,14340,13841,499,3.5,112
"Randolph County, IL",IL,2018,14228,13609,619,4.4,27
"Randolph County, IL",IL,2017,14201,13575,626,4.4,-408
"Randolph County, IL",IL,2016,14609,13878,731,5.0,280
"Randolph County, IL",IL,2015,14329,13550,779,5.4,168
"Randolph County, IL",IL,2014,14161,13215,946,6.7,-207
"Randolph County, IL",IL,2013,14368,13167,1201,8.4,-182
"Randolph County, IL",IL,2012,14550,13322,1228,8.4,-249
"Randolph County, IL",IL,2011,14799,13572,1227,8.3,-204
"Randolph County, IL",IL,2010,15003,13671,1332,8.9,0
"Randolph County, IN",IN,2021,11874,11524,350,2.9,680
"Randolph County, IN",IN,2020,11194,10452,742,6.6,-157
"Randolph County, IN",IN,2019,11351,10935,416,3.7,-277
"Randolph County, IN",IN,2018,11628,11180,448,3.9,-106
"Randolph County, IN",IN,2017,11734,11250,484,4.1,-947
"Randolph County, IN",IN,2016,12681,12118,563,4.4,-2
"Randolph County, IN",IN,2015,12683,12059,624,4.9,194
"Randolph County, IN",IN,2014,12489,11687,802,6.4,-104
"Randolph County, IN",IN,2013,12593,11525,1068,8.5,-175
"Randolph County, IN",IN,2012,12768,11567,1201,9.4,-281
"Randolph County, IN",IN,2011,13049,11722,1327,10.2,32
"Randolph County, IN",IN,2010,13017,11524,1493,11.5,0
"Randolph County, MO",MO,2021,10273,9840,433,4.2,154
"Randolph County, MO",MO,2020,10119,9523,596,5.9,-150
"Randolph County, MO",MO,2019,10269,9892,377,3.7,50
"Randolph County, MO",MO,2018,10219,9835,384,3.8,-45
"Randolph County, MO",MO,2017,10264,9802,462,4.5,-217
"Randolph County, MO",MO,2016,10481,9933,548,5.2,37
"Randolph County, MO",MO,2015,10444,9805,639,6.1,-86
"Randolph County, MO",MO,2014,10530,9783,747,7.1,25
"Randolph County, MO",MO,2013,10505,9637,868,8.3,-104
"Randolph County, MO",MO,2012,10609,9653,956,9.0,-165
"Randolph County, MO",MO,2011,10774,9618,1156,10.7,29
"Randolph County, MO",MO,2010,10745,9513,1232,11.5,0
"Randolph County, NC",NC,2021,63631,60655,2976,4.7,786
"Randolph County, NC",NC,2020,62845,58373,4472,7.1,-2673
"Randolph County, NC",NC,2019,65518,63074,2444,3.7,361
"Randolph County, NC",NC,2018,65157,62663,2494,3.8,-521
"Randolph County, NC",NC,2017,65678,62804,2874,4.4,-1003
"Randolph County, NC",NC,2016,66681,63396,3285,4.9,107
"Randolph County, NC",NC,2015,66574,62820,3754,5.6,-58
"Randolph County, NC",NC,2014,66632,62396,4236,6.4,-1437
"Randolph County, NC",NC,2013,68069,62344,5725,8.4,-1010
"Randolph County, NC",NC,2012,69079,62045,7034,10.2,-5
"Randolph County, NC",NC,2011,69084,61522,7562,10.9,-585
"Randolph County, NC",NC,2010,69669,61384,8285,11.9,0
"Randolph County, WV",WV,2021,12058,11386,672,5.6,-126
"Randolph County, WV",WV,2020,12184,11091,1093,9.0,-216
"Randolph County, WV",WV,2019,12400,11662,738,6.0,248
"Randolph County, WV",WV,2018,12152,11493,659,5.4,-63
"Randolph County, WV",WV,2017,12215,11556,659,5.4,-30
"Randolph County, WV",WV,2016,12245,11511,734,6.0,208
"Randolph County, WV",WV,2015,12037,11213,824,6.8,119
"Randolph County, WV",WV,2014,11918,11071,847,7.1,-15
"Randolph County, WV",WV,2013,11933,11083,850,7.1,-140
"Randolph County, WV",WV,2012,12073,11056,1017,8.4,4
"Randolph County, WV",WV,2011,12069,10926,1143,9.5,-124
"Randolph County, WV",WV,2010,12193,10912,1281,10.5,0
"Rankin County, MS",MS,2021,75393,72669,2724,3.6,1118
"Rankin County, MS",MS,2020,74275,70439,3836,5.2,-2941
"Rankin County, MS",MS,2019,77216,74146,3070,4.0,1181
"Rankin County, MS",MS,2018,76035,73331,2704,3.6,180
"Rankin County, MS",MS,2017,75855,73065,2790,3.7,1282
"Rankin County, MS",MS,2016,74573,71558,3015,4.0,1810
"Rankin County, MS",MS,2015,72763,69701,3062,4.2,2025
"Rankin County, MS",MS,2014,70738,67418,3320,4.7,-537
"Rankin County, MS",MS,2013,71275,67569,3706,5.2,-2333
"Rankin County, MS",MS,2012,73608,69466,4142,5.6,-130
"Rankin County, MS",MS,2011,73738,69149,4589,6.2,2666
"Rankin County, MS",MS,2010,71072,66343,4729,6.7,0
"Ransom County, ND",ND,2021,2696,2627,69,2.6,-202
"Ransom County, ND",ND,2020,2898,2782,116,4.0,34
"Ransom County, ND",ND,2019,2864,2819,45,1.6,-16
"Ransom County, ND",ND,2018,2880,2830,50,1.7,30
"Ransom County, ND",ND,2017,2850,2795,55,1.9,17
"Ransom County, ND",ND,2016,2833,2769,64,2.3,79
"Ransom County, ND",ND,2015,2754,2686,68,2.5,54
"Ransom County, ND",ND,2014,2700,2625,75,2.8,-35
"Ransom County, ND",ND,2013,2735,2657,78,2.9,-48
"Ransom County, ND",ND,2012,2783,2703,80,2.9,-88
"Ransom County, ND",ND,2011,2871,2772,99,3.4,10
"Ransom County, ND",ND,2010,2861,2732,129,4.5,0
"Rapides Parish, LA",LA,2021,55425,53197,2228,4.0,748
"Rapides Parish, LA",LA,2020,54677,51015,3662,6.7,-580
"Rapides Parish, LA",LA,2019,55257,52558,2699,4.9,-372
"Rapides Parish, LA",LA,2018,55629,52729,2900,5.2,-540
"Rapides Parish, LA",LA,2017,56169,53019,3150,5.6,-1177
"Rapides Parish, LA",LA,2016,57346,53805,3541,6.2,-612
"Rapides Parish, LA",LA,2015,57958,54240,3718,6.4,174
"Rapides Parish, LA",LA,2014,57784,53998,3786,6.6,562
"Rapides Parish, LA",LA,2013,57222,53455,3767,6.6,-269
"Rapides Parish, LA",LA,2012,57491,53634,3857,6.7,-922
"Rapides Parish, LA",LA,2011,58413,54175,4238,7.3,-372
"Rapides Parish, LA",LA,2010,58785,54571,4214,7.2,0
"Rappahannock County, VA",VA,2021,3584,3480,104,2.9,-42
"Rappahannock County, VA",VA,2020,3626,3461,165,4.6,-185
"Rappahannock County, VA",VA,2019,3811,3716,95,2.5,135
"Rappahannock County, VA",VA,2018,3676,3576,100,2.7,-6
"Rappahannock County, VA",VA,2017,3682,3554,128,3.5,-35
"Rappahannock County, VA",VA,2016,3717,3588,129,3.5,-32
"Rappahannock County, VA",VA,2015,3749,3596,153,4.1,-62
"Rappahannock County, VA",VA,2014,3811,3632,179,4.7,-107
"Rappahannock County, VA",VA,2013,3918,3722,196,5.0,-40
"Rappahannock County, VA",VA,2012,3958,3748,210,5.3,-39
"Rappahannock County, VA",VA,2011,3997,3773,224,5.6,-33
"Rappahannock County, VA",VA,2010,4030,3769,261,6.5,0
"Ravalli County, MT",MT,2021,21330,20564,766,3.6,482
"Ravalli County, MT",MT,2020,20848,19667,1181,5.7,254
"Ravalli County, MT",MT,2019,20594,19736,858,4.2,474
"Ravalli County, MT",MT,2018,20120,19271,849,4.2,217
"Ravalli County, MT",MT,2017,19903,18956,947,4.8,334
"Ravalli County, MT",MT,2016,19569,18594,975,5.0,334
"Ravalli County, MT",MT,2015,19235,18206,1029,5.3,443
"Ravalli County, MT",MT,2014,18792,17658,1134,6.0,33
"Ravalli County, MT",MT,2013,18759,17510,1249,6.7,54
"Ravalli County, MT",MT,2012,18705,17322,1383,7.4,65
"Ravalli County, MT",MT,2011,18640,17036,1604,8.6,-248
"Ravalli County, MT",MT,2010,18888,17125,1763,9.3,0
"Rawlins County, KS",KS,2021,1632,1606,26,1.6,88
"Rawlins County, KS",KS,2020,1544,1506,38,2.5,44
"Rawlins County, KS",KS,2019,1500,1467,33,2.2,19
"Rawlins County, KS",KS,2018,1481,1451,30,2.0,19
"Rawlins County, KS",KS,2017,1462,1429,33,2.3,-90
"Rawlins County, KS",KS,2016,1552,1515,37,2.4,13
"Rawlins County, KS",KS,2015,1539,1504,35,2.3,21
"Rawlins County, KS",KS,2014,1518,1481,37,2.4,-36
"Rawlins County, KS",KS,2013,1554,1511,43,2.8,-20
"Rawlins County, KS",KS,2012,1574,1532,42,2.7,47
"Rawlins County, KS",KS,2011,1527,1474,53,3.5,16
"Rawlins County, KS",KS,2010,1511,1459,52,3.4,0
"Ray County, MO",MO,2021,10983,10272,711,6.5,226
"Ray County, MO",MO,2020,10757,10026,731,6.8,-201
"Ray County, MO",MO,2019,10958,10582,376,3.4,64
"Ray County, MO",MO,2018,10894,10501,393,3.6,-191
"Ray County, MO",MO,2017,11085,10553,532,4.8,-50
"Ray County, MO",MO,2016,11135,10588,547,4.9,39
"Ray County, MO",MO,2015,11096,10478,618,5.6,3
"Ray County, MO",MO,2014,11093,10335,758,6.8,-5
"Ray County, MO",MO,2013,11098,10234,864,7.8,-139
"Ray County, MO",MO,2012,11237,10286,951,8.5,-145
"Ray County, MO",MO,2011,11382,10307,1075,9.4,-137
"Ray County, MO",MO,2010,11519,10347,1172,10.2,0
"Reagan County, TX",TX,2021,1653,1526,127,7.7,-137
"Reagan County, TX",TX,2020,1790,1615,175,9.8,-81
"Reagan County, TX",TX,2019,1871,1822,49,2.6,15
"Reagan County, TX",TX,2018,1856,1809,47,2.5,76
"Reagan County, TX",TX,2017,1780,1711,69,3.9,78
"Reagan County, TX",TX,2016,1702,1597,105,6.2,-227
"Reagan County, TX",TX,2015,1929,1841,88,4.6,-145
"Reagan County, TX",TX,2014,2074,2007,67,3.2,120
"Reagan County, TX",TX,2013,1954,1876,78,4.0,-119
"Reagan County, TX",TX,2012,2073,2003,70,3.4,59
"Reagan County, TX",TX,2011,2014,1923,91,4.5,100
"Reagan County, TX",TX,2010,1914,1807,107,5.6,0
"Real County, TX",TX,2021,1144,1076,68,5.9,69
"Real County, TX",TX,2020,1075,1005,70,6.5,27
"Real County, TX",TX,2019,1048,1007,41,3.9,9
"Real County, TX",TX,2018,1039,987,52,5.0,-7
"Real County, TX",TX,2017,1046,986,60,5.7,5
"Real County, TX",TX,2016,1041,982,59,5.7,-23
"Real County, TX",TX,2015,1064,1009,55,5.2,6
"Real County, TX",TX,2014,1058,991,67,6.3,-3
"Real County, TX",TX,2013,1061,975,86,8.1,-3
"Real County, TX",TX,2012,1064,965,99,9.3,-71
"Real County, TX",TX,2011,1135,1020,115,10.1,-3
"Real County, TX",TX,2010,1138,1034,104,9.1,0
"Red Lake County, MN",MN,2021,2150,2065,85,4.0,-94
"Red Lake County, MN",MN,2020,2244,2094,150,6.7,-8
"Red Lake County, MN",MN,2019,2252,2127,125,5.6,12
"Red Lake County, MN",MN,2018,2240,2117,123,5.5,-22
"Red Lake County, MN",MN,2017,2262,2111,151,6.7,-27
"Red Lake County, MN",MN,2016,2289,2121,168,7.3,-47
"Red Lake County, MN",MN,2015,2336,2196,140,6.0,71
"Red Lake County, MN",MN,2014,2265,2131,134,5.9,7
"Red Lake County, MN",MN,2013,2258,2104,154,6.8,-86
"Red Lake County, MN",MN,2012,2344,2173,171,7.3,-84
"Red Lake County, MN",MN,2011,2428,2232,196,8.1,7
"Red Lake County, MN",MN,2010,2421,2188,233,9.6,0
"Red River County, TX",TX,2021,5320,5006,314,5.9,251
"Red River County, TX",TX,2020,5069,4746,323,6.4,51
"Red River County, TX",TX,2019,5018,4786,232,4.6,-22
"Red River County, TX",TX,2018,5040,4765,275,5.5,-121
"Red River County, TX",TX,2017,5161,4888,273,5.3,125
"Red River County, TX",TX,2016,5036,4744,292,5.8,124
"Red River County, TX",TX,2015,4912,4600,312,6.4,-20
"Red River County, TX",TX,2014,4932,4544,388,7.9,-200
"Red River County, TX",TX,2013,5132,4613,519,10.1,-116
"Red River County, TX",TX,2012,5248,4690,558,10.6,-252
"Red River County, TX",TX,2011,5500,4814,686,12.5,-91
"Red River County, TX",TX,2010,5591,4941,650,11.6,0
"Red River Parish, LA",LA,2021,3668,3509,159,4.3,84
"Red River Parish, LA",LA,2020,3584,3345,239,6.7,-178
"Red River Parish, LA",LA,2019,3762,3577,185,4.9,-300
"Red River Parish, LA",LA,2018,4062,3883,179,4.4,197
"Red River Parish, LA",LA,2017,3865,3664,201,5.2,52
"Red River Parish, LA",LA,2016,3813,3583,230,6.0,-87
"Red River Parish, LA",LA,2015,3900,3632,268,6.9,-74
"Red River Parish, LA",LA,2014,3974,3693,281,7.1,116
"Red River Parish, LA",LA,2013,3858,3578,280,7.3,-105
"Red River Parish, LA",LA,2012,3963,3686,277,7.0,-100
"Red River Parish, LA",LA,2011,4063,3766,297,7.3,47
"Red River Parish, LA",LA,2010,4016,3695,321,8.0,0
"Red Willow County, NE",NE,2021,5869,5752,117,2.0,-17
"Red Willow County, NE",NE,2020,5886,5700,186,3.2,-35
"Red Willow County, NE",NE,2019,5921,5761,160,2.7,29
"Red Willow County, NE",NE,2018,5892,5749,143,2.4,-2
"Red Willow County, NE",NE,2017,5894,5743,151,2.6,-115
"Red Willow County, NE",NE,2016,6009,5840,169,2.8,-117
"Red Willow County, NE",NE,2015,6126,5965,161,2.6,-166
"Red Willow County, NE",NE,2014,6292,6131,161,2.6,-126
"Red Willow County, NE",NE,2013,6418,6233,185,2.9,73
"Red Willow County, NE",NE,2012,6345,6144,201,3.2,55
"Red Willow County, NE",NE,2011,6290,6071,219,3.5,84
"Red Willow County, NE",NE,2010,6206,5975,231,3.7,0
"Redwood County, MN",MN,2021,7379,7128,251,3.4,-432
"Redwood County, MN",MN,2020,7811,7369,442,5.7,121
"Redwood County, MN",MN,2019,7690,7388,302,3.9,42
"Redwood County, MN",MN,2018,7648,7355,293,3.8,-64
"Redwood County, MN",MN,2017,7712,7394,318,4.1,-603
"Redwood County, MN",MN,2016,8315,7974,341,4.1,27
"Redwood County, MN",MN,2015,8288,7957,331,4.0,268
"Redwood County, MN",MN,2014,8020,7658,362,4.5,-39
"Redwood County, MN",MN,2013,8059,7611,448,5.6,-156
"Redwood County, MN",MN,2012,8215,7758,457,5.6,-188
"Redwood County, MN",MN,2011,8403,7892,511,6.1,-184
"Redwood County, MN",MN,2010,8587,8006,581,6.8,0
"Reeves County, TX",TX,2021,8608,8103,505,5.9,-132
"Reeves County, TX",TX,2020,8740,8112,628,7.2,-2291
"Reeves County, TX",TX,2019,11031,10836,195,1.8,1713
"Reeves County, TX",TX,2018,9318,9123,195,2.1,2376
"Reeves County, TX",TX,2017,6942,6692,250,3.6,906
"Reeves County, TX",TX,2016,6036,5715,321,5.3,356
"Reeves County, TX",TX,2015,5680,5406,274,4.8,-71
"Reeves County, TX",TX,2014,5751,5516,235,4.1,133
"Reeves County, TX",TX,2013,5618,5292,326,5.8,288
"Reeves County, TX",TX,2012,5330,4974,356,6.7,-208
"Reeves County, TX",TX,2011,5538,5082,456,8.2,-216
"Reeves County, TX",TX,2010,5754,5244,510,8.9,0
"Refugio County, TX",TX,2021,3037,2833,204,6.7,15
"Refugio County, TX",TX,2020,3022,2773,249,8.2,-88
"Refugio County, TX",TX,2019,3110,2995,115,3.7,3
"Refugio County, TX",TX,2018,3107,2963,144,4.6,-111
"Refugio County, TX",TX,2017,3218,3037,181,5.6,81
"Refugio County, TX",TX,2016,3137,2929,208,6.6,-171
"Refugio County, TX",TX,2015,3308,3131,177,5.4,-287
"Refugio County, TX",TX,2014,3595,3440,155,4.3,40
"Refugio County, TX",TX,2013,3555,3362,193,5.4,54
"Refugio County, TX",TX,2012,3501,3291,210,6.0,83
"Refugio County, TX",TX,2011,3418,3150,268,7.8,85
"Refugio County, TX",TX,2010,3333,3040,293,8.8,0
"Reno County, KS",KS,2021,29772,28825,947,3.2,41
"Reno County, KS",KS,2020,29731,28164,1567,5.3,-134
"Reno County, KS",KS,2019,29865,28922,943,3.2,69
"Reno County, KS",KS,2018,29796,28746,1050,3.5,-363
"Reno County, KS",KS,2017,30159,28996,1163,3.9,-114
"Reno County, KS",KS,2016,30273,28944,1329,4.4,-652
"Reno County, KS",KS,2015,30925,29594,1331,4.3,-310
"Reno County, KS",KS,2014,31235,29870,1365,4.4,-428
"Reno County, KS",KS,2013,31663,30000,1663,5.3,-527
"Reno County, KS",KS,2012,32190,30438,1752,5.4,-604
"Reno County, KS",KS,2011,32794,30843,1951,5.9,-101
"Reno County, KS",KS,2010,32895,30827,2068,6.3,0
"Rensselaer County, NY",NY,2021,80735,77206,3529,4.4,-1186
"Rensselaer County, NY",NY,2020,81921,76421,5500,6.7,-1091
"Rensselaer County, NY",NY,2019,83012,80006,3006,3.6,83
"Rensselaer County, NY",NY,2018,82929,79721,3208,3.9,449
"Rensselaer County, NY",NY,2017,82480,78844,3636,4.4,895
"Rensselaer County, NY",NY,2016,81585,78036,3549,4.4,146
"Rensselaer County, NY",NY,2015,81439,77625,3814,4.7,391
"Rensselaer County, NY",NY,2014,81048,76657,4391,5.4,-2343
"Rensselaer County, NY",NY,2013,83391,77684,5707,6.8,-84
"Rensselaer County, NY",NY,2012,83475,76917,6558,7.9,590
"Rensselaer County, NY",NY,2011,82885,76538,6347,7.7,-1794
"Rensselaer County, NY",NY,2010,84679,77980,6699,7.9,0
"Renville County, MN",MN,2021,8153,7838,315,3.9,-387
"Renville County, MN",MN,2020,8540,8034,506,5.9,-195
"Renville County, MN",MN,2019,8735,8315,420,4.8,-24
"Renville County, MN",MN,2018,8759,8389,370,4.2,-161
"Renville County, MN",MN,2017,8920,8522,398,4.5,509
"Renville County, MN",MN,2016,8411,7969,442,5.3,-204
"Renville County, MN",MN,2015,8615,8192,423,4.9,387
"Renville County, MN",MN,2014,8228,7763,465,5.7,-21
"Renville County, MN",MN,2013,8249,7704,545,6.6,-189
"Renville County, MN",MN,2012,8438,7861,577,6.8,-127
"Renville County, MN",MN,2011,8565,7934,631,7.4,-433
"Renville County, MN",MN,2010,8998,8274,724,8.0,0
"Renville County, ND",ND,2021,1201,1160,41,3.4,-34
"Renville County, ND",ND,2020,1235,1174,61,4.9,7
"Renville County, ND",ND,2019,1228,1201,27,2.2,-12
"Renville County, ND",ND,2018,1240,1213,27,2.2,-46
"Renville County, ND",ND,2017,1286,1253,33,2.6,-20
"Renville County, ND",ND,2016,1306,1255,51,3.9,-21
"Renville County, ND",ND,2015,1327,1283,44,3.3,-64
"Renville County, ND",ND,2014,1391,1355,36,2.6,3
"Renville County, ND",ND,2013,1388,1354,34,2.4,-49
"Renville County, ND",ND,2012,1437,1406,31,2.2,-5
"Renville County, ND",ND,2011,1442,1403,39,2.7,-20
"Renville County, ND",ND,2010,1462,1422,40,2.7,0
"Republic County, KS",KS,2021,2356,2302,54,2.3,43
"Republic County, KS",KS,2020,2313,2241,72,3.1,26
"Republic County, KS",KS,2019,2287,2230,57,2.5,-137
"Republic County, KS",KS,2018,2424,2360,64,2.6,-42
"Republic County, KS",KS,2017,2466,2397,69,2.8,-89
"Republic County, KS",KS,2016,2555,2485,70,2.7,-42
"Republic County, KS",KS,2015,2597,2526,71,2.7,25
"Republic County, KS",KS,2014,2572,2494,78,3.0,-84
"Republic County, KS",KS,2013,2656,2566,90,3.4,35
"Republic County, KS",KS,2012,2621,2521,100,3.8,-76
"Republic County, KS",KS,2011,2697,2595,102,3.8,-37
"Republic County, KS",KS,2010,2734,2617,117,4.3,0
"Reynolds County, MO",MO,2021,2936,2815,121,4.1,14
"Reynolds County, MO",MO,2020,2922,2759,163,5.6,-85
"Reynolds County, MO",MO,2019,3007,2902,105,3.5,-21
"Reynolds County, MO",MO,2018,3028,2935,93,3.1,-98
"Reynolds County, MO",MO,2017,3126,3005,121,3.9,446
"Reynolds County, MO",MO,2016,2680,2507,173,6.5,-17
"Reynolds County, MO",MO,2015,2697,2505,192,7.1,14
"Reynolds County, MO",MO,2014,2683,2458,225,8.4,168
"Reynolds County, MO",MO,2013,2515,2276,239,9.5,259
"Reynolds County, MO",MO,2012,2256,2001,255,11.3,-54
"Reynolds County, MO",MO,2011,2310,2000,310,13.4,-62
"Reynolds County, MO",MO,2010,2372,2016,356,15.0,0
"Rhea County, TN",TN,2021,13588,12936,652,4.8,473
"Rhea County, TN",TN,2020,13115,11861,1254,9.6,-283
"Rhea County, TN",TN,2019,13398,12635,763,5.7,256
"Rhea County, TN",TN,2018,13142,12404,738,5.6,-102
"Rhea County, TN",TN,2017,13244,12384,860,6.5,-241
"Rhea County, TN",TN,2016,13485,12523,962,7.1,367
"Rhea County, TN",TN,2015,13118,12155,963,7.3,-183
"Rhea County, TN",TN,2014,13301,12176,1125,8.5,-98
"Rhea County, TN",TN,2013,13399,11972,1427,10.7,-90
"Rhea County, TN",TN,2012,13489,12085,1404,10.4,-336
"Rhea County, TN",TN,2011,13825,12245,1580,11.4,245
"Rhea County, TN",TN,2010,13580,11879,1701,12.5,0
"Rice County, KS",KS,2021,5315,5187,128,2.4,233
"Rice County, KS",KS,2020,5082,4878,204,4.0,-178
"Rice County, KS",KS,2019,5260,5117,143,2.7,-48
"Rice County, KS",KS,2018,5308,5157,151,2.8,-108
"Rice County, KS",KS,2017,5416,5243,173,3.2,87
"Rice County, KS",KS,2016,5329,5117,212,4.0,-163
"Rice County, KS",KS,2015,5492,5285,207,3.8,36
"Rice County, KS",KS,2014,5456,5265,191,3.5,2
"Rice County, KS",KS,2013,5454,5221,233,4.3,30
"Rice County, KS",KS,2012,5424,5183,241,4.4,9
"Rice County, KS",KS,2011,5415,5139,276,5.1,109
"Rice County, KS",KS,2010,5306,5022,284,5.4,0
"Rice County, MN",MN,2021,36354,35190,1164,3.2,-1167
"Rice County, MN",MN,2020,37521,35481,2040,5.4,-99
"Rice County, MN",MN,2019,37620,36375,1245,3.3,550
"Rice County, MN",MN,2018,37070,35969,1101,3.0,375
"Rice County, MN",MN,2017,36695,35518,1177,3.2,612
"Rice County, MN",MN,2016,36083,34818,1265,3.5,576
"Rice County, MN",MN,2015,35507,34222,1285,3.6,321
"Rice County, MN",MN,2014,35186,33704,1482,4.2,158
"Rice County, MN",MN,2013,35028,33269,1759,5.0,124
"Rice County, MN",MN,2012,34904,32860,2044,5.9,56
"Rice County, MN",MN,2011,34848,32525,2323,6.7,-159
"Rice County, MN",MN,2010,35007,32281,2726,7.8,0
"Rich County, UT",UT,2021,1273,1244,29,2.3,109
"Rich County, UT",UT,2020,1164,1123,41,3.5,-11
"Rich County, UT",UT,2019,1175,1140,35,3.0,-7
"Rich County, UT",UT,2018,1182,1146,36,3.0,36
"Rich County, UT",UT,2017,1146,1110,36,3.1,55
"Rich County, UT",UT,2016,1091,1057,34,3.1,51
"Rich County, UT",UT,2015,1040,1003,37,3.6,42
"Rich County, UT",UT,2014,998,961,37,3.7,28
"Rich County, UT",UT,2013,970,929,41,4.2,41
"Rich County, UT",UT,2012,929,885,44,4.7,-47
"Rich County, UT",UT,2011,976,902,74,7.6,-58
"Rich County, UT",UT,2010,1034,958,76,7.4,0
"Richardson County, NE",NE,2021,4294,4192,102,2.4,55
"Richardson County, NE",NE,2020,4239,4104,135,3.2,-53
"Richardson County, NE",NE,2019,4292,4156,136,3.2,11
"Richardson County, NE",NE,2018,4281,4149,132,3.1,30
"Richardson County, NE",NE,2017,4251,4111,140,3.3,-10
"Richardson County, NE",NE,2016,4261,4124,137,3.2,-56
"Richardson County, NE",NE,2015,4317,4179,138,3.2,38
"Richardson County, NE",NE,2014,4279,4124,155,3.6,-72
"Richardson County, NE",NE,2013,4351,4160,191,4.4,-45
"Richardson County, NE",NE,2012,4396,4177,219,5.0,-10
"Richardson County, NE",NE,2011,4406,4140,266,6.0,83
"Richardson County, NE",NE,2010,4323,4049,274,6.3,0
"Richland County, IL",IL,2021,7057,6753,304,4.3,-293
"Richland County, IL",IL,2020,7350,6843,507,6.9,93
"Richland County, IL",IL,2019,7257,6974,283,3.9,-264
"Richland County, IL",IL,2018,7521,7174,347,4.6,-39
"Richland County, IL",IL,2017,7560,7198,362,4.8,-14
"Richland County, IL",IL,2016,7574,7124,450,5.9,96
"Richland County, IL",IL,2015,7478,7038,440,5.9,247
"Richland County, IL",IL,2014,7231,6761,470,6.5,-136
"Richland County, IL",IL,2013,7367,6754,613,8.3,-148
"Richland County, IL",IL,2012,7515,6909,606,8.1,-287
"Richland County, IL",IL,2011,7802,7160,642,8.2,-197
"Richland County, IL",IL,2010,7999,7281,718,9.0,0
"Richland County, MT",MT,2021,5887,5651,236,4.0,-77
"Richland County, MT",MT,2020,5964,5591,373,6.3,13
"Richland County, MT",MT,2019,5951,5790,161,2.7,22
"Richland County, MT",MT,2018,5929,5746,183,3.1,-85
"Richland County, MT",MT,2017,6014,5781,233,3.9,-199
"Richland County, MT",MT,2016,6213,5893,320,5.2,-668
"Richland County, MT",MT,2015,6881,6653,228,3.3,-447
"Richland County, MT",MT,2014,7328,7153,175,2.4,250
"Richland County, MT",MT,2013,7078,6895,183,2.6,358
"Richland County, MT",MT,2012,6720,6538,182,2.7,561
"Richland County, MT",MT,2011,6159,5978,181,2.9,390
"Richland County, MT",MT,2010,5769,5555,214,3.7,0
"Richland County, ND",ND,2021,8669,8431,238,2.7,13
"Richland County, ND",ND,2020,8656,8325,331,3.8,-118
"Richland County, ND",ND,2019,8774,8589,185,2.1,-94
"Richland County, ND",ND,2018,8868,8658,210,2.4,-53
"Richland County, ND",ND,2017,8921,8710,211,2.4,37
"Richland County, ND",ND,2016,8884,8640,244,2.7,353
"Richland County, ND",ND,2015,8531,8298,233,2.7,111
"Richland County, ND",ND,2014,8420,8170,250,3.0,-61
"Richland County, ND",ND,2013,8481,8197,284,3.3,-31
"Richland County, ND",ND,2012,8512,8215,297,3.5,-341
"Richland County, ND",ND,2011,8853,8528,325,3.7,-224
"Richland County, ND",ND,2010,9077,8736,341,3.8,0
"Richland County, OH",OH,2021,51520,48658,2862,5.6,-150
"Richland County, OH",OH,2020,51670,47026,4644,9.0,-1142
"Richland County, OH",OH,2019,52812,50401,2411,4.6,-286
"Richland County, OH",OH,2018,53098,50498,2600,4.9,-417
"Richland County, OH",OH,2017,53515,50600,2915,5.4,-111
"Richland County, OH",OH,2016,53626,50633,2993,5.6,-118
"Richland County, OH",OH,2015,53744,50713,3031,5.6,-910
"Richland County, OH",OH,2014,54654,51085,3569,6.5,-249
"Richland County, OH",OH,2013,54903,50190,4713,8.6,-981
"Richland County, OH",OH,2012,55884,51019,4865,8.7,-2084
"Richland County, OH",OH,2011,57968,51826,6142,10.6,-1195
"Richland County, OH",OH,2010,59163,51970,7193,12.2,0
"Richland County, SC",SC,2021,196303,188213,8090,4.1,2100
"Richland County, SC",SC,2020,194203,183126,11077,5.7,1086
"Richland County, SC",SC,2019,193117,187840,5277,2.7,1070
"Richland County, SC",SC,2018,192047,185496,6551,3.4,-2818
"Richland County, SC",SC,2017,194865,186698,8167,4.2,-4948
"Richland County, SC",SC,2016,199813,190406,9407,4.7,1249
"Richland County, SC",SC,2015,198564,187463,11101,5.6,4621
"Richland County, SC",SC,2014,193943,182681,11262,5.8,2761
"Richland County, SC",SC,2013,191182,178448,12734,6.7,1546
"Richland County, SC",SC,2012,189636,174505,15131,8.0,2412
"Richland County, SC",SC,2011,187224,170293,16931,9.0,846
"Richland County, SC",SC,2010,186378,168729,17649,9.5,0
"Richland County, WI",WI,2021,9076,8758,318,3.5,-53
"Richland County, WI",WI,2020,9129,8661,468,5.1,-105
"Richland County, WI",WI,2019,9234,8958,276,3.0,-92
"Richland County, WI",WI,2018,9326,9084,242,2.6,13
"Richland County, WI",WI,2017,9313,9037,276,3.0,73
"Richland County, WI",WI,2016,9240,8901,339,3.7,-31
"Richland County, WI",WI,2015,9271,8891,380,4.1,-27
"Richland County, WI",WI,2014,9298,8835,463,5.0,-48
"Richland County, WI",WI,2013,9346,8782,564,6.0,-353
"Richland County, WI",WI,2012,9699,9102,597,6.2,47
"Richland County, WI",WI,2011,9652,8952,700,7.3,15
"Richland County, WI",WI,2010,9637,8784,853,8.9,0
"Richland Parish, LA",LA,2021,8117,7695,422,5.2,19
"Richland Parish, LA",LA,2020,8098,7436,662,8.2,-160
"Richland Parish, LA",LA,2019,8258,7761,497,6.0,-82
"Richland Parish, LA",LA,2018,8340,7827,513,6.2,12
"Richland Parish, LA",LA,2017,8328,7818,510,6.1,-127
"Richland Parish, LA",LA,2016,8455,7827,628,7.4,-173
"Richland Parish, LA",LA,2015,8628,7879,749,8.7,-52
"Richland Parish, LA",LA,2014,8680,7938,742,8.5,26
"Richland Parish, LA",LA,2013,8654,7853,801,9.3,-44
"Richland Parish, LA",LA,2012,8698,7886,812,9.3,-121
"Richland Parish, LA",LA,2011,8819,7900,919,10.4,37
"Richland Parish, LA",LA,2010,8782,7866,916,10.4,0
"Richmond city, VA",VA,2021,116270,109892,6378,5.5,-4241
"Richmond city, VA",VA,2020,120511,109953,10558,8.8,82
"Richmond city, VA",VA,2019,120429,116513,3916,3.3,1710
"Richmond city, VA",VA,2018,118719,114564,4155,3.5,776
"Richmond city, VA",VA,2017,117943,112921,5022,4.3,3145
"Richmond city, VA",VA,2016,114798,109549,5249,4.6,1657
"Richmond city, VA",VA,2015,113141,107324,5817,5.1,401
"Richmond city, VA",VA,2014,112740,105947,6793,6.0,2280
"Richmond city, VA",VA,2013,110460,103127,7333,6.6,1325
"Richmond city, VA",VA,2012,109135,101114,8021,7.3,1639
"Richmond city, VA",VA,2011,107496,98386,9110,8.5,814
"Richmond city, VA",VA,2010,106682,96300,10382,9.7,0
"Richmond County, GA",GA,2021,84416,79901,4515,5.3,361
"Richmond County, GA",GA,2020,84055,77658,6397,7.6,-1415
"Richmond County, GA",GA,2019,85470,81412,4058,4.7,-674
"Richmond County, GA",GA,2018,86144,81613,4531,5.3,-673
"Richmond County, GA",GA,2017,86817,81598,5219,6.0,1975
"Richmond County, GA",GA,2016,84842,79035,5807,6.8,1491
"Richmond County, GA",GA,2015,83351,77071,6280,7.5,-1176
"Richmond County, GA",GA,2014,84527,77147,7380,8.7,-2067
"Richmond County, GA",GA,2013,86594,78136,8458,9.8,-1521
"Richmond County, GA",GA,2012,88115,78891,9224,10.5,-193
"Richmond County, GA",GA,2011,88308,78477,9831,11.1,183
"Richmond County, GA",GA,2010,88125,78306,9819,11.1,0
"Richmond County, NC",NC,2021,16248,15059,1189,7.3,88
"Richmond County, NC",NC,2020,16160,14727,1433,8.9,-376
"Richmond County, NC",NC,2019,16536,15687,849,5.1,220
"Richmond County, NC",NC,2018,16316,15413,903,5.5,-159
"Richmond County, NC",NC,2017,16475,15484,991,6.0,-264
"Richmond County, NC",NC,2016,16739,15579,1160,6.9,-166
"Richmond County, NC",NC,2015,16905,15582,1323,7.8,-17
"Richmond County, NC",NC,2014,16922,15450,1472,8.7,-524
"Richmond County, NC",NC,2013,17446,15451,1995,11.4,-658
"Richmond County, NC",NC,2012,18104,15625,2479,13.7,-278
"Richmond County, NC",NC,2011,18382,15700,2682,14.6,-605
"Richmond County, NC",NC,2010,18987,16192,2795,14.7,0
"Richmond County, NY",NY,2021,221184,201965,19219,8.7,-1889
"Richmond County, NY",NY,2020,223073,199333,23740,10.6,-13442
"Richmond County, NY",NY,2019,236515,227662,8853,3.7,2625
"Richmond County, NY",NY,2018,233890,224382,9508,4.1,3559
"Richmond County, NY",NY,2017,230331,219832,10499,4.6,11018
"Richmond County, NY",NY,2016,219313,207941,11372,5.2,785
"Richmond County, NY",NY,2015,218528,206018,12510,5.7,-1142
"Richmond County, NY",NY,2014,219670,203725,15945,7.3,-351
"Richmond County, NY",NY,2013,220021,200334,19687,8.9,1836
"Richmond County, NY",NY,2012,218185,197348,20837,9.6,724
"Richmond County, NY",NY,2011,217461,197400,20061,9.2,-1169
"Richmond County, NY",NY,2010,218630,197881,20749,9.5,0
"Richmond County, VA",VA,2021,3904,3767,137,3.5,-136
"Richmond County, VA",VA,2020,4040,3844,196,4.9,-78
"Richmond County, VA",VA,2019,4118,3997,121,2.9,27
"Richmond County, VA",VA,2018,4091,3965,126,3.1,8
"Richmond County, VA",VA,2017,4083,3936,147,3.6,170
"Richmond County, VA",VA,2016,3913,3771,142,3.6,-2
"Richmond County, VA",VA,2015,3915,3739,176,4.5,-71
"Richmond County, VA",VA,2014,3986,3773,213,5.3,46
"Richmond County, VA",VA,2013,3940,3702,238,6.0,20
"Richmond County, VA",VA,2012,3920,3674,246,6.3,-339
"Richmond County, VA",VA,2011,4259,3977,282,6.6,-112
"Richmond County, VA",VA,2010,4371,4056,315,7.2,0
"Riley County, KS",KS,2021,33731,32789,942,2.8,184
"Riley County, KS",KS,2020,33547,31962,1585,4.7,-1711
"Riley County, KS",KS,2019,35258,34271,987,2.8,-120
"Riley County, KS",KS,2018,35378,34388,990,2.8,81
"Riley County, KS",KS,2017,35297,34224,1073,3.0,251
"Riley County, KS",KS,2016,35046,33861,1185,3.4,-681
"Riley County, KS",KS,2015,35727,34508,1219,3.4,-908
"Riley County, KS",KS,2014,36635,35292,1343,3.7,-22
"Riley County, KS",KS,2013,36657,35111,1546,4.2,271
"Riley County, KS",KS,2012,36386,34803,1583,4.4,780
"Riley County, KS",KS,2011,35606,33921,1685,4.7,-492
"Riley County, KS",KS,2010,36098,34319,1779,4.9,0
"Rincon Municipio, PR",PR,2021,4983,4549,434,8.7,
"Rincon Municipio, PR",PR,2020,N.A.,N.A.,N.A.,N.A.,
"Rincon Municipio, PR",PR,2019,4775,4121,654,13.7,62
"Rincon Municipio, PR",PR,2018,4713,4042,671,14.2,49
"Rincon Municipio, PR",PR,2017,4664,3951,713,15.3,33
"Rincon Municipio, PR",PR,2016,4631,3908,723,15.6,-8
"Rincon Municipio, PR",PR,2015,4639,3874,765,16.5,-67
"Rincon Municipio, PR",PR,2014,4706,3768,938,19.9,-61
"Rincon Municipio, PR",PR,2013,4767,3791,976,20.5,-44
"Rincon Municipio, PR",PR,2012,4811,3912,899,18.7,-96
"Rincon Municipio, PR",PR,2011,4907,3942,965,19.7,-79
"Rincon Municipio, PR",PR,2010,4986,4066,920,18.5,0
"Ringgold County, IA",IA,2021,2383,2303,80,3.4,-5
"Ringgold County, IA",IA,2020,2388,2298,90,3.8,-120
"Ringgold County, IA",IA,2019,2508,2439,69,2.8,-54
"Ringgold County, IA",IA,2018,2562,2491,71,2.8,-13
"Ringgold County, IA",IA,2017,2575,2497,78,3.0,-46
"Ringgold County, IA",IA,2016,2621,2530,91,3.5,54
"Ringgold County, IA",IA,2015,2567,2482,85,3.3,36
"Ringgold County, IA",IA,2014,2531,2434,97,3.8,13
"Ringgold County, IA",IA,2013,2518,2410,108,4.3,-30
"Ringgold County, IA",IA,2012,2548,2435,113,4.4,-63
"Ringgold County, IA",IA,2011,2611,2489,122,4.7,3
"Ringgold County, IA",IA,2010,2608,2483,125,4.8,0
"Rio Arriba County, NM",NM,2021,16592,15424,1168,7.0,109
"Rio Arriba County, NM",NM,2020,16483,15191,1292,7.8,-438
"Rio Arriba County, NM",NM,2019,16921,16015,906,5.4,145
"Rio Arriba County, NM",NM,2018,16776,15910,866,5.2,-197
"Rio Arriba County, NM",NM,2017,16973,15902,1071,6.3,81
"Rio Arriba County, NM",NM,2016,16892,15617,1275,7.5,183
"Rio Arriba County, NM",NM,2015,16709,15354,1355,8.1,116
"Rio Arriba County, NM",NM,2014,16593,15158,1435,8.6,-145
"Rio Arriba County, NM",NM,2013,16738,15148,1590,9.5,-132
"Rio Arriba County, NM",NM,2012,16870,15332,1538,9.1,-273
"Rio Arriba County, NM",NM,2011,17143,15614,1529,8.9,-718
"Rio Arriba County, NM",NM,2010,17861,16291,1570,8.8,0
"Rio Blanco County, CO",CO,2021,2931,2769,162,5.5,26
"Rio Blanco County, CO",CO,2020,2905,2754,151,5.2,-59
"Rio Blanco County, CO",CO,2019,2964,2861,103,3.5,57
"Rio Blanco County, CO",CO,2018,2907,2795,112,3.9,151
"Rio Blanco County, CO",CO,2017,2756,2658,98,3.6,21
"Rio Blanco County, CO",CO,2016,2735,2603,132,4.8,-70
"Rio Blanco County, CO",CO,2015,2805,2663,142,5.1,-134
"Rio Blanco County, CO",CO,2014,2939,2765,174,5.9,-132
"Rio Blanco County, CO",CO,2013,3071,2833,238,7.7,-13
"Rio Blanco County, CO",CO,2012,3084,2822,262,8.5,-30
"Rio Blanco County, CO",CO,2011,3114,2858,256,8.2,-25
"Rio Blanco County, CO",CO,2010,3139,2844,295,9.4,0
"Rio Grande County, CO",CO,2021,5529,5169,360,6.5,169
"Rio Grande County, CO",CO,2020,5360,4993,367,6.8,-40
"Rio Grande County, CO",CO,2019,5400,5190,210,3.9,36
"Rio Grande County, CO",CO,2018,5364,5122,242,4.5,46
"Rio Grande County, CO",CO,2017,5318,5105,213,4.0,165
"Rio Grande County, CO",CO,2016,5153,4909,244,4.7,292
"Rio Grande County, CO",CO,2015,4861,4566,295,6.1,44
"Rio Grande County, CO",CO,2014,4817,4376,441,9.2,-56
"Rio Grande County, CO",CO,2013,4873,4317,556,11.4,-220
"Rio Grande County, CO",CO,2012,5093,4463,630,12.4,-60
"Rio Grande County, CO",CO,2011,5153,4494,659,12.8,-48
"Rio Grande County, CO",CO,2010,5201,4618,583,11.2,0
"Rio Grande Municipio, PR",PR,2021,18349,16835,1514,8.3,
"Rio Grande Municipio, PR",PR,2020,N.A.,N.A.,N.A.,N.A.,
"Rio Grande Municipio, PR",PR,2019,16903,15669,1234,7.3,-13
"Rio Grande Municipio, PR",PR,2018,16916,15360,1556,9.2,-37
"Rio Grande Municipio, PR",PR,2017,16953,15308,1645,9.7,-142
"Rio Grande Municipio, PR",PR,2016,17095,15303,1792,10.5,34
"Rio Grande Municipio, PR",PR,2015,17061,15297,1764,10.3,-101
"Rio Grande Municipio, PR",PR,2014,17162,15120,2042,11.9,-424
"Rio Grande Municipio, PR",PR,2013,17586,15509,2077,11.8,-341
"Rio Grande Municipio, PR",PR,2012,17927,15704,2223,12.4,-253
"Rio Grande Municipio, PR",PR,2011,18180,15547,2633,14.5,-695
"Rio Grande Municipio, PR",PR,2010,18875,15999,2876,15.2,0
"Ripley County, IN",IN,2021,13534,13159,375,2.8,-385
"Ripley County, IN",IN,2020,13919,13020,899,6.5,-465
"Ripley County, IN",IN,2019,14384,13926,458,3.2,262
"Ripley County, IN",IN,2018,14122,13621,501,3.5,55
"Ripley County, IN",IN,2017,14067,13574,493,3.5,-11
"Ripley County, IN",IN,2016,14078,13442,636,4.5,447
"Ripley County, IN",IN,2015,13631,12905,726,5.3,-14
"Ripley County, IN",IN,2014,13645,12748,897,6.6,-8
"Ripley County, IN",IN,2013,13653,12504,1149,8.4,-203
"Ripley County, IN",IN,2012,13856,12630,1226,8.8,-1112
"Ripley County, IN",IN,2011,14968,13585,1383,9.2,445
"Ripley County, IN",IN,2010,14523,12940,1583,10.9,0
"Ripley County, MO",MO,2021,5072,4793,279,5.5,65
"Ripley County, MO",MO,2020,5007,4617,390,7.8,30
"Ripley County, MO",MO,2019,4977,4716,261,5.2,-111
"Ripley County, MO",MO,2018,5088,4826,262,5.1,-156
"Ripley County, MO",MO,2017,5244,4955,289,5.5,-85
"Ripley County, MO",MO,2016,5329,4954,375,7.0,34
"Ripley County, MO",MO,2015,5295,4866,429,8.1,-254
"Ripley County, MO",MO,2014,5549,5091,458,8.3,11
"Ripley County, MO",MO,2013,5538,5021,517,9.3,59
"Ripley County, MO",MO,2012,5479,4889,590,10.8,12
"Ripley County, MO",MO,2011,5467,4799,668,12.2,97
"Ripley County, MO",MO,2010,5370,4683,687,12.8,0
"Ritchie County, WV",WV,2021,4330,4089,241,5.6,-22
"Ritchie County, WV",WV,2020,4352,3996,356,8.2,-54
"Ritchie County, WV",WV,2019,4406,4154,252,5.7,50
"Ritchie County, WV",WV,2018,4356,4126,230,5.3,-75
"Ritchie County, WV",WV,2017,4431,4187,244,5.5,-147
"Ritchie County, WV",WV,2016,4578,4279,299,6.5,32
"Ritchie County, WV",WV,2015,4546,4236,310,6.8,-92
"Ritchie County, WV",WV,2014,4638,4355,283,6.1,78
"Ritchie County, WV",WV,2013,4560,4284,276,6.1,177
"Ritchie County, WV",WV,2012,4383,4071,312,7.1,76
"Ritchie County, WV",WV,2011,4307,3926,381,8.8,17
"Ritchie County, WV",WV,2010,4290,3873,417,9.7,0
"Riverside County, CA",CA,2021,1129562,1046723,82839,7.3,12304
"Riverside County, CA",CA,2020,1117258,1003553,113705,10.2,9542
"Riverside County, CA",CA,2019,1107716,1060633,47083,4.3,17678
"Riverside County, CA",CA,2018,1090038,1041323,48715,4.5,19162
"Riverside County, CA",CA,2017,1070876,1014232,56644,5.3,19266
"Riverside County, CA",CA,2016,1051610,987187,64423,6.1,18152
"Riverside County, CA",CA,2015,1033458,963825,69633,6.7,24296
"Riverside County, CA",CA,2014,1009162,925465,83697,8.3,16139
"Riverside County, CA",CA,2013,993023,893454,99569,10.0,7779
"Riverside County, CA",CA,2012,985244,868757,116487,11.8,7956
"Riverside County, CA",CA,2011,977288,846288,131000,13.4,-496
"Riverside County, CA",CA,2010,977784,839147,138637,14.2,0
"Roane County, TN",TN,2021,23377,22451,926,4.0,408
"Roane County, TN",TN,2020,22969,21521,1448,6.3,-506
"Roane County, TN",TN,2019,23475,22521,954,4.1,348
"Roane County, TN",TN,2018,23127,22174,953,4.1,174
"Roane County, TN",TN,2017,22953,21939,1014,4.4,75
"Roane County, TN",TN,2016,22878,21599,1279,5.6,250
"Roane County, TN",TN,2015,22628,21177,1451,6.4,13
"Roane County, TN",TN,2014,22615,20879,1736,7.7,-645
"Roane County, TN",TN,2013,23260,21166,2094,9.0,-606
"Roane County, TN",TN,2012,23866,21772,2094,8.8,-525
"Roane County, TN",TN,2011,24391,22144,2247,9.2,51
"Roane County, TN",TN,2010,24340,22065,2275,9.3,0
"Roane County, WV",WV,2021,5017,4592,425,8.5,-68
"Roane County, WV",WV,2020,5085,4470,615,12.1,-41
"Roane County, WV",WV,2019,5126,4634,492,9.6,130
"Roane County, WV",WV,2018,4996,4610,386,7.7,-60
"Roane County, WV",WV,2017,5056,4615,441,8.7,-163
"Roane County, WV",WV,2016,5219,4681,538,10.3,-59
"Roane County, WV",WV,2015,5278,4685,593,11.2,-54
"Roane County, WV",WV,2014,5332,4807,525,9.8,-29
"Roane County, WV",WV,2013,5361,4812,549,10.2,42
"Roane County, WV",WV,2012,5319,4734,585,11.0,-82
"Roane County, WV",WV,2011,5401,4721,680,12.6,-103
"Roane County, WV",WV,2010,5504,4753,751,13.6,0
"Roanoke city, VA",VA,2021,47664,45355,2309,4.8,-1666
"Roanoke city, VA",VA,2020,49330,45554,3776,7.7,-336
"Roanoke city, VA",VA,2019,49666,48170,1496,3.0,300
"Roanoke city, VA",VA,2018,49366,47784,1582,3.2,-55
"Roanoke city, VA",VA,2017,49421,47397,2024,4.1,424
"Roanoke city, VA",VA,2016,48997,46924,2073,4.2,-99
"Roanoke city, VA",VA,2015,49096,46728,2368,4.8,-1160
"Roanoke city, VA",VA,2014,50256,47364,2892,5.8,479
"Roanoke city, VA",VA,2013,49777,46540,3237,6.5,214
"Roanoke city, VA",VA,2012,49563,46064,3499,7.1,169
"Roanoke city, VA",VA,2011,49394,45430,3964,8.0,20
"Roanoke city, VA",VA,2010,49374,45000,4374,8.9,0
"Roanoke County, VA",VA,2021,47898,46394,1504,3.1,-1188
"Roanoke County, VA",VA,2020,49086,46600,2486,5.1,-1234
"Roanoke County, VA",VA,2019,50320,49061,1259,2.5,760
"Roanoke County, VA",VA,2018,49560,48227,1333,2.7,192
"Roanoke County, VA",VA,2017,49368,47703,1665,3.4,162
"Roanoke County, VA",VA,2016,49206,47475,1731,3.5,-67
"Roanoke County, VA",VA,2015,49273,47365,1908,3.9,-888
"Roanoke County, VA",VA,2014,50161,47911,2250,4.5,313
"Roanoke County, VA",VA,2013,49848,47408,2440,4.9,344
"Roanoke County, VA",VA,2012,49504,46965,2539,5.1,-144
"Roanoke County, VA",VA,2011,49648,46833,2815,5.7,331
"Roanoke County, VA",VA,2010,49317,46114,3203,6.5,0
"Roberts County, SD",SD,2021,4726,4509,217,4.6,-71
"Roberts County, SD",SD,2020,4797,4511,286,6.0,2
"Roberts County, SD",SD,2019,4795,4619,176,3.7,-21
"Roberts County, SD",SD,2018,4816,4625,191,4.0,7
"Roberts County, SD",SD,2017,4809,4595,214,4.4,-56
"Roberts County, SD",SD,2016,4865,4663,202,4.2,-30
"Roberts County, SD",SD,2015,4895,4686,209,4.3,4
"Roberts County, SD",SD,2014,4891,4662,229,4.7,22
"Roberts County, SD",SD,2013,4869,4621,248,5.1,-101
"Roberts County, SD",SD,2012,4970,4700,270,5.4,-113
"Roberts County, SD",SD,2011,5083,4751,332,6.5,8
"Roberts County, SD",SD,2010,5075,4785,290,5.7,0
"Roberts County, TX",TX,2021,399,382,17,4.3,0
"Roberts County, TX",TX,2020,399,381,18,4.5,-13
"Roberts County, TX",TX,2019,412,400,12,2.9,-12
"Roberts County, TX",TX,2018,424,412,12,2.8,-14
"Roberts County, TX",TX,2017,438,421,17,3.9,-4
"Roberts County, TX",TX,2016,442,422,20,4.5,-14
"Roberts County, TX",TX,2015,456,438,18,3.9,6
"Roberts County, TX",TX,2014,450,433,17,3.8,1
"Roberts County, TX",TX,2013,449,429,20,4.5,-21
"Roberts County, TX",TX,2012,470,447,23,4.9,-9
"Roberts County, TX",TX,2011,479,455,24,5.0,-2
"Roberts County, TX",TX,2010,481,455,26,5.4,0
"Robertson County, KY",KY,2021,801,767,34,4.2,14
"Robertson County, KY",KY,2020,787,741,46,5.8,-25
"Robertson County, KY",KY,2019,812,770,42,5.2,11
"Robertson County, KY",KY,2018,801,763,38,4.7,-17
"Robertson County, KY",KY,2017,818,768,50,6.1,13
"Robertson County, KY",KY,2016,805,756,49,6.1,24
"Robertson County, KY",KY,2015,781,730,51,6.5,-29
"Robertson County, KY",KY,2014,810,747,63,7.8,-38
"Robertson County, KY",KY,2013,848,756,92,10.8,-3
"Robertson County, KY",KY,2012,851,762,89,10.5,-11
"Robertson County, KY",KY,2011,862,766,96,11.1,-11
"Robertson County, KY",KY,2010,873,771,102,11.7,0
"Robertson County, TN",TN,2021,38067,36806,1261,3.3,859
"Robertson County, TN",TN,2020,37208,34951,2257,6.1,-1134
"Robertson County, TN",TN,2019,38342,37230,1112,2.9,1173
"Robertson County, TN",TN,2018,37169,36000,1169,3.1,1161
"Robertson County, TN",TN,2017,36008,34776,1232,3.4,1228
"Robertson County, TN",TN,2016,34780,33328,1452,4.2,889
"Robertson County, TN",TN,2015,33891,32250,1641,4.8,330
"Robertson County, TN",TN,2014,33561,31648,1913,5.7,-134
"Robertson County, TN",TN,2013,33695,31425,2270,6.7,3
"Robertson County, TN",TN,2012,33692,31281,2411,7.2,-350
"Robertson County, TN",TN,2011,34042,31137,2905,8.5,253
"Robertson County, TN",TN,2010,33789,30620,3169,9.4,0
"Robertson County, TX",TX,2021,7557,7159,398,5.3,300
"Robertson County, TX",TX,2020,7257,6791,466,6.4,-122
"Robertson County, TX",TX,2019,7379,7112,267,3.6,-85
"Robertson County, TX",TX,2018,7464,7150,314,4.2,72
"Robertson County, TX",TX,2017,7392,7040,352,4.8,134
"Robertson County, TX",TX,2016,7258,6890,368,5.1,7
"Robertson County, TX",TX,2015,7251,6903,348,4.8,113
"Robertson County, TX",TX,2014,7138,6749,389,5.4,-136
"Robertson County, TX",TX,2013,7274,6761,513,7.1,2
"Robertson County, TX",TX,2012,7272,6691,581,8.0,-272
"Robertson County, TX",TX,2011,7544,6829,715,9.5,-28
"Robertson County, TX",TX,2010,7572,6871,701,9.3,0
"Robeson County, NC",NC,2021,48147,44504,3643,7.6,-109
"Robeson County, NC",NC,2020,48256,44128,4128,8.6,-1609
"Robeson County, NC",NC,2019,49865,47249,2616,5.2,851
"Robeson County, NC",NC,2018,49014,46101,2913,5.9,-461
"Robeson County, NC",NC,2017,49475,46252,3223,6.5,-926
"Robeson County, NC",NC,2016,50401,46394,4007,8.0,-577
"Robeson County, NC",NC,2015,50978,46709,4269,8.4,-96
"Robeson County, NC",NC,2014,51074,46378,4696,9.2,-1065
"Robeson County, NC",NC,2013,52139,46133,6006,11.5,-1189
"Robeson County, NC",NC,2012,53328,46099,7229,13.6,-425
"Robeson County, NC",NC,2011,53753,46111,7642,14.2,-276
"Robeson County, NC",NC,2010,54029,46706,7323,13.6,0
"Rock County, MN",MN,2021,5801,5691,110,1.9,-63
"Rock County, MN",MN,2020,5864,5679,185,3.2,159
"Rock County, MN",MN,2019,5705,5566,139,2.4,-15
"Rock County, MN",MN,2018,5720,5579,141,2.5,-179
"Rock County, MN",MN,2017,5899,5774,125,2.1,-8
"Rock County, MN",MN,2016,5907,5770,137,2.3,-13
"Rock County, MN",MN,2015,5920,5792,128,2.2,238
"Rock County, MN",MN,2014,5682,5535,147,2.6,51
"Rock County, MN",MN,2013,5631,5448,183,3.2,79
"Rock County, MN",MN,2012,5552,5348,204,3.7,-76
"Rock County, MN",MN,2011,5628,5390,238,4.2,248
"Rock County, MN",MN,2010,5380,5107,273,5.1,0
"Rock County, NE",NE,2021,890,878,12,1.3,1
"Rock County, NE",NE,2020,889,871,18,2.0,8
"Rock County, NE",NE,2019,881,854,27,3.1,-15
"Rock County, NE",NE,2018,896,874,22,2.5,-17
"Rock County, NE",NE,2017,913,889,24,2.6,17
"Rock County, NE",NE,2016,896,873,23,2.6,34
"Rock County, NE",NE,2015,862,839,23,2.7,-22
"Rock County, NE",NE,2014,884,861,23,2.6,0
"Rock County, NE",NE,2013,884,857,27,3.1,5
"Rock County, NE",NE,2012,879,857,22,2.5,-21
"Rock County, NE",NE,2011,900,876,24,2.7,10
"Rock County, NE",NE,2010,890,864,26,2.9,0
"Rock County, WI",WI,2021,86855,82991,3864,4.4,891
"Rock County, WI",WI,2020,85964,79829,6135,7.1,103
"Rock County, WI",WI,2019,85861,82813,3048,3.5,586
"Rock County, WI",WI,2018,85275,82522,2753,3.2,-238
"Rock County, WI",WI,2017,85513,82375,3138,3.7,1629
"Rock County, WI",WI,2016,83884,80279,3605,4.3,762
"Rock County, WI",WI,2015,83122,78910,4212,5.1,941
"Rock County, WI",WI,2014,82181,77215,4966,6.0,43
"Rock County, WI",WI,2013,82138,75851,6287,7.7,832
"Rock County, WI",WI,2012,81306,74650,6656,8.2,356
"Rock County, WI",WI,2011,80950,73427,7523,9.3,-1758
"Rock County, WI",WI,2010,82708,73550,9158,11.1,0
"Rock Island County, IL",IL,2021,67709,63924,3785,5.6,-780
"Rock Island County, IL",IL,2020,68489,61912,6577,9.6,-2506
"Rock Island County, IL",IL,2019,70995,67620,3375,4.8,-534
"Rock Island County, IL",IL,2018,71529,67823,3706,5.2,206
"Rock Island County, IL",IL,2017,71323,67677,3646,5.1,-1064
"Rock Island County, IL",IL,2016,72387,67847,4540,6.3,-321
"Rock Island County, IL",IL,2015,72708,68066,4642,6.4,-197
"Rock Island County, IL",IL,2014,72905,67727,5178,7.1,-903
"Rock Island County, IL",IL,2013,73808,67713,6095,8.3,-1498
"Rock Island County, IL",IL,2012,75306,69246,6060,8.0,-931
"Rock Island County, IL",IL,2011,76237,69763,6474,8.5,-175
"Rock Island County, IL",IL,2010,76412,69113,7299,9.6,0
"Rockbridge County, VA",VA,2021,10381,9998,383,3.7,-57
"Rockbridge County, VA",VA,2020,10438,9866,572,5.5,-502
"Rockbridge County, VA",VA,2019,10940,10646,294,2.7,266
"Rockbridge County, VA",VA,2018,10674,10357,317,3.0,2
"Rockbridge County, VA",VA,2017,10672,10235,437,4.1,197
"Rockbridge County, VA",VA,2016,10475,10024,451,4.3,112
"Rockbridge County, VA",VA,2015,10363,9882,481,4.6,29
"Rockbridge County, VA",VA,2014,10334,9794,540,5.2,-85
"Rockbridge County, VA",VA,2013,10419,9828,591,5.7,-333
"Rockbridge County, VA",VA,2012,10752,10110,642,6.0,-241
"Rockbridge County, VA",VA,2011,10993,10249,744,6.8,-165
"Rockbridge County, VA",VA,2010,11158,10297,861,7.7,0
"Rockcastle County, KY",KY,2021,6457,6137,320,5.0,86
"Rockcastle County, KY",KY,2020,6371,5918,453,7.1,-291
"Rockcastle County, KY",KY,2019,6662,6358,304,4.6,31
"Rockcastle County, KY",KY,2018,6631,6309,322,4.9,6
"Rockcastle County, KY",KY,2017,6625,6247,378,5.7,-58
"Rockcastle County, KY",KY,2016,6683,6280,403,6.0,-189
"Rockcastle County, KY",KY,2015,6872,6438,434,6.3,-17
"Rockcastle County, KY",KY,2014,6889,6371,518,7.5,-196
"Rockcastle County, KY",KY,2013,7085,6434,651,9.2,-110
"Rockcastle County, KY",KY,2012,7195,6457,738,10.3,-15
"Rockcastle County, KY",KY,2011,7210,6387,823,11.4,145
"Rockcastle County, KY",KY,2010,7065,6266,799,11.3,0
"Rockdale County, GA",GA,2021,44591,42529,2062,4.6,976
"Rockdale County, GA",GA,2020,43615,40322,3293,7.6,-1034
"Rockdale County, GA",GA,2019,44649,42863,1786,4.0,-20
"Rockdale County, GA",GA,2018,44669,42670,1999,4.5,-172
"Rockdale County, GA",GA,2017,44841,42450,2391,5.3,1587
"Rockdale County, GA",GA,2016,43254,40714,2540,5.9,1461
"Rockdale County, GA",GA,2015,41793,39019,2774,6.6,-179
"Rockdale County, GA",GA,2014,41972,38661,3311,7.9,-151
"Rockdale County, GA",GA,2013,42123,38294,3829,9.1,138
"Rockdale County, GA",GA,2012,41985,37768,4217,10.0,-172
"Rockdale County, GA",GA,2011,42157,37477,4680,11.1,86
"Rockdale County, GA",GA,2010,42071,37256,4815,11.4,0
"Rockingham County, NC",NC,2021,38593,36458,2135,5.5,447
"Rockingham County, NC",NC,2020,38146,35071,3075,8.1,-1589
"Rockingham County, NC",NC,2019,39735,38011,1724,4.3,188
"Rockingham County, NC",NC,2018,39547,37711,1836,4.6,-442
"Rockingham County, NC",NC,2017,39989,37913,2076,5.2,-738
"Rockingham County, NC",NC,2016,40727,38423,2304,5.7,-347
"Rockingham County, NC",NC,2015,41074,38388,2686,6.5,-29
"Rockingham County, NC",NC,2014,41103,38116,2987,7.3,-1107
"Rockingham County, NC",NC,2013,42210,38236,3974,9.4,-1214
"Rockingham County, NC",NC,2012,43424,38417,5007,11.5,-374
"Rockingham County, NC",NC,2011,43798,38417,5381,12.3,-561
"Rockingham County, NC",NC,2010,44359,38557,5802,13.1,0
"Rockingham County, NH",NH,2021,185013,178612,6401,3.5,-886
"Rockingham County, NH",NH,2020,185899,172685,13214,7.1,-3429
"Rockingham County, NH",NH,2019,189328,184075,5253,2.8,2843
"Rockingham County, NH",NH,2018,186485,181129,5356,2.9,2467
"Rockingham County, NH",NH,2017,184018,178435,5583,3.0,2093
"Rockingham County, NH",NH,2016,181925,176410,5515,3.0,2903
"Rockingham County, NH",NH,2015,179022,172520,6502,3.6,1965
"Rockingham County, NH",NH,2014,177057,168833,8224,4.6,897
"Rockingham County, NH",NH,2013,176160,166282,9878,5.6,1472
"Rockingham County, NH",NH,2012,174688,164616,10072,5.8,2449
"Rockingham County, NH",NH,2011,172239,162489,9750,5.7,-375
"Rockingham County, NH",NH,2010,172614,161814,10800,6.3,0
"Rockingham County, VA",VA,2021,41368,40151,1217,2.9,-409
"Rockingham County, VA",VA,2020,41777,39820,1957,4.7,-1297
"Rockingham County, VA",VA,2019,43074,42064,1010,2.3,1577
"Rockingham County, VA",VA,2018,41497,40401,1096,2.6,514
"Rockingham County, VA",VA,2017,40983,39664,1319,3.2,367
"Rockingham County, VA",VA,2016,40616,39212,1404,3.5,343
"Rockingham County, VA",VA,2015,40273,38639,1634,4.1,-251
"Rockingham County, VA",VA,2014,40524,38662,1862,4.6,-116
"Rockingham County, VA",VA,2013,40640,38627,2013,5.0,-176
"Rockingham County, VA",VA,2012,40816,38549,2267,5.6,-436
"Rockingham County, VA",VA,2011,41252,38769,2483,6.0,825
"Rockingham County, VA",VA,2010,40427,37637,2790,6.9,0
"Rockland County, NY",NY,2021,153829,147064,6765,4.4,-2013
"Rockland County, NY",NY,2020,155842,143862,11980,7.7,-3697
"Rockland County, NY",NY,2019,159539,154087,5452,3.4,1769
"Rockland County, NY",NY,2018,157770,151936,5834,3.7,1390
"Rockland County, NY",NY,2017,156380,149629,6751,4.3,3819
"Rockland County, NY",NY,2016,152561,146064,6497,4.3,638
"Rockland County, NY",NY,2015,151923,144999,6924,4.6,2766
"Rockland County, NY",NY,2014,149157,141405,7752,5.2,-1414
"Rockland County, NY",NY,2013,150571,140889,9682,6.4,346
"Rockland County, NY",NY,2012,150225,139075,11150,7.4,1125
"Rockland County, NY",NY,2011,149100,138351,10749,7.2,-1009
"Rockland County, NY",NY,2010,150109,138686,11423,7.6,0
"Rockwall County, TX",TX,2021,56678,54240,2438,4.3,2416
"Rockwall County, TX",TX,2020,54262,51050,3212,5.9,1404
"Rockwall County, TX",TX,2019,52858,51236,1622,3.1,2424
"Rockwall County, TX",TX,2018,50434,48793,1641,3.3,1827
"Rockwall County, TX",TX,2017,48607,46960,1647,3.4,1240
"Rockwall County, TX",TX,2016,47367,45704,1663,3.5,2452
"Rockwall County, TX",TX,2015,44915,43216,1699,3.8,1566
"Rockwall County, TX",TX,2014,43349,41366,1983,4.6,1160
"Rockwall County, TX",TX,2013,42189,39743,2446,5.8,1093
"Rockwall County, TX",TX,2012,41096,38572,2524,6.1,505
"Rockwall County, TX",TX,2011,40591,37619,2972,7.3,1095
"Rockwall County, TX",TX,2010,39496,36559,2937,7.4,0
"Roger Mills County, OK",OK,2021,1802,1750,52,2.9,29
"Roger Mills County, OK",OK,2020,1773,1682,91,5.1,-75
"Roger Mills County, OK",OK,2019,1848,1796,52,2.8,-23
"Roger Mills County, OK",OK,2018,1871,1828,43,2.3,-5
"Roger Mills County, OK",OK,2017,1876,1818,58,3.1,67
"Roger Mills County, OK",OK,2016,1809,1719,90,5.0,-28
"Roger Mills County, OK",OK,2015,1837,1761,76,4.1,41
"Roger Mills County, OK",OK,2014,1796,1747,49,2.7,-81
"Roger Mills County, OK",OK,2013,1877,1819,58,3.1,-221
"Roger Mills County, OK",OK,2012,2098,2040,58,2.8,199
"Roger Mills County, OK",OK,2011,1899,1841,58,3.1,103
"Roger Mills County, OK",OK,2010,1796,1717,79,4.4,0
"Rogers County, OK",OK,2021,44863,43285,1578,3.5,254
"Rogers County, OK",OK,2020,44609,41984,2625,5.9,-548
"Rogers County, OK",OK,2019,45157,43840,1317,2.9,411
"Rogers County, OK",OK,2018,44746,43327,1419,3.2,316
"Rogers County, OK",OK,2017,44430,42580,1850,4.2,-398
"Rogers County, OK",OK,2016,44828,42659,2169,4.8,250
"Rogers County, OK",OK,2015,44578,42672,1906,4.3,887
"Rogers County, OK",OK,2014,43691,41917,1774,4.1,-77
"Rogers County, OK",OK,2013,43768,41603,2165,4.9,150
"Rogers County, OK",OK,2012,43618,41514,2104,4.8,686
"Rogers County, OK",OK,2011,42932,40590,2342,5.5,-381
"Rogers County, OK",OK,2010,43313,40460,2853,6.6,0
"Rolette County, ND",ND,2021,4780,4271,509,10.6,-24
"Rolette County, ND",ND,2020,4804,4154,650,13.5,142
"Rolette County, ND",ND,2019,4662,4317,345,7.4,-75
"Rolette County, ND",ND,2018,4737,4329,408,8.6,-143
"Rolette County, ND",ND,2017,4880,4380,500,10.2,-97
"Rolette County, ND",ND,2016,4977,4437,540,10.8,127
"Rolette County, ND",ND,2015,4850,4349,501,10.3,120
"Rolette County, ND",ND,2014,4730,4199,531,11.2,-107
"Rolette County, ND",ND,2013,4837,4243,594,12.3,-141
"Rolette County, ND",ND,2012,4978,4473,505,10.1,-148
"Rolette County, ND",ND,2011,5126,4582,544,10.6,-169
"Rolette County, ND",ND,2010,5295,4728,567,10.7,0
"Rooks County, KS",KS,2021,2437,2378,59,2.4,-64
"Rooks County, KS",KS,2020,2501,2406,95,3.8,-41
"Rooks County, KS",KS,2019,2542,2454,88,3.5,13
"Rooks County, KS",KS,2018,2529,2450,79,3.1,25
"Rooks County, KS",KS,2017,2504,2409,95,3.8,-177
"Rooks County, KS",KS,2016,2681,2555,126,4.7,-136
"Rooks County, KS",KS,2015,2817,2688,129,4.6,-37
"Rooks County, KS",KS,2014,2854,2752,102,3.6,69
"Rooks County, KS",KS,2013,2785,2669,116,4.2,7
"Rooks County, KS",KS,2012,2778,2649,129,4.6,38
"Rooks County, KS",KS,2011,2740,2596,144,5.3,-27
"Rooks County, KS",KS,2010,2767,2595,172,6.2,0
"Roosevelt County, MT",MT,2021,4330,4146,184,4.2,-119
"Roosevelt County, MT",MT,2020,4449,4188,261,5.9,-120
"Roosevelt County, MT",MT,2019,4569,4368,201,4.4,60
"Roosevelt County, MT",MT,2018,4509,4303,206,4.6,-90
"Roosevelt County, MT",MT,2017,4599,4382,217,4.7,-88
"Roosevelt County, MT",MT,2016,4687,4428,259,5.5,-9
"Roosevelt County, MT",MT,2015,4696,4443,253,5.4,-126
"Roosevelt County, MT",MT,2014,4822,4573,249,5.2,-103
"Roosevelt County, MT",MT,2013,4925,4657,268,5.4,105
"Roosevelt County, MT",MT,2012,4820,4512,308,6.4,193
"Roosevelt County, MT",MT,2011,4627,4314,313,6.8,40
"Roosevelt County, MT",MT,2010,4587,4276,311,6.8,0
"Roosevelt County, NM",NM,2021,7904,7465,439,5.6,80
"Roosevelt County, NM",NM,2020,7824,7358,466,6.0,-112
"Roosevelt County, NM",NM,2019,7936,7577,359,4.5,36
"Roosevelt County, NM",NM,2018,7900,7559,341,4.3,-182
"Roosevelt County, NM",NM,2017,8082,7667,415,5.1,-48
"Roosevelt County, NM",NM,2016,8130,7661,469,5.8,35
"Roosevelt County, NM",NM,2015,8095,7652,443,5.5,-75
"Roosevelt County, NM",NM,2014,8170,7723,447,5.5,-222
"Roosevelt County, NM",NM,2013,8392,7926,466,5.6,34
"Roosevelt County, NM",NM,2012,8358,7900,458,5.5,73
"Roosevelt County, NM",NM,2011,8285,7830,455,5.5,-64
"Roosevelt County, NM",NM,2010,8349,7850,499,6.0,0
"Roscommon County, MI",MI,2021,7388,6679,709,9.6,-352
"Roscommon County, MI",MI,2020,7740,6752,988,12.8,-36
"Roscommon County, MI",MI,2019,7776,7185,591,7.6,-86
"Roscommon County, MI",MI,2018,7862,7245,617,7.8,25
"Roscommon County, MI",MI,2017,7837,7155,682,8.7,-57
"Roscommon County, MI",MI,2016,7894,7219,675,8.6,45
"Roscommon County, MI",MI,2015,7849,7131,718,9.1,-126
"Roscommon County, MI",MI,2014,7975,7059,916,11.5,-131
"Roscommon County, MI",MI,2013,8106,6991,1115,13.8,-22
"Roscommon County, MI",MI,2012,8128,7048,1080,13.3,-219
"Roscommon County, MI",MI,2011,8347,7159,1188,14.2,-209
"Roscommon County, MI",MI,2010,8556,7172,1384,16.2,0
"Roseau County, MN",MN,2021,7748,7521,227,2.9,-226
"Roseau County, MN",MN,2020,7974,7504,470,5.9,46
"Roseau County, MN",MN,2019,7928,7601,327,4.1,0
"Roseau County, MN",MN,2018,7928,7643,285,3.6,-250
"Roseau County, MN",MN,2017,8178,7776,402,4.9,-66
"Roseau County, MN",MN,2016,8244,7822,422,5.1,-379
"Roseau County, MN",MN,2015,8623,8273,350,4.1,-208
"Roseau County, MN",MN,2014,8831,8499,332,3.8,209
"Roseau County, MN",MN,2013,8622,8237,385,4.5,75
"Roseau County, MN",MN,2012,8547,8140,407,4.8,0
"Roseau County, MN",MN,2011,8547,8087,460,5.4,-145
"Roseau County, MN",MN,2010,8692,8134,558,6.4,0
"Rosebud County, MT",MT,2021,3575,3432,143,4.0,-167
"Rosebud County, MT",MT,2020,3742,3535,207,5.5,-135
"Rosebud County, MT",MT,2019,3877,3678,199,5.1,-23
"Rosebud County, MT",MT,2018,3900,3693,207,5.3,-149
"Rosebud County, MT",MT,2017,4049,3837,212,5.2,-58
"Rosebud County, MT",MT,2016,4107,3874,233,5.7,-73
"Rosebud County, MT",MT,2015,4180,3950,230,5.5,4
"Rosebud County, MT",MT,2014,4176,3940,236,5.7,-27
"Rosebud County, MT",MT,2013,4203,3937,266,6.3,-250
"Rosebud County, MT",MT,2012,4453,4160,293,6.6,11
"Rosebud County, MT",MT,2011,4442,4133,309,7.0,81
"Rosebud County, MT",MT,2010,4361,4061,300,6.9,0
"Ross County, OH",OH,2021,35174,33475,1699,4.8,-12
"Ross County, OH",OH,2020,35186,32371,2815,8.0,-397
"Ross County, OH",OH,2019,35583,34074,1509,4.2,615
"Ross County, OH",OH,2018,34968,33388,1580,4.5,556
"Ross County, OH",OH,2017,34412,32651,1761,5.1,439
"Ross County, OH",OH,2016,33973,32087,1886,5.6,146
"Ross County, OH",OH,2015,33827,31996,1831,5.4,78
"Ross County, OH",OH,2014,33749,31592,2157,6.4,268
"Ross County, OH",OH,2013,33481,30579,2902,8.7,-573
"Ross County, OH",OH,2012,34054,31195,2859,8.4,-162
"Ross County, OH",OH,2011,34216,30817,3399,9.9,83
"Ross County, OH",OH,2010,34133,30052,4081,12.0,0
"Routt County, CO",CO,2021,16024,15343,681,4.2,101
"Routt County, CO",CO,2020,15923,14729,1194,7.5,-252
"Routt County, CO",CO,2019,16175,15843,332,2.1,97
"Routt County, CO",CO,2018,16078,15678,400,2.5,657
"Routt County, CO",CO,2017,15421,15080,341,2.2,509
"Routt County, CO",CO,2016,14912,14539,373,2.5,630
"Routt County, CO",CO,2015,14282,13835,447,3.1,-96
"Routt County, CO",CO,2014,14378,13782,596,4.1,-110
"Routt County, CO",CO,2013,14488,13642,846,5.8,159
"Routt County, CO",CO,2012,14329,13285,1044,7.3,74
"Routt County, CO",CO,2011,14255,13039,1216,8.5,-242
"Routt County, CO",CO,2010,14497,13089,1408,9.7,0
"Rowan County, KY",KY,2021,9943,9417,526,5.3,-23
"Rowan County, KY",KY,2020,9966,9246,720,7.2,-440
"Rowan County, KY",KY,2019,10406,9885,521,5.0,-113
"Rowan County, KY",KY,2018,10519,9989,530,5.0,-137
"Rowan County, KY",KY,2017,10656,10050,606,5.7,82
"Rowan County, KY",KY,2016,10574,9955,619,5.9,284
"Rowan County, KY",KY,2015,10290,9685,605,5.9,-267
"Rowan County, KY",KY,2014,10557,9824,733,6.9,-374
"Rowan County, KY",KY,2013,10931,10031,900,8.2,-264
"Rowan County, KY",KY,2012,11195,10257,938,8.4,-71
"Rowan County, KY",KY,2011,11266,10196,1070,9.5,297
"Rowan County, KY",KY,2010,10969,9848,1121,10.2,0
"Rowan County, NC",NC,2021,64309,61070,3239,5.0,1232
"Rowan County, NC",NC,2020,63077,58194,4883,7.7,-1954
"Rowan County, NC",NC,2019,65031,62431,2600,4.0,960
"Rowan County, NC",NC,2018,64071,61473,2598,4.1,241
"Rowan County, NC",NC,2017,63830,60827,3003,4.7,-205
"Rowan County, NC",NC,2016,64035,60466,3569,5.6,1009
"Rowan County, NC",NC,2015,63026,59235,3791,6.0,600
"Rowan County, NC",NC,2014,62426,58148,4278,6.9,-480
"Rowan County, NC",NC,2013,62906,57235,5671,9.0,-976
"Rowan County, NC",NC,2012,63882,56768,7114,11.1,40
"Rowan County, NC",NC,2011,63842,55898,7944,12.4,-696
"Rowan County, NC",NC,2010,64538,55548,8990,13.9,0
"Runnels County, TX",TX,2021,4618,4430,188,4.1,123
"Runnels County, TX",TX,2020,4495,4274,221,4.9,-48
"Runnels County, TX",TX,2019,4543,4416,127,2.8,10
"Runnels County, TX",TX,2018,4533,4389,144,3.2,-13
"Runnels County, TX",TX,2017,4546,4377,169,3.7,-103
"Runnels County, TX",TX,2016,4649,4465,184,4.0,-24
"Runnels County, TX",TX,2015,4673,4498,175,3.7,-291
"Runnels County, TX",TX,2014,4964,4751,213,4.3,-5
"Runnels County, TX",TX,2013,4969,4705,264,5.3,-79
"Runnels County, TX",TX,2012,5048,4771,277,5.5,-58
"Runnels County, TX",TX,2011,5106,4719,387,7.6,-30
"Runnels County, TX",TX,2010,5136,4707,429,8.4,0
"Rush County, IN",IN,2021,8755,8511,244,2.8,-11
"Rush County, IN",IN,2020,8766,8213,553,6.3,-286
"Rush County, IN",IN,2019,9052,8814,238,2.6,2
"Rush County, IN",IN,2018,9050,8794,256,2.8,118
"Rush County, IN",IN,2017,8932,8662,270,3.0,-55
"Rush County, IN",IN,2016,8987,8654,333,3.7,150
"Rush County, IN",IN,2015,8837,8457,380,4.3,303
"Rush County, IN",IN,2014,8534,8056,478,5.6,185
"Rush County, IN",IN,2013,8349,7742,607,7.3,-35
"Rush County, IN",IN,2012,8384,7682,702,8.4,-221
"Rush County, IN",IN,2011,8605,7800,805,9.4,-80
"Rush County, IN",IN,2010,8685,7741,944,10.9,0
"Rush County, KS",KS,2021,1583,1545,38,2.4,11
"Rush County, KS",KS,2020,1572,1502,70,4.5,-65
"Rush County, KS",KS,2019,1637,1592,45,2.7,-22
"Rush County, KS",KS,2018,1659,1615,44,2.7,1
"Rush County, KS",KS,2017,1658,1605,53,3.2,-82
"Rush County, KS",KS,2016,1740,1671,69,4.0,-60
"Rush County, KS",KS,2015,1800,1737,63,3.5,-11
"Rush County, KS",KS,2014,1811,1747,64,3.5,-3
"Rush County, KS",KS,2013,1814,1736,78,4.3,-84
"Rush County, KS",KS,2012,1898,1810,88,4.6,48
"Rush County, KS",KS,2011,1850,1770,80,4.3,57
"Rush County, KS",KS,2010,1793,1698,95,5.3,0
"Rusk County, TX",TX,2021,22047,20721,1326,6.0,247
"Rusk County, TX",TX,2020,21800,20199,1601,7.3,-825
"Rusk County, TX",TX,2019,22625,21814,811,3.6,75
"Rusk County, TX",TX,2018,22550,21624,926,4.1,588
"Rusk County, TX",TX,2017,21962,20838,1124,5.1,-420
"Rusk County, TX",TX,2016,22382,21076,1306,5.8,-471
"Rusk County, TX",TX,2015,22853,21758,1095,4.8,-1319
"Rusk County, TX",TX,2014,24172,22965,1207,5.0,-91
"Rusk County, TX",TX,2013,24263,22744,1519,6.3,-269
"Rusk County, TX",TX,2012,24532,23000,1532,6.2,259
"Rusk County, TX",TX,2011,24273,22505,1768,7.3,277
"Rusk County, TX",TX,2010,23996,22112,1884,7.9,0
"Rusk County, WI",WI,2021,6633,6340,293,4.4,10
"Rusk County, WI",WI,2020,6623,6181,442,6.7,-123
"Rusk County, WI",WI,2019,6746,6433,313,4.6,-232
"Rusk County, WI",WI,2018,6978,6703,275,3.9,-30
"Rusk County, WI",WI,2017,7008,6700,308,4.4,25
"Rusk County, WI",WI,2016,6983,6634,349,5.0,5
"Rusk County, WI",WI,2015,6978,6605,373,5.3,-7
"Rusk County, WI",WI,2014,6985,6534,451,6.5,254
"Rusk County, WI",WI,2013,6731,6161,570,8.5,-41
"Rusk County, WI",WI,2012,6772,6169,603,8.9,-93
"Rusk County, WI",WI,2011,6865,6125,740,10.8,-275
"Rusk County, WI",WI,2010,7140,6278,862,12.1,0
"Russell County, AL",AL,2021,23281,22566,715,3.1,-538
"Russell County, AL",AL,2020,23819,22447,1372,5.8,-256
"Russell County, AL",AL,2019,24075,23324,751,3.1,-204
"Russell County, AL",AL,2018,24279,23308,971,4.0,619
"Russell County, AL",AL,2017,23660,22613,1047,4.4,322
"Russell County, AL",AL,2016,23338,22038,1300,5.6,-713
"Russell County, AL",AL,2015,24051,22614,1437,6.0,-761
"Russell County, AL",AL,2014,24812,23197,1615,6.5,-187
"Russell County, AL",AL,2013,24999,23160,1839,7.4,54
"Russell County, AL",AL,2012,24945,22697,2248,9.0,344
"Russell County, AL",AL,2011,24601,22088,2513,10.2,773
"Russell County, AL",AL,2010,23828,21271,2557,10.7,0
"Russell County, KS",KS,2021,3361,3280,81,2.4,54
"Russell County, KS",KS,2020,3307,3175,132,4.0,-10
"Russell County, KS",KS,2019,3317,3222,95,2.9,-64
"Russell County, KS",KS,2018,3381,3284,97,2.9,-139
"Russell County, KS",KS,2017,3520,3403,117,3.3,-69
"Russell County, KS",KS,2016,3589,3439,150,4.2,-155
"Russell County, KS",KS,2015,3744,3604,140,3.7,-99
"Russell County, KS",KS,2014,3843,3709,134,3.5,-15
"Russell County, KS",KS,2013,3858,3705,153,4.0,35
"Russell County, KS",KS,2012,3823,3667,156,4.1,20
"Russell County, KS",KS,2011,3803,3628,175,4.6,62
"Russell County, KS",KS,2010,3741,3553,188,5.0,0
"Russell County, KY",KY,2021,6118,5785,333,5.4,50
"Russell County, KY",KY,2020,6068,5582,486,8.0,-196
"Russell County, KY",KY,2019,6264,5925,339,5.4,-9
"Russell County, KY",KY,2018,6273,5919,354,5.6,16
"Russell County, KY",KY,2017,6257,5819,438,7.0,122
"Russell County, KY",KY,2016,6135,5626,509,8.3,-5
"Russell County, KY",KY,2015,6140,5425,715,11.6,-446
"Russell County, KY",KY,2014,6586,5914,672,10.2,-442
"Russell County, KY",KY,2013,7028,6223,805,11.5,-201
"Russell County, KY",KY,2012,7229,6478,751,10.4,-139
"Russell County, KY",KY,2011,7368,6506,862,11.7,30
"Russell County, KY",KY,2010,7338,6387,951,13.0,0
"Russell County, VA",VA,2021,10695,10233,462,4.3,-498
"Russell County, VA",VA,2020,11193,10453,740,6.6,-191
"Russell County, VA",VA,2019,11384,10914,470,4.1,89
"Russell County, VA",VA,2018,11295,10818,477,4.2,-248
"Russell County, VA",VA,2017,11543,10948,595,5.2,290
"Russell County, VA",VA,2016,11253,10538,715,6.4,-212
"Russell County, VA",VA,2015,11465,10723,742,6.5,157
"Russell County, VA",VA,2014,11308,10434,874,7.7,-290
"Russell County, VA",VA,2013,11598,10638,960,8.3,-160
"Russell County, VA",VA,2012,11758,10760,998,8.5,-166
"Russell County, VA",VA,2011,11924,10794,1130,9.5,-185
"Russell County, VA",VA,2010,12109,10839,1270,10.5,0
"Rutherford County, NC",NC,2021,24050,22494,1556,6.5,299
"Rutherford County, NC",NC,2020,23751,21603,2148,9.0,-1308
"Rutherford County, NC",NC,2019,25059,23855,1204,4.8,614
"Rutherford County, NC",NC,2018,24445,23182,1263,5.2,202
"Rutherford County, NC",NC,2017,24243,22771,1472,6.1,-490
"Rutherford County, NC",NC,2016,24733,23078,1655,6.7,-283
"Rutherford County, NC",NC,2015,25016,23097,1919,7.7,-420
"Rutherford County, NC",NC,2014,25436,23323,2113,8.3,-525
"Rutherford County, NC",NC,2013,25961,23137,2824,10.9,-1077
"Rutherford County, NC",NC,2012,27038,23385,3653,13.5,415
"Rutherford County, NC",NC,2011,26623,22748,3875,14.6,-436
"Rutherford County, NC",NC,2010,27059,22574,4485,16.6,0
"Rutherford County, TN",TN,2021,190190,183656,6534,3.4,3396
"Rutherford County, TN",TN,2020,186794,173859,12935,6.9,-951
"Rutherford County, TN",TN,2019,187745,182901,4844,2.6,7967
"Rutherford County, TN",TN,2018,179778,174943,4835,2.7,8030
"Rutherford County, TN",TN,2017,171748,166744,5004,2.9,8007
"Rutherford County, TN",TN,2016,163741,157663,6078,3.7,7812
"Rutherford County, TN",TN,2015,155929,148996,6933,4.4,5956
"Rutherford County, TN",TN,2014,149973,142096,7877,5.3,2434
"Rutherford County, TN",TN,2013,147539,138387,9152,6.2,2611
"Rutherford County, TN",TN,2012,144928,135335,9593,6.6,1212
"Rutherford County, TN",TN,2011,143716,132121,11595,8.1,3416
"Rutherford County, TN",TN,2010,140300,127659,12641,9.0,0
"Rutland County, VT",VT,2021,28966,27751,1215,4.2,-1340
"Rutland County, VT",VT,2020,30306,28274,2032,6.7,-1315
"Rutland County, VT",VT,2019,31621,30764,857,2.7,-126
"Rutland County, VT",VT,2018,31747,30770,977,3.1,-219
"Rutland County, VT",VT,2017,31966,30847,1119,3.5,412
"Rutland County, VT",VT,2016,31554,30405,1149,3.6,119
"Rutland County, VT",VT,2015,31435,30111,1324,4.2,-483
"Rutland County, VT",VT,2014,31918,30393,1525,4.8,-338
"Rutland County, VT",VT,2013,32256,30537,1719,5.3,-450
"Rutland County, VT",VT,2012,32706,30720,1986,6.1,-548
"Rutland County, VT",VT,2011,33254,30962,2292,6.9,-381
"Rutland County, VT",VT,2010,33635,31053,2582,7.7,0
"Sabana Grande Municipio, PR",PR,2021,6440,5789,651,10.1,
"Sabana Grande Municipio, PR",PR,2020,N.A.,N.A.,N.A.,N.A.,
"Sabana Grande Municipio, PR",PR,2019,6105,5307,798,13.1,-14
"Sabana Grande Municipio, PR",PR,2018,6119,5267,852,13.9,-250
"Sabana Grande Municipio, PR",PR,2017,6369,5296,1073,16.8,-77
"Sabana Grande Municipio, PR",PR,2016,6446,5424,1022,15.9,80
"Sabana Grande Municipio, PR",PR,2015,6366,5425,941,14.8,-142
"Sabana Grande Municipio, PR",PR,2014,6508,5288,1220,18.7,-204
"Sabana Grande Municipio, PR",PR,2013,6712,5287,1425,21.2,-320
"Sabana Grande Municipio, PR",PR,2012,7032,5563,1469,20.9,-201
"Sabana Grande Municipio, PR",PR,2011,7233,5661,1572,21.7,-299
"Sabana Grande Municipio, PR",PR,2010,7532,5908,1624,21.6,0
"Sabine County, TX",TX,2021,3965,3587,378,9.5,94
"Sabine County, TX",TX,2020,3871,3452,419,10.8,160
"Sabine County, TX",TX,2019,3711,3467,244,6.6,199
"Sabine County, TX",TX,2018,3512,3232,280,8.0,-36
"Sabine County, TX",TX,2017,3548,3241,307,8.7,64
"Sabine County, TX",TX,2016,3484,3157,327,9.4,-21
"Sabine County, TX",TX,2015,3505,3176,329,9.4,-35
"Sabine County, TX",TX,2014,3540,3161,379,10.7,-16
"Sabine County, TX",TX,2013,3556,3093,463,13.0,178
"Sabine County, TX",TX,2012,3378,2890,488,14.4,-92
"Sabine County, TX",TX,2011,3470,2908,562,16.2,-191
"Sabine County, TX",TX,2010,3661,3061,600,16.4,0
"Sabine Parish, LA",LA,2021,9271,8929,342,3.7,70
"Sabine Parish, LA",LA,2020,9201,8652,549,6.0,-58
"Sabine Parish, LA",LA,2019,9259,8806,453,4.9,197
"Sabine Parish, LA",LA,2018,9062,8599,463,5.1,221
"Sabine Parish, LA",LA,2017,8841,8355,486,5.5,-309
"Sabine Parish, LA",LA,2016,9150,8516,634,6.9,-289
"Sabine Parish, LA",LA,2015,9439,8769,670,7.1,268
"Sabine Parish, LA",LA,2014,9171,8582,589,6.4,-21
"Sabine Parish, LA",LA,2013,9192,8596,596,6.5,-63
"Sabine Parish, LA",LA,2012,9255,8641,614,6.6,-243
"Sabine Parish, LA",LA,2011,9498,8854,644,6.8,-171
"Sabine Parish, LA",LA,2010,9669,9006,663,6.9,0
"Sac County, IA",IA,2021,5209,5036,173,3.3,3
"Sac County, IA",IA,2020,5206,5026,180,3.5,-200
"Sac County, IA",IA,2019,5406,5285,121,2.2,36
"Sac County, IA",IA,2018,5370,5244,126,2.3,-23
"Sac County, IA",IA,2017,5393,5243,150,2.8,-130
"Sac County, IA",IA,2016,5523,5359,164,3.0,-119
"Sac County, IA",IA,2015,5642,5456,186,3.3,85
"Sac County, IA",IA,2014,5557,5339,218,3.9,35
"Sac County, IA",IA,2013,5522,5290,232,4.2,-3
"Sac County, IA",IA,2012,5525,5290,235,4.3,-116
"Sac County, IA",IA,2011,5641,5387,254,4.5,-59
"Sac County, IA",IA,2010,5700,5429,271,4.8,0
"Sacramento County, CA",CA,2021,714032,664353,49679,7.0,4319
"Sacramento County, CA",CA,2020,709713,641956,67757,9.5,-1751
"Sacramento County, CA",CA,2019,711464,684781,26683,3.8,7303
"Sacramento County, CA",CA,2018,704161,676667,27494,3.9,7695
"Sacramento County, CA",CA,2017,696466,663727,32739,4.7,2487
"Sacramento County, CA",CA,2016,693979,656360,37619,5.4,9402
"Sacramento County, CA",CA,2015,684577,643295,41282,6.0,6881
"Sacramento County, CA",CA,2014,677696,627615,50081,7.4,-135
"Sacramento County, CA",CA,2013,677831,616885,60946,9.0,-2042
"Sacramento County, CA",CA,2012,679873,607250,72623,10.7,879
"Sacramento County, CA",CA,2011,678994,595329,83665,12.3,-4835
"Sacramento County, CA",CA,2010,683829,595476,88353,12.9,0
"Sagadahoc County, ME",ME,2021,19159,18448,711,3.7,-87
"Sagadahoc County, ME",ME,2020,19246,18403,843,4.4,-496
"Sagadahoc County, ME",ME,2019,19742,19329,413,2.1,48
"Sagadahoc County, ME",ME,2018,19694,19203,491,2.5,140
"Sagadahoc County, ME",ME,2017,19554,19016,538,2.8,313
"Sagadahoc County, ME",ME,2016,19241,18673,568,3.0,183
"Sagadahoc County, ME",ME,2015,19058,18386,672,3.5,-19
"Sagadahoc County, ME",ME,2014,19077,18218,859,4.5,-15
"Sagadahoc County, ME",ME,2013,19092,18010,1082,5.7,-71
"Sagadahoc County, ME",ME,2012,19163,17946,1217,6.4,21
"Sagadahoc County, ME",ME,2011,19142,17875,1267,6.6,-139
"Sagadahoc County, ME",ME,2010,19281,17950,1331,6.9,0
"Saginaw County, MI",MI,2021,81321,75566,5755,7.1,-3102
"Saginaw County, MI",MI,2020,84423,75670,8753,10.4,-2424
"Saginaw County, MI",MI,2019,86847,82632,4215,4.9,-332
"Saginaw County, MI",MI,2018,87179,83005,4174,4.8,-539
"Saginaw County, MI",MI,2017,87718,83062,4656,5.3,-1044
"Saginaw County, MI",MI,2016,88762,83977,4785,5.4,11
"Saginaw County, MI",MI,2015,88751,83622,5129,5.8,-492
"Saginaw County, MI",MI,2014,89243,82552,6691,7.5,133
"Saginaw County, MI",MI,2013,89110,81122,7988,9.0,77
"Saginaw County, MI",MI,2012,89033,80916,8117,9.1,-496
"Saginaw County, MI",MI,2011,89529,80762,8767,9.8,-262
"Saginaw County, MI",MI,2010,89791,79123,10668,11.9,0
"Saguache County, CO",CO,2021,3496,3290,206,5.9,91
"Saguache County, CO",CO,2020,3405,3176,229,6.7,-108
"Saguache County, CO",CO,2019,3513,3379,134,3.8,16
"Saguache County, CO",CO,2018,3497,3345,152,4.3,93
"Saguache County, CO",CO,2017,3404,3264,140,4.1,178
"Saguache County, CO",CO,2016,3226,3075,151,4.7,151
"Saguache County, CO",CO,2015,3075,2893,182,5.9,72
"Saguache County, CO",CO,2014,3003,2742,261,8.7,54
"Saguache County, CO",CO,2013,2949,2622,327,11.1,-98
"Saguache County, CO",CO,2012,3047,2705,342,11.2,35
"Saguache County, CO",CO,2011,3012,2664,348,11.6,-47
"Saguache County, CO",CO,2010,3059,2734,325,10.6,0
"Salem city, VA",VA,2021,12390,11950,440,3.6,-355
"Salem city, VA",VA,2020,12745,12010,735,5.8,-292
"Salem city, VA",VA,2019,13037,12677,360,2.8,4
"Salem city, VA",VA,2018,13033,12649,384,2.9,-127
"Salem city, VA",VA,2017,13160,12674,486,3.7,251
"Salem city, VA",VA,2016,12909,12409,500,3.9,93
"Salem city, VA",VA,2015,12816,12258,558,4.4,-350
"Salem city, VA",VA,2014,13166,12499,667,5.1,114
"Salem city, VA",VA,2013,13052,12310,742,5.7,156
"Salem city, VA",VA,2012,12896,12145,751,5.8,82
"Salem city, VA",VA,2011,12814,12001,813,6.3,8
"Salem city, VA",VA,2010,12806,11904,902,7.0,0
"Salem County, NJ",NJ,2021,30386,28158,2228,7.3,-96
"Salem County, NJ",NJ,2020,30482,27661,2821,9.3,60
"Salem County, NJ",NJ,2019,30422,29024,1398,4.6,542
"Salem County, NJ",NJ,2018,29880,28308,1572,5.3,-311
"Salem County, NJ",NJ,2017,30191,28370,1821,6.0,118
"Salem County, NJ",NJ,2016,30073,28162,1911,6.4,-717
"Salem County, NJ",NJ,2015,30790,28554,2236,7.3,-274
"Salem County, NJ",NJ,2014,31064,28429,2635,8.5,-584
"Salem County, NJ",NJ,2013,31648,28280,3368,10.6,-459
"Salem County, NJ",NJ,2012,32107,28293,3814,11.9,-267
"Salem County, NJ",NJ,2011,32374,28599,3775,11.7,218
"Salem County, NJ",NJ,2010,32156,28352,3804,11.8,0
"Salinas Municipio, PR",PR,2021,7440,6664,776,10.4,
"Salinas Municipio, PR",PR,2020,N.A.,N.A.,N.A.,N.A.,
"Salinas Municipio, PR",PR,2019,7114,6081,1033,14.5,-35
"Salinas Municipio, PR",PR,2018,7149,6094,1055,14.8,-332
"Salinas Municipio, PR",PR,2017,7481,6080,1401,18.7,-87
"Salinas Municipio, PR",PR,2016,7568,5928,1640,21.7,-329
"Salinas Municipio, PR",PR,2015,7897,5992,1905,24.1,-415
"Salinas Municipio, PR",PR,2014,8312,6121,2191,26.4,-298
"Salinas Municipio, PR",PR,2013,8610,6374,2236,26.0,-368
"Salinas Municipio, PR",PR,2012,8978,6741,2237,24.9,-91
"Salinas Municipio, PR",PR,2011,9069,6704,2365,26.1,-105
"Salinas Municipio, PR",PR,2010,9174,6787,2387,26.0,0
"Saline County, AR",AR,2021,57900,56082,1818,3.1,-883
"Saline County, AR",AR,2020,58783,55813,2970,5.1,-771
"Saline County, AR",AR,2019,59554,57919,1635,2.7,890
"Saline County, AR",AR,2018,58664,56890,1774,3.0,1190
"Saline County, AR",AR,2017,57474,55729,1745,3.0,522
"Saline County, AR",AR,2016,56952,55170,1782,3.1,723
"Saline County, AR",AR,2015,56229,53970,2259,4.0,1190
"Saline County, AR",AR,2014,55039,52439,2600,4.7,-81
"Saline County, AR",AR,2013,55120,52011,3109,5.6,476
"Saline County, AR",AR,2012,54644,51443,3201,5.9,657
"Saline County, AR",AR,2011,53987,50565,3422,6.3,639
"Saline County, AR",AR,2010,53348,49934,3414,6.4,0
"Saline County, IL",IL,2021,9274,8661,613,6.6,-228
"Saline County, IL",IL,2020,9502,8559,943,9.9,-159
"Saline County, IL",IL,2019,9661,9173,488,5.1,-220
"Saline County, IL",IL,2018,9881,9246,635,6.4,98
"Saline County, IL",IL,2017,9783,9152,631,6.4,-309
"Saline County, IL",IL,2016,10092,9228,864,8.6,-275
"Saline County, IL",IL,2015,10367,9563,804,7.8,-401
"Saline County, IL",IL,2014,10768,9878,890,8.3,-501
"Saline County, IL",IL,2013,11269,10081,1188,10.5,-332
"Saline County, IL",IL,2012,11601,10541,1060,9.1,-50
"Saline County, IL",IL,2011,11651,10542,1109,9.5,36
"Saline County, IL",IL,2010,11615,10421,1194,10.3,0
"Saline County, KS",KS,2021,29373,28494,879,3.0,-109
"Saline County, KS",KS,2020,29482,27928,1554,5.3,-905
"Saline County, KS",KS,2019,30387,29492,895,2.9,11
"Saline County, KS",KS,2018,30376,29473,903,3.0,-368
"Saline County, KS",KS,2017,30744,29762,982,3.2,495
"Saline County, KS",KS,2016,30249,29124,1125,3.7,-705
"Saline County, KS",KS,2015,30954,29791,1163,3.8,222
"Saline County, KS",KS,2014,30732,29446,1286,4.2,-440
"Saline County, KS",KS,2013,31172,29619,1553,5.0,348
"Saline County, KS",KS,2012,30824,29054,1770,5.7,-85
"Saline County, KS",KS,2011,30909,29059,1850,6.0,-26
"Saline County, KS",KS,2010,30935,29052,1883,6.1,0
"Saline County, MO",MO,2021,10487,10119,368,3.5,-73
"Saline County, MO",MO,2020,10560,10082,478,4.5,-37
"Saline County, MO",MO,2019,10597,10278,319,3.0,-112
"Saline County, MO",MO,2018,10709,10384,325,3.0,43
"Saline County, MO",MO,2017,10666,10289,377,3.5,-60
"Saline County, MO",MO,2016,10726,10227,499,4.7,-259
"Saline County, MO",MO,2015,10985,10445,540,4.9,-217
"Saline County, MO",MO,2014,11202,10571,631,5.6,146
"Saline County, MO",MO,2013,11056,10389,667,6.0,104
"Saline County, MO",MO,2012,10952,10206,746,6.8,-114
"Saline County, MO",MO,2011,11066,10163,903,8.2,131
"Saline County, MO",MO,2010,10935,9969,966,8.8,0
"Saline County, NE",NE,2021,7302,7134,168,2.3,-74
"Saline County, NE",NE,2020,7376,7116,260,3.5,-99
"Saline County, NE",NE,2019,7475,7232,243,3.3,-29
"Saline County, NE",NE,2018,7504,7273,231,3.1,41
"Saline County, NE",NE,2017,7463,7231,232,3.1,72
"Saline County, NE",NE,2016,7391,7164,227,3.1,83
"Saline County, NE",NE,2015,7308,7094,214,2.9,71
"Saline County, NE",NE,2014,7237,6990,247,3.4,-137
"Saline County, NE",NE,2013,7374,7067,307,4.2,26
"Saline County, NE",NE,2012,7348,7037,311,4.2,2
"Saline County, NE",NE,2011,7346,7000,346,4.7,69
"Saline County, NE",NE,2010,7277,6930,347,4.8,0
"Salt Lake County, UT",UT,2021,653817,635656,18161,2.8,10356
"Salt Lake County, UT",UT,2020,643461,610521,32940,5.1,6288
"Salt Lake County, UT",UT,2019,637173,621401,15772,2.5,12329
"Salt Lake County, UT",UT,2018,624844,607123,17721,2.8,7387
"Salt Lake County, UT",UT,2017,617457,598906,18551,3.0,17954
"Salt Lake County, UT",UT,2016,599503,581020,18483,3.1,17013
"Salt Lake County, UT",UT,2015,582490,563174,19316,3.3,11653
"Salt Lake County, UT",UT,2014,570837,550796,20041,3.5,9087
"Salt Lake County, UT",UT,2013,561750,539099,22651,4.0,15040
"Salt Lake County, UT",UT,2012,546710,521300,25410,4.6,4046
"Salt Lake County, UT",UT,2011,542664,505036,37628,6.9,-3355
"Salt Lake County, UT",UT,2010,546019,503514,42505,7.8,0
"Saluda County, SC",SC,2021,8409,8145,264,3.1,89
"Saluda County, SC",SC,2020,8320,7973,347,4.2,-292
"Saluda County, SC",SC,2019,8612,8387,225,2.6,44
"Saluda County, SC",SC,2018,8568,8304,264,3.1,-124
"Saluda County, SC",SC,2017,8692,8356,336,3.9,-178
"Saluda County, SC",SC,2016,8870,8476,394,4.4,45
"Saluda County, SC",SC,2015,8825,8367,458,5.2,169
"Saluda County, SC",SC,2014,8656,8177,479,5.5,60
"Saluda County, SC",SC,2013,8596,8018,578,6.7,-13
"Saluda County, SC",SC,2012,8609,7895,714,8.3,-103
"Saluda County, SC",SC,2011,8712,7872,840,9.6,-47
"Saluda County, SC",SC,2010,8759,7868,891,10.2,0
"Sampson County, NC",NC,2021,27818,26567,1251,4.5,260
"Sampson County, NC",NC,2020,27558,25999,1559,5.7,-1616
"Sampson County, NC",NC,2019,29174,28085,1089,3.7,305
"Sampson County, NC",NC,2018,28869,27693,1176,4.1,-117
"Sampson County, NC",NC,2017,28986,27606,1380,4.8,-437
"Sampson County, NC",NC,2016,29423,27817,1606,5.5,-88
"Sampson County, NC",NC,2015,29511,27786,1725,5.8,-125
"Sampson County, NC",NC,2014,29636,27775,1861,6.3,-78
"Sampson County, NC",NC,2013,29714,27381,2333,7.9,-244
"Sampson County, NC",NC,2012,29958,27095,2863,9.6,95
"Sampson County, NC",NC,2011,29863,26932,2931,9.8,188
"Sampson County, NC",NC,2010,29675,26834,2841,9.6,0
"San Augustine County, TX",TX,2021,2979,2734,245,8.2,-20
"San Augustine County, TX",TX,2020,2999,2711,288,9.6,-335
"San Augustine County, TX",TX,2019,3334,3175,159,4.8,357
"San Augustine County, TX",TX,2018,2977,2784,193,6.5,129
"San Augustine County, TX",TX,2017,2848,2633,215,7.5,43
"San Augustine County, TX",TX,2016,2805,2554,251,8.9,4
"San Augustine County, TX",TX,2015,2801,2545,256,9.1,-22
"San Augustine County, TX",TX,2014,2823,2550,273,9.7,-108
"San Augustine County, TX",TX,2013,2931,2588,343,11.7,-86
"San Augustine County, TX",TX,2012,3017,2654,363,12.0,-143
"San Augustine County, TX",TX,2011,3160,2699,461,14.6,-41
"San Augustine County, TX",TX,2010,3201,2782,419,13.1,0
"San Benito County, CA",CA,2021,31976,29658,2318,7.2,-517
"San Benito County, CA",CA,2020,32493,29251,3242,10.0,177
"San Benito County, CA",CA,2019,32316,30688,1628,5.0,1117
"San Benito County, CA",CA,2018,31199,29606,1593,5.1,611
"San Benito County, CA",CA,2017,30588,28811,1777,5.8,154
"San Benito County, CA",CA,2016,30434,28398,2036,6.7,675
"San Benito County, CA",CA,2015,29759,27495,2264,7.6,638
"San Benito County, CA",CA,2014,29121,26372,2749,9.4,310
"San Benito County, CA",CA,2013,28811,25574,3237,11.2,179
"San Benito County, CA",CA,2012,28632,24837,3795,13.3,379
"San Benito County, CA",CA,2011,28253,24084,4169,14.8,296
"San Benito County, CA",CA,2010,27957,23632,4325,15.5,0
"San Bernardino County, CA",CA,2021,988604,915089,73515,7.4,17220
"San Bernardino County, CA",CA,2020,971384,876969,94415,9.7,4621
"San Bernardino County, CA",CA,2019,966763,929049,37714,3.9,11774
"San Bernardino County, CA",CA,2018,954989,915519,39470,4.1,12941
"San Bernardino County, CA",CA,2017,942048,895265,46783,5.0,11806
"San Bernardino County, CA",CA,2016,930242,876387,53855,5.8,10934
"San Bernardino County, CA",CA,2015,919308,859733,59575,6.5,15659
"San Bernardino County, CA",CA,2014,903649,830461,73188,8.1,10039
"San Bernardino County, CA",CA,2013,893610,805211,88399,9.9,3092
"San Bernardino County, CA",CA,2012,890518,787254,103264,11.6,3173
"San Bernardino County, CA",CA,2011,887345,771117,116228,13.1,-4077
"San Bernardino County, CA",CA,2010,891422,767935,123487,13.9,0
"San Diego County, CA",CA,2021,1543678,1443815,99863,6.5,1699
"San Diego County, CA",CA,2020,1541979,1395730,146249,9.5,-40895
"San Diego County, CA",CA,2019,1582874,1531029,51845,3.3,3324
"San Diego County, CA",CA,2018,1579550,1526087,53463,3.4,8759
"San Diego County, CA",CA,2017,1570791,1507180,63611,4.0,7545
"San Diego County, CA",CA,2016,1563246,1489143,74103,4.7,14452
"San Diego County, CA",CA,2015,1548794,1467686,81108,5.2,11282
"San Diego County, CA",CA,2014,1537512,1437398,100114,6.5,-132
"San Diego County, CA",CA,2013,1537644,1415625,122019,7.9,719
"San Diego County, CA",CA,2012,1536925,1394274,142651,9.3,15180
"San Diego County, CA",CA,2011,1521745,1361865,159880,10.5,5883
"San Diego County, CA",CA,2010,1515862,1348833,167029,11.0,0
"San Francisco County/city, CA",CA,2021,545953,518434,27519,5.0,-12152
"San Francisco County/city, CA",CA,2020,558105,513363,44742,8.0,-22492
"San Francisco County/city, CA",CA,2019,580597,567612,12985,2.2,11992
"San Francisco County/city, CA",CA,2018,568605,554889,13716,2.4,5559
"San Francisco County/city, CA",CA,2017,563046,546440,16606,2.9,7730
"San Francisco County/city, CA",CA,2016,555316,536972,18344,3.3,13902
"San Francisco County/city, CA",CA,2015,541414,521569,19845,3.7,14094
"San Francisco County/city, CA",CA,2014,527320,503984,23336,4.4,13089
"San Francisco County/city, CA",CA,2013,514231,485801,28430,5.5,6220
"San Francisco County/city, CA",CA,2012,508011,473033,34978,6.9,14574
"San Francisco County/city, CA",CA,2011,493437,453071,40366,8.2,7658
"San Francisco County/city, CA",CA,2010,485779,441571,44208,9.1,0
"San German Municipio, PR",PR,2021,10384,9395,989,9.5,
"San German Municipio, PR",PR,2020,N.A.,N.A.,N.A.,N.A.,
"San German Municipio, PR",PR,2019,9674,8580,1094,11.3,22
"San German Municipio, PR",PR,2018,9652,8474,1178,12.2,-365
"San German Municipio, PR",PR,2017,10017,8447,1570,15.7,-339
"San German Municipio, PR",PR,2016,10356,8775,1581,15.3,26
"San German Municipio, PR",PR,2015,10330,8872,1458,14.1,-219
"San German Municipio, PR",PR,2014,10549,8649,1900,18.0,-304
"San German Municipio, PR",PR,2013,10853,8689,2164,19.9,-318
"San German Municipio, PR",PR,2012,11171,9128,2043,18.3,-284
"San German Municipio, PR",PR,2011,11455,9321,2134,18.6,-525
"San German Municipio, PR",PR,2010,11980,9773,2207,18.4,0
"San Jacinto County, TX",TX,2021,11871,10994,877,7.4,342
"San Jacinto County, TX",TX,2020,11529,10594,935,8.1,-76
"San Jacinto County, TX",TX,2019,11605,11073,532,4.6,196
"San Jacinto County, TX",TX,2018,11409,10837,572,5.0,30
"San Jacinto County, TX",TX,2017,11379,10723,656,5.8,-52
"San Jacinto County, TX",TX,2016,11431,10713,718,6.3,136
"San Jacinto County, TX",TX,2015,11295,10657,638,5.6,-102
"San Jacinto County, TX",TX,2014,11397,10732,665,5.8,-34
"San Jacinto County, TX",TX,2013,11431,10561,870,7.6,-13
"San Jacinto County, TX",TX,2012,11444,10508,936,8.2,74
"San Jacinto County, TX",TX,2011,11370,10238,1132,10.0,122
"San Jacinto County, TX",TX,2010,11248,10120,1128,10.0,0
"San Joaquin County, CA",CA,2021,334250,305278,28972,8.7,-42
"San Joaquin County, CA",CA,2020,334292,295559,38733,11.6,7203
"San Joaquin County, CA",CA,2019,327089,307458,19631,6.0,2943
"San Joaquin County, CA",CA,2018,324146,304226,19920,6.1,1195
"San Joaquin County, CA",CA,2017,322951,300205,22746,7.0,4635
"San Joaquin County, CA",CA,2016,318316,292367,25949,8.2,3915
"San Joaquin County, CA",CA,2015,314401,286281,28120,8.9,2858
"San Joaquin County, CA",CA,2014,311543,278342,33201,10.7,-597
"San Joaquin County, CA",CA,2013,312140,273256,38884,12.5,747
"San Joaquin County, CA",CA,2012,311393,265990,45403,14.6,234
"San Joaquin County, CA",CA,2011,311159,259969,51190,16.5,-945
"San Joaquin County, CA",CA,2010,312104,259334,52770,16.9,0
"San Juan County, CO",CO,2021,608,587,21,3.5,89
"San Juan County, CO",CO,2020,519,486,33,6.4,-32
"San Juan County, CO",CO,2019,551,536,15,2.7,32
"San Juan County, CO",CO,2018,519,504,15,2.9,-4
"San Juan County, CO",CO,2017,523,512,11,2.1,44
"San Juan County, CO",CO,2016,479,462,17,3.5,9
"San Juan County, CO",CO,2015,470,451,19,4.0,-5
"San Juan County, CO",CO,2014,475,450,25,5.3,-2
"San Juan County, CO",CO,2013,477,436,41,8.6,-57
"San Juan County, CO",CO,2012,534,480,54,10.1,13
"San Juan County, CO",CO,2011,521,458,63,12.1,16
"San Juan County, CO",CO,2010,505,439,66,13.1,0
"San Juan County, NM",NM,2021,49527,45550,3977,8.0,-493
"San Juan County, NM",NM,2020,50020,45217,4803,9.6,-2466
"San Juan County, NM",NM,2019,52486,49450,3036,5.8,-264
"San Juan County, NM",NM,2018,52750,49735,3015,5.7,-1805
"San Juan County, NM",NM,2017,54555,50494,4061,7.4,-123
"San Juan County, NM",NM,2016,54678,49824,4854,8.9,-1324
"San Juan County, NM",NM,2015,56002,52098,3904,7.0,379
"San Juan County, NM",NM,2014,55623,52119,3504,6.3,750
"San Juan County, NM",NM,2013,54873,51165,3708,6.8,-498
"San Juan County, NM",NM,2012,55371,51522,3849,7.0,661
"San Juan County, NM",NM,2011,54710,50576,4134,7.6,309
"San Juan County, NM",NM,2010,54401,49509,4892,9.0,0
"San Juan County, UT",UT,2021,5470,5125,345,6.3,-22
"San Juan County, UT",UT,2020,5492,4928,564,10.3,-265
"San Juan County, UT",UT,2019,5757,5470,287,5.0,13
"San Juan County, UT",UT,2018,5744,5406,338,5.9,28
"San Juan County, UT",UT,2017,5716,5327,389,6.8,3
"San Juan County, UT",UT,2016,5713,5265,448,7.8,30
"San Juan County, UT",UT,2015,5683,5243,440,7.7,134
"San Juan County, UT",UT,2014,5549,5139,410,7.4,-30
"San Juan County, UT",UT,2013,5579,5170,409,7.3,9
"San Juan County, UT",UT,2012,5570,5134,436,7.8,-354
"San Juan County, UT",UT,2011,5924,5306,618,10.4,-141
"San Juan County, UT",UT,2010,6065,5394,671,11.1,0
"San Juan County, WA",WA,2021,8376,7959,417,5.0,250
"San Juan County, WA",WA,2020,8126,7467,659,8.1,-611
"San Juan County, WA",WA,2019,8737,8398,339,3.9,407
"San Juan County, WA",WA,2018,8330,8007,323,3.9,101
"San Juan County, WA",WA,2017,8229,7909,320,3.9,350
"San Juan County, WA",WA,2016,7879,7518,361,4.6,155
"San Juan County, WA",WA,2015,7724,7363,361,4.7,40
"San Juan County, WA",WA,2014,7684,7311,373,4.9,-100
"San Juan County, WA",WA,2013,7784,7329,455,5.8,-305
"San Juan County, WA",WA,2012,8089,7614,475,5.9,84
"San Juan County, WA",WA,2011,8005,7485,520,6.5,-297
"San Juan County, WA",WA,2010,8302,7754,548,6.6,0
"San Juan Municipio, PR",PR,2021,143839,134397,9442,6.6,
"San Juan Municipio, PR",PR,2020,N.A.,N.A.,N.A.,N.A.,
"San Juan Municipio, PR",PR,2019,132548,125161,7387,5.6,665
"San Juan Municipio, PR",PR,2018,131883,123646,8237,6.2,-621
"San Juan Municipio, PR",PR,2017,132504,123201,9303,7.0,-2655
"San Juan Municipio, PR",PR,2016,135159,124495,10664,7.9,-603
"San Juan Municipio, PR",PR,2015,135762,125441,10321,7.6,-141
"San Juan Municipio, PR",PR,2014,135903,124920,10983,8.1,-4079
"San Juan Municipio, PR",PR,2013,139982,128736,11246,8.0,-5042
"San Juan Municipio, PR",PR,2012,145024,132233,12791,8.8,-3363
"San Juan Municipio, PR",PR,2011,148387,133606,14781,10.0,-7021
"San Juan Municipio, PR",PR,2010,155408,139469,15939,10.3,0
"San Lorenzo Municipio, PR",PR,2021,12332,11384,948,7.7,
"San Lorenzo Municipio, PR",PR,2020,N.A.,N.A.,N.A.,N.A.,
"San Lorenzo Municipio, PR",PR,2019,11686,10661,1025,8.8,60
"San Lorenzo Municipio, PR",PR,2018,11626,10453,1173,10.1,-282
"San Lorenzo Municipio, PR",PR,2017,11908,10381,1527,12.8,-2
"San Lorenzo Municipio, PR",PR,2016,11910,10418,1492,12.5,-69
"San Lorenzo Municipio, PR",PR,2015,11979,10410,1569,13.1,-251
"San Lorenzo Municipio, PR",PR,2014,12230,10320,1910,15.6,-426
"San Lorenzo Municipio, PR",PR,2013,12656,10558,2098,16.6,-57
"San Lorenzo Municipio, PR",PR,2012,12713,10710,2003,15.8,-251
"San Lorenzo Municipio, PR",PR,2011,12964,10677,2287,17.6,-363
"San Lorenzo Municipio, PR",PR,2010,13327,11002,2325,17.4,0
"San Luis Obispo County, CA",CA,2021,135268,128186,7082,5.2,1347
"San Luis Obispo County, CA",CA,2020,133921,123379,10542,7.9,-5917
"San Luis Obispo County, CA",CA,2019,139838,135750,4088,2.9,-247
"San Luis Obispo County, CA",CA,2018,140085,135845,4240,3.0,-165
"San Luis Obispo County, CA",CA,2017,140250,135171,5079,3.6,766
"San Luis Obispo County, CA",CA,2016,139484,133438,6046,4.3,571
"San Luis Obispo County, CA",CA,2015,138913,132302,6611,4.8,-1006
"San Luis Obispo County, CA",CA,2014,139919,132020,7899,5.6,2192
"San Luis Obispo County, CA",CA,2013,137727,128206,9521,6.9,714
"San Luis Obispo County, CA",CA,2012,137013,125533,11480,8.4,2947
"San Luis Obispo County, CA",CA,2011,134066,121031,13035,9.7,476
"San Luis Obispo County, CA",CA,2010,133590,119904,13686,10.2,0
"San Mateo County, CA",CA,2021,431205,411484,19721,4.6,-6630
"San Mateo County, CA",CA,2020,437835,407241,30594,7.0,-19298
"San Mateo County, CA",CA,2019,457133,447577,9556,2.1,8222
"San Mateo County, CA",CA,2018,448911,438753,10158,2.3,4002
"San Mateo County, CA",CA,2017,444909,432729,12180,2.7,3117
"San Mateo County, CA",CA,2016,441792,428282,13510,3.1,7558
"San Mateo County, CA",CA,2015,434234,419310,14924,3.4,8371
"San Mateo County, CA",CA,2014,425863,407692,18171,4.3,9464
"San Mateo County, CA",CA,2013,416399,394209,22190,5.3,5501
"San Mateo County, CA",CA,2012,410898,384118,26780,6.5,12006
"San Mateo County, CA",CA,2011,398892,368371,30521,7.7,6023
"San Mateo County, CA",CA,2010,392869,359249,33620,8.6,0
"San Miguel County, CO",CO,2021,5836,5542,294,5.0,411
"San Miguel County, CO",CO,2020,5425,4865,560,10.3,-286
"San Miguel County, CO",CO,2019,5711,5559,152,2.7,205
"San Miguel County, CO",CO,2018,5506,5331,175,3.2,208
"San Miguel County, CO",CO,2017,5298,5158,140,2.6,113
"San Miguel County, CO",CO,2016,5185,5024,161,3.1,112
"San Miguel County, CO",CO,2015,5073,4888,185,3.6,154
"San Miguel County, CO",CO,2014,4919,4687,232,4.7,143
"San Miguel County, CO",CO,2013,4776,4462,314,6.6,-68
"San Miguel County, CO",CO,2012,4844,4457,387,8.0,-29
"San Miguel County, CO",CO,2011,4873,4467,406,8.3,-1
"San Miguel County, CO",CO,2010,4874,4473,401,8.2,0
"San Miguel County, NM",NM,2021,10367,9609,758,7.3,-62
"San Miguel County, NM",NM,2020,10429,9602,827,7.9,-454
"San Miguel County, NM",NM,2019,10883,10246,637,5.9,-137
"San Miguel County, NM",NM,2018,11020,10373,647,5.9,-71
"San Miguel County, NM",NM,2017,11091,10279,812,7.3,-88
"San Miguel County, NM",NM,2016,11179,10310,869,7.8,13
"San Miguel County, NM",NM,2015,11166,10299,867,7.8,108
"San Miguel County, NM",NM,2014,11058,10170,888,8.0,-97
"San Miguel County, NM",NM,2013,11155,10230,925,8.3,47
"San Miguel County, NM",NM,2012,11108,10142,966,8.7,81
"San Miguel County, NM",NM,2011,11027,10018,1009,9.2,-86
"San Miguel County, NM",NM,2010,11113,10089,1024,9.2,0
"San Patricio County, TX",TX,2021,29428,26830,2598,8.8,225
"San Patricio County, TX",TX,2020,29203,26222,2981,10.2,-210
"San Patricio County, TX",TX,2019,29413,27801,1612,5.5,-386
"San Patricio County, TX",TX,2018,29799,27897,1902,6.4,-546
"San Patricio County, TX",TX,2017,30345,27997,2348,7.7,-278
"San Patricio County, TX",TX,2016,30623,28335,2288,7.5,373
"San Patricio County, TX",TX,2015,30250,28264,1986,6.6,-396
"San Patricio County, TX",TX,2014,30646,28708,1938,6.3,40
"San Patricio County, TX",TX,2013,30606,28390,2216,7.2,244
"San Patricio County, TX",TX,2012,30362,28073,2289,7.5,116
"San Patricio County, TX",TX,2011,30246,27210,3036,10.0,-251
"San Patricio County, TX",TX,2010,30497,27270,3227,10.6,0
"San Saba County, TX",TX,2021,2203,2100,103,4.7,29
"San Saba County, TX",TX,2020,2174,2062,112,5.2,-330
"San Saba County, TX",TX,2019,2504,2430,74,3.0,-9
"San Saba County, TX",TX,2018,2513,2436,77,3.1,114
"San Saba County, TX",TX,2017,2399,2321,78,3.3,-49
"San Saba County, TX",TX,2016,2448,2365,83,3.4,202
"San Saba County, TX",TX,2015,2246,2163,83,3.7,18
"San Saba County, TX",TX,2014,2228,2134,94,4.2,-41
"San Saba County, TX",TX,2013,2269,2138,131,5.8,-21
"San Saba County, TX",TX,2012,2290,2148,142,6.2,-229
"San Saba County, TX",TX,2011,2519,2362,157,6.2,-44
"San Saba County, TX",TX,2010,2563,2403,160,6.2,0
"San Sebastian Municipio, PR",PR,2021,10938,9629,1309,12.0,
"San Sebastian Municipio, PR",PR,2020,N.A.,N.A.,N.A.,N.A.,
"San Sebastian Municipio, PR",PR,2019,10330,8923,1407,13.6,59
"San Sebastian Municipio, PR",PR,2018,10271,8767,1504,14.6,-305
"San Sebastian Municipio, PR",PR,2017,10576,8709,1867,17.7,-145
"San Sebastian Municipio, PR",PR,2016,10721,8694,2027,18.9,44
"San Sebastian Municipio, PR",PR,2015,10677,8555,2122,19.9,-341
"San Sebastian Municipio, PR",PR,2014,11018,8461,2557,23.2,-345
"San Sebastian Municipio, PR",PR,2013,11363,8654,2709,23.8,46
"San Sebastian Municipio, PR",PR,2012,11317,8813,2504,22.1,-264
"San Sebastian Municipio, PR",PR,2011,11581,8911,2670,23.1,-274
"San Sebastian Municipio, PR",PR,2010,11855,9218,2637,22.2,0
"Sanborn County, SD",SD,2021,1184,1148,36,3.0,30
"Sanborn County, SD",SD,2020,1154,1110,44,3.8,23
"Sanborn County, SD",SD,2019,1131,1102,29,2.6,-14
"Sanborn County, SD",SD,2018,1145,1114,31,2.7,-28
"Sanborn County, SD",SD,2017,1173,1134,39,3.3,-42
"Sanborn County, SD",SD,2016,1215,1179,36,3.0,-20
"Sanborn County, SD",SD,2015,1235,1204,31,2.5,-18
"Sanborn County, SD",SD,2014,1253,1222,31,2.5,-48
"Sanborn County, SD",SD,2013,1301,1262,39,3.0,-8
"Sanborn County, SD",SD,2012,1309,1266,43,3.3,-38
"Sanborn County, SD",SD,2011,1347,1292,55,4.1,-6
"Sanborn County, SD",SD,2010,1353,1297,56,4.1,0
"Sanders County, MT",MT,2021,5206,4955,251,4.8,116
"Sanders County, MT",MT,2020,5090,4700,390,7.7,132
"Sanders County, MT",MT,2019,4958,4659,299,6.0,136
"Sanders County, MT",MT,2018,4822,4513,309,6.4,9
"Sanders County, MT",MT,2017,4813,4473,340,7.1,55
"Sanders County, MT",MT,2016,4758,4377,381,8.0,48
"Sanders County, MT",MT,2015,4710,4309,401,8.5,73
"Sanders County, MT",MT,2014,4637,4207,430,9.3,-103
"Sanders County, MT",MT,2013,4740,4249,491,10.4,-46
"Sanders County, MT",MT,2012,4786,4252,534,11.2,-57
"Sanders County, MT",MT,2011,4843,4224,619,12.8,-154
"Sanders County, MT",MT,2010,4997,4352,645,12.9,0
"Sandoval County, NM",NM,2021,67732,63252,4480,6.6,1146
"Sandoval County, NM",NM,2020,66586,61164,5422,8.1,-1156
"Sandoval County, NM",NM,2019,67742,64430,3312,4.9,1517
"Sandoval County, NM",NM,2018,66225,62980,3245,4.9,964
"Sandoval County, NM",NM,2017,65261,61293,3968,6.1,654
"Sandoval County, NM",NM,2016,64607,60300,4307,6.7,2115
"Sandoval County, NM",NM,2015,62492,58296,4196,6.7,959
"Sandoval County, NM",NM,2014,61533,57186,4347,7.1,595
"Sandoval County, NM",NM,2013,60938,56417,4521,7.4,352
"Sandoval County, NM",NM,2012,60586,55966,4620,7.6,106
"Sandoval County, NM",NM,2011,60480,55796,4684,7.7,34
"Sandoval County, NM",NM,2010,60446,55563,4883,8.1,0
"Sandusky County, OH",OH,2021,30368,28788,1580,5.2,388
"Sandusky County, OH",OH,2020,29980,27548,2432,8.1,-850
"Sandusky County, OH",OH,2019,30830,29492,1338,4.3,-202
"Sandusky County, OH",OH,2018,31032,29632,1400,4.5,-466
"Sandusky County, OH",OH,2017,31498,30011,1487,4.7,349
"Sandusky County, OH",OH,2016,31149,29669,1480,4.8,-312
"Sandusky County, OH",OH,2015,31461,29929,1532,4.9,87
"Sandusky County, OH",OH,2014,31374,29577,1797,5.7,-166
"Sandusky County, OH",OH,2013,31540,29160,2380,7.5,-233
"Sandusky County, OH",OH,2012,31773,29386,2387,7.5,-854
"Sandusky County, OH",OH,2011,32627,29644,2983,9.1,-626
"Sandusky County, OH",OH,2010,33253,29663,3590,10.8,0
"Sangamon County, IL",IL,2021,97844,92423,5421,5.5,1291
"Sangamon County, IL",IL,2020,96553,88467,8086,8.4,-3355
"Sangamon County, IL",IL,2019,99908,96007,3901,3.9,-1739
"Sangamon County, IL",IL,2018,101647,97167,4480,4.4,-198
"Sangamon County, IL",IL,2017,101845,97335,4510,4.4,-2392
"Sangamon County, IL",IL,2016,104237,99031,5206,5.0,666
"Sangamon County, IL",IL,2015,103571,98071,5500,5.3,1170
"Sangamon County, IL",IL,2014,102401,96182,6219,6.1,652
"Sangamon County, IL",IL,2013,101749,94098,7651,7.5,-3201
"Sangamon County, IL",IL,2012,104950,97124,7826,7.5,-2413
"Sangamon County, IL",IL,2011,107363,99273,8090,7.5,397
"Sangamon County, IL",IL,2010,106966,98527,8439,7.9,0
"Sanilac County, MI",MI,2021,18923,17768,1155,6.1,-475
"Sanilac County, MI",MI,2020,19398,17443,1955,10.1,-180
"Sanilac County, MI",MI,2019,19578,18633,945,4.8,330
"Sanilac County, MI",MI,2018,19248,18247,1001,5.2,-57
"Sanilac County, MI",MI,2017,19305,18187,1118,5.8,-165
"Sanilac County, MI",MI,2016,19470,18247,1223,6.3,-131
"Sanilac County, MI",MI,2015,19601,18310,1291,6.6,-77
"Sanilac County, MI",MI,2014,19678,18001,1677,8.5,237
"Sanilac County, MI",MI,2013,19441,17421,2020,10.4,68
"Sanilac County, MI",MI,2012,19373,17363,2010,10.4,-69
"Sanilac County, MI",MI,2011,19442,17158,2284,11.7,-348
"Sanilac County, MI",MI,2010,19790,16828,2962,15.0,0
"Sanpete County, UT",UT,2021,13057,12691,366,2.8,298
"Sanpete County, UT",UT,2020,12759,12275,484,3.8,217
"Sanpete County, UT",UT,2019,12542,12148,394,3.1,-14
"Sanpete County, UT",UT,2018,12556,12115,441,3.5,491
"Sanpete County, UT",UT,2017,12065,11605,460,3.8,310
"Sanpete County, UT",UT,2016,11755,11300,455,3.9,397
"Sanpete County, UT",UT,2015,11358,10898,460,4.1,390
"Sanpete County, UT",UT,2014,10968,10493,475,4.3,76
"Sanpete County, UT",UT,2013,10892,10330,562,5.2,-146
"Sanpete County, UT",UT,2012,11038,10413,625,5.7,-3
"Sanpete County, UT",UT,2011,11041,10134,907,8.2,-370
"Sanpete County, UT",UT,2010,11411,10369,1042,9.1,0
"Santa Barbara County, CA",CA,2021,217988,205423,12565,5.8,-134
"Santa Barbara County, CA",CA,2020,218122,200213,17909,8.2,-4553
"Santa Barbara County, CA",CA,2019,222675,214501,8174,3.7,7455
"Santa Barbara County, CA",CA,2018,215220,206642,8578,4.0,272
"Santa Barbara County, CA",CA,2017,214948,205145,9803,4.6,-308
"Santa Barbara County, CA",CA,2016,215256,204329,10927,5.1,-1902
"Santa Barbara County, CA",CA,2015,217158,205591,11567,5.3,-173
"Santa Barbara County, CA",CA,2014,217331,203882,13449,6.2,800
"Santa Barbara County, CA",CA,2013,216531,200720,15811,7.3,1046
"Santa Barbara County, CA",CA,2012,215485,197127,18358,8.5,2928
"Santa Barbara County, CA",CA,2011,212557,192261,20296,9.5,283
"Santa Barbara County, CA",CA,2010,212274,191192,21082,9.9,0
"Santa Clara County, CA",CA,2021,1013614,966009,47605,4.7,-8185
"Santa Clara County, CA",CA,2020,1021799,948273,73526,7.2,-28291
"Santa Clara County, CA",CA,2019,1050090,1023426,26664,2.5,7753
"Santa Clara County, CA",CA,2018,1042337,1014614,27723,2.7,4981
"Santa Clara County, CA",CA,2017,1037356,1003683,33673,3.2,9438
"Santa Clara County, CA",CA,2016,1027918,989048,38870,3.8,15703
"Santa Clara County, CA",CA,2015,1012215,969950,42265,4.2,24602
"Santa Clara County, CA",CA,2014,987613,936090,51523,5.2,19459
"Santa Clara County, CA",CA,2013,968154,904718,63436,6.6,12175
"Santa Clara County, CA",CA,2012,955979,879447,76532,8.0,18108
"Santa Clara County, CA",CA,2011,937871,849070,88801,9.5,11003
"Santa Clara County, CA",CA,2010,926868,828008,98860,10.7,0
"Santa Cruz County, AZ",AZ,2021,18942,17298,1644,8.7,167
"Santa Cruz County, AZ",AZ,2020,18775,16677,2098,11.2,-234
"Santa Cruz County, AZ",AZ,2019,19009,17356,1653,8.7,281
"Santa Cruz County, AZ",AZ,2018,18728,17011,1717,9.2,127
"Santa Cruz County, AZ",AZ,2017,18601,16816,1785,9.6,-681
"Santa Cruz County, AZ",AZ,2016,19282,17317,1965,10.2,-704
"Santa Cruz County, AZ",AZ,2015,19986,17687,2299,11.5,-436
"Santa Cruz County, AZ",AZ,2014,20422,17777,2645,13.0,67
"Santa Cruz County, AZ",AZ,2013,20355,17210,3145,15.5,62
"Santa Cruz County, AZ",AZ,2012,20293,17157,3136,15.5,-274
"Santa Cruz County, AZ",AZ,2011,20567,17407,3160,15.4,-350
"Santa Cruz County, AZ",AZ,2010,20917,17748,3169,15.2,0
"Santa Cruz County, CA",CA,2021,133351,124166,9185,6.9,-1260
"Santa Cruz County, CA",CA,2020,134611,121436,13175,9.8,-6741
"Santa Cruz County, CA",CA,2019,141352,134342,7010,5.0,82
"Santa Cruz County, CA",CA,2018,141270,134175,7095,5.0,-1331
"Santa Cruz County, CA",CA,2017,142601,134423,8178,5.7,-1163
"Santa Cruz County, CA",CA,2016,143764,133730,10034,7.0,537
"Santa Cruz County, CA",CA,2015,143227,132434,10793,7.5,1179
"Santa Cruz County, CA",CA,2014,142048,129469,12579,8.9,457
"Santa Cruz County, CA",CA,2013,141591,126860,14731,10.4,-210
"Santa Cruz County, CA",CA,2012,141801,124756,17045,12.0,654
"Santa Cruz County, CA",CA,2011,141147,122382,18765,13.3,-726
"Santa Cruz County, CA",CA,2010,141873,122559,19314,13.6,0
"Santa Fe County, NM",NM,2021,72572,68094,4478,6.2,1535
"Santa Fe County, NM",NM,2020,71037,65447,5590,7.9,-3449
"Santa Fe County, NM",NM,2019,74486,71439,3047,4.1,-375
"Santa Fe County, NM",NM,2018,74861,71783,3078,4.1,616
"Santa Fe County, NM",NM,2017,74245,70515,3730,5.0,185
"Santa Fe County, NM",NM,2016,74060,70098,3962,5.3,395
"Santa Fe County, NM",NM,2015,73665,69678,3987,5.4,611
"Santa Fe County, NM",NM,2014,73054,69128,3926,5.4,-606
"Santa Fe County, NM",NM,2013,73660,69565,4095,5.6,-101
"Santa Fe County, NM",NM,2012,73761,69587,4174,5.7,510
"Santa Fe County, NM",NM,2011,73251,68875,4376,6.0,-491
"Santa Fe County, NM",NM,2010,73742,68957,4785,6.5,0
"Santa Isabel Municipio, PR",PR,2021,9292,8433,859,9.2,
"Santa Isabel Municipio, PR",PR,2020,N.A.,N.A.,N.A.,N.A.,
"Santa Isabel Municipio, PR",PR,2019,8838,7868,970,11.0,171
"Santa Isabel Municipio, PR",PR,2018,8667,7553,1114,12.9,-1071
"Santa Isabel Municipio, PR",PR,2017,9738,8420,1318,13.5,-160
"Santa Isabel Municipio, PR",PR,2016,9898,8244,1654,16.7,365
"Santa Isabel Municipio, PR",PR,2015,9533,7791,1742,18.3,-341
"Santa Isabel Municipio, PR",PR,2014,9874,7920,1954,19.8,-134
"Santa Isabel Municipio, PR",PR,2013,10008,8118,1890,18.9,116
"Santa Isabel Municipio, PR",PR,2012,9892,7914,1978,20.0,109
"Santa Isabel Municipio, PR",PR,2011,9783,7633,2150,22.0,-610
"Santa Isabel Municipio, PR",PR,2010,10393,8241,2152,20.7,0
"Santa Rosa County, FL",FL,2021,84880,81942,2938,3.5,2018
"Santa Rosa County, FL",FL,2020,82862,78224,4638,5.6,-243
"Santa Rosa County, FL",FL,2019,83105,80577,2528,3.0,2400
"Santa Rosa County, FL",FL,2018,80705,77931,2774,3.4,2285
"Santa Rosa County, FL",FL,2017,78420,75315,3105,4.0,2049
"Santa Rosa County, FL",FL,2016,76371,72892,3479,4.6,2125
"Santa Rosa County, FL",FL,2015,74246,70622,3624,4.9,1255
"Santa Rosa County, FL",FL,2014,72991,68881,4110,5.6,158
"Santa Rosa County, FL",FL,2013,72833,67968,4865,6.7,663
"Santa Rosa County, FL",FL,2012,72170,66565,5605,7.8,-71
"Santa Rosa County, FL",FL,2011,72241,66024,6217,8.6,1492
"Santa Rosa County, FL",FL,2010,70749,64403,6346,9.0,0
"Sarasota County, FL",FL,2021,191384,184019,7365,3.8,7399
"Sarasota County, FL",FL,2020,183985,170423,13562,7.4,-3402
"Sarasota County, FL",FL,2019,187387,181384,6003,3.2,1671
"Sarasota County, FL",FL,2018,185716,179203,6513,3.5,2525
"Sarasota County, FL",FL,2017,183191,175840,7351,4.0,1584
"Sarasota County, FL",FL,2016,181607,173272,8335,4.6,3103
"Sarasota County, FL",FL,2015,178504,169363,9141,5.1,3867
"Sarasota County, FL",FL,2014,174637,164132,10505,6.0,4349
"Sarasota County, FL",FL,2013,170288,157879,12409,7.3,3357
"Sarasota County, FL",FL,2012,166931,152422,14509,8.7,1064
"Sarasota County, FL",FL,2011,165867,148948,16919,10.2,110
"Sarasota County, FL",FL,2010,165757,147114,18643,11.2,0
"Saratoga County, NY",NY,2021,119267,114754,4513,3.8,-2121
"Saratoga County, NY",NY,2020,121388,113590,7798,6.4,-774
"Saratoga County, NY",NY,2019,122162,118200,3962,3.2,491
"Saratoga County, NY",NY,2018,121671,117408,4263,3.5,1193
"Saratoga County, NY",NY,2017,120478,115722,4756,3.9,2985
"Saratoga County, NY",NY,2016,117493,112934,4559,3.9,823
"Saratoga County, NY",NY,2015,116670,111795,4875,4.2,1185
"Saratoga County, NY",NY,2014,115485,110057,5428,4.7,-2441
"Saratoga County, NY",NY,2013,117926,110894,7032,6.0,596
"Saratoga County, NY",NY,2012,117330,109223,8107,6.9,1506
"Saratoga County, NY",NY,2011,115824,108056,7768,6.7,-2307
"Saratoga County, NY",NY,2010,118131,109818,8313,7.0,0
"Sargent County, ND",ND,2021,2386,2322,64,2.7,-427
"Sargent County, ND",ND,2020,2813,2694,119,4.2,88
"Sargent County, ND",ND,2019,2725,2681,44,1.6,129
"Sargent County, ND",ND,2018,2596,2552,44,1.7,184
"Sargent County, ND",ND,2017,2412,2364,48,2.0,85
"Sargent County, ND",ND,2016,2327,2282,45,1.9,89
"Sargent County, ND",ND,2015,2238,2197,41,1.8,97
"Sargent County, ND",ND,2014,2141,2094,47,2.2,26
"Sargent County, ND",ND,2013,2115,2062,53,2.5,-20
"Sargent County, ND",ND,2012,2135,2081,54,2.5,31
"Sargent County, ND",ND,2011,2104,2042,62,2.9,54
"Sargent County, ND",ND,2010,2050,1963,87,4.2,0
"Sarpy County, NE",NE,2021,98538,96195,2343,2.4,631
"Sarpy County, NE",NE,2020,97907,93989,3918,4.0,-581
"Sarpy County, NE",NE,2019,98488,95644,2844,2.9,2529
"Sarpy County, NE",NE,2018,95959,93301,2658,2.8,1912
"Sarpy County, NE",NE,2017,94047,91389,2658,2.8,1479
"Sarpy County, NE",NE,2016,92568,89882,2686,2.9,1564
"Sarpy County, NE",NE,2015,91004,88454,2550,2.8,1131
"Sarpy County, NE",NE,2014,89873,87108,2765,3.1,894
"Sarpy County, NE",NE,2013,88979,85854,3125,3.5,1089
"Sarpy County, NE",NE,2012,87890,84588,3302,3.8,1507
"Sarpy County, NE",NE,2011,86383,82715,3668,4.2,1582
"Sarpy County, NE",NE,2010,84801,80959,3842,4.5,0
"Sauk County, WI",WI,2021,34936,33522,1414,4.0,189
"Sauk County, WI",WI,2020,34747,32125,2622,7.5,-1032
"Sauk County, WI",WI,2019,35779,34788,991,2.8,97
"Sauk County, WI",WI,2018,35682,34777,905,2.5,39
"Sauk County, WI",WI,2017,35643,34615,1028,2.9,499
"Sauk County, WI",WI,2016,35144,33921,1223,3.5,-74
"Sauk County, WI",WI,2015,35218,33806,1412,4.0,273
"Sauk County, WI",WI,2014,34945,33229,1716,4.9,-430
"Sauk County, WI",WI,2013,35375,33181,2194,6.2,-217
"Sauk County, WI",WI,2012,35592,33177,2415,6.8,-331
"Sauk County, WI",WI,2011,35923,33260,2663,7.4,54
"Sauk County, WI",WI,2010,35869,32906,2963,8.3,0
"Saunders County, NE",NE,2021,11484,11229,255,2.2,101
"Saunders County, NE",NE,2020,11383,10977,406,3.6,7
"Saunders County, NE",NE,2019,11376,11060,316,2.8,254
"Saunders County, NE",NE,2018,11122,10806,316,2.8,185
"Saunders County, NE",NE,2017,10937,10627,310,2.8,2
"Saunders County, NE",NE,2016,10935,10600,335,3.1,-35
"Saunders County, NE",NE,2015,10970,10634,336,3.1,-55
"Saunders County, NE",NE,2014,11025,10644,381,3.5,-114
"Saunders County, NE",NE,2013,11139,10700,439,3.9,-28
"Saunders County, NE",NE,2012,11167,10706,461,4.1,-39
"Saunders County, NE",NE,2011,11206,10691,515,4.6,42
"Saunders County, NE",NE,2010,11164,10618,546,4.9,0
"Sawyer County, WI",WI,2021,8109,7696,413,5.1,82
"Sawyer County, WI",WI,2020,8027,7393,634,7.9,1
"Sawyer County, WI",WI,2019,8026,7664,362,4.5,49
"Sawyer County, WI",WI,2018,7977,7636,341,4.3,-42
"Sawyer County, WI",WI,2017,8019,7649,370,4.6,126
"Sawyer County, WI",WI,2016,7893,7413,480,6.1,106
"Sawyer County, WI",WI,2015,7787,7187,600,7.7,-155
"Sawyer County, WI",WI,2014,7942,7243,699,8.8,-242
"Sawyer County, WI",WI,2013,8184,7296,888,10.9,-77
"Sawyer County, WI",WI,2012,8261,7386,875,10.6,105
"Sawyer County, WI",WI,2011,8156,7272,884,10.8,-238
"Sawyer County, WI",WI,2010,8394,7463,931,11.1,0
"Schenectady County, NY",NY,2021,76733,72958,3775,4.9,-1487
"Schenectady County, NY",NY,2020,78220,72204,6016,7.7,63
"Schenectady County, NY",NY,2019,78157,75277,2880,3.7,358
"Schenectady County, NY",NY,2018,77799,74695,3104,4.0,486
"Schenectady County, NY",NY,2017,77313,73869,3444,4.5,1506
"Schenectady County, NY",NY,2016,75807,72465,3342,4.4,187
"Schenectady County, NY",NY,2015,75620,72028,3592,4.8,-378
"Schenectady County, NY",NY,2014,75998,71888,4110,5.4,-1959
"Schenectady County, NY",NY,2013,77957,72602,5355,6.9,23
"Schenectady County, NY",NY,2012,77934,71862,6072,7.8,756
"Schenectady County, NY",NY,2011,77178,71348,5830,7.6,-1907
"Schenectady County, NY",NY,2010,79085,72913,6172,7.8,0
"Schleicher County, TX",TX,2021,1192,1126,66,5.5,-9
"Schleicher County, TX",TX,2020,1201,1118,83,6.9,-93
"Schleicher County, TX",TX,2019,1294,1257,37,2.9,-63
"Schleicher County, TX",TX,2018,1357,1318,39,2.9,33
"Schleicher County, TX",TX,2017,1324,1274,50,3.8,-97
"Schleicher County, TX",TX,2016,1421,1347,74,5.2,-81
"Schleicher County, TX",TX,2015,1502,1422,80,5.3,-274
"Schleicher County, TX",TX,2014,1776,1722,54,3.0,-23
"Schleicher County, TX",TX,2013,1799,1735,64,3.6,22
"Schleicher County, TX",TX,2012,1777,1706,71,4.0,78
"Schleicher County, TX",TX,2011,1699,1598,101,5.9,62
"Schleicher County, TX",TX,2010,1637,1511,126,7.7,0
"Schley County, GA",GA,2021,2134,2055,79,3.7,-12
"Schley County, GA",GA,2020,2146,2054,92,4.3,-114
"Schley County, GA",GA,2019,2260,2170,90,4.0,59
"Schley County, GA",GA,2018,2201,2098,103,4.7,-32
"Schley County, GA",GA,2017,2233,2110,123,5.5,116
"Schley County, GA",GA,2016,2117,1982,135,6.4,31
"Schley County, GA",GA,2015,2086,1945,141,6.8,-86
"Schley County, GA",GA,2014,2172,2006,166,7.6,43
"Schley County, GA",GA,2013,2129,1933,196,9.2,-39
"Schley County, GA",GA,2012,2168,1945,223,10.3,11
"Schley County, GA",GA,2011,2157,1912,245,11.4,-13
"Schley County, GA",GA,2010,2170,1905,265,12.2,0
"Schoharie County, NY",NY,2021,14511,13852,659,4.5,-272
"Schoharie County, NY",NY,2020,14783,13774,1009,6.8,-216
"Schoharie County, NY",NY,2019,14999,14329,670,4.5,64
"Schoharie County, NY",NY,2018,14935,14219,716,4.8,-1
"Schoharie County, NY",NY,2017,14936,14123,813,5.4,205
"Schoharie County, NY",NY,2016,14731,13917,814,5.5,81
"Schoharie County, NY",NY,2015,14650,13793,857,5.8,-74
"Schoharie County, NY",NY,2014,14724,13728,996,6.8,-563
"Schoharie County, NY",NY,2013,15287,14013,1274,8.3,-148
"Schoharie County, NY",NY,2012,15435,13996,1439,9.3,-147
"Schoharie County, NY",NY,2011,15582,14174,1408,9.0,-360
"Schoharie County, NY",NY,2010,15942,14492,1450,9.1,0
"Schoolcraft County, MI",MI,2021,3128,2877,251,8.0,-110
"Schoolcraft County, MI",MI,2020,3238,2909,329,10.2,-66
"Schoolcraft County, MI",MI,2019,3304,3067,237,7.2,-67
"Schoolcraft County, MI",MI,2018,3371,3128,243,7.2,11
"Schoolcraft County, MI",MI,2017,3360,3084,276,8.2,-39
"Schoolcraft County, MI",MI,2016,3399,3087,312,9.2,-78
"Schoolcraft County, MI",MI,2015,3477,3096,381,11.0,-64
"Schoolcraft County, MI",MI,2014,3541,3152,389,11.0,-30
"Schoolcraft County, MI",MI,2013,3571,3117,454,12.7,24
"Schoolcraft County, MI",MI,2012,3547,3106,441,12.4,-117
"Schoolcraft County, MI",MI,2011,3664,3196,468,12.8,-95
"Schoolcraft County, MI",MI,2010,3759,3262,497,13.2,0
"Schuyler County, IL",IL,2021,3150,3026,124,3.9,24
"Schuyler County, IL",IL,2020,3126,2929,197,6.3,-139
"Schuyler County, IL",IL,2019,3265,3136,129,4.0,-80
"Schuyler County, IL",IL,2018,3345,3198,147,4.4,5
"Schuyler County, IL",IL,2017,3340,3188,152,4.6,-32
"Schuyler County, IL",IL,2016,3372,3183,189,5.6,-115
"Schuyler County, IL",IL,2015,3487,3283,204,5.9,30
"Schuyler County, IL",IL,2014,3457,3222,235,6.8,-15
"Schuyler County, IL",IL,2013,3472,3184,288,8.3,-139
"Schuyler County, IL",IL,2012,3611,3325,286,7.9,-158
"Schuyler County, IL",IL,2011,3769,3466,303,8.0,-87
"Schuyler County, IL",IL,2010,3856,3536,320,8.3,0
"Schuyler County, MO",MO,2021,1845,1765,80,4.3,-53
"Schuyler County, MO",MO,2020,1898,1788,110,5.8,-59
"Schuyler County, MO",MO,2019,1957,1876,81,4.1,-51
"Schuyler County, MO",MO,2018,2008,1927,81,4.0,53
"Schuyler County, MO",MO,2017,1955,1861,94,4.8,51
"Schuyler County, MO",MO,2016,1904,1783,121,6.4,8
"Schuyler County, MO",MO,2015,1896,1784,112,5.9,13
"Schuyler County, MO",MO,2014,1883,1743,140,7.4,-14
"Schuyler County, MO",MO,2013,1897,1747,150,7.9,18
"Schuyler County, MO",MO,2012,1879,1736,143,7.6,-20
"Schuyler County, MO",MO,2011,1899,1722,177,9.3,-53
"Schuyler County, MO",MO,2010,1952,1751,201,10.3,0
"Schuyler County, NY",NY,2021,8046,7649,397,4.9,-134
"Schuyler County, NY",NY,2020,8180,7500,680,8.3,-74
"Schuyler County, NY",NY,2019,8254,7887,367,4.4,-147
"Schuyler County, NY",NY,2018,8401,7974,427,5.1,38
"Schuyler County, NY",NY,2017,8363,7881,482,5.8,82
"Schuyler County, NY",NY,2016,8281,7775,506,6.1,-58
"Schuyler County, NY",NY,2015,8339,7784,555,6.7,-256
"Schuyler County, NY",NY,2014,8595,7987,608,7.1,-278
"Schuyler County, NY",NY,2013,8873,8073,800,9.0,-148
"Schuyler County, NY",NY,2012,9021,8162,859,9.5,-1
"Schuyler County, NY",NY,2011,9022,8219,803,8.9,-31
"Schuyler County, NY",NY,2010,9053,8213,840,9.3,0
"Schuylkill County, PA",PA,2021,65357,60936,4421,6.8,-1619
"Schuylkill County, PA",PA,2020,66976,60768,6208,9.3,-294
"Schuylkill County, PA",PA,2019,67270,63536,3734,5.6,429
"Schuylkill County, PA",PA,2018,66841,63252,3589,5.4,-55
"Schuylkill County, PA",PA,2017,66896,62924,3972,5.9,-765
"Schuylkill County, PA",PA,2016,67661,63524,4137,6.1,-568
"Schuylkill County, PA",PA,2015,68229,63858,4371,6.4,-683
"Schuylkill County, PA",PA,2014,68912,63979,4933,7.2,-1042
"Schuylkill County, PA",PA,2013,69954,63724,6230,8.9,-848
"Schuylkill County, PA",PA,2012,70802,64056,6746,9.5,914
"Schuylkill County, PA",PA,2011,69888,63197,6691,9.6,-529
"Schuylkill County, PA",PA,2010,70417,63169,7248,10.3,0
"Scioto County, OH",OH,2021,29306,27495,1811,6.2,224
"Scioto County, OH",OH,2020,29082,26546,2536,8.7,-91
"Scioto County, OH",OH,2019,29173,27332,1841,6.3,58
"Scioto County, OH",OH,2018,29115,27160,1955,6.7,-652
"Scioto County, OH",OH,2017,29767,27670,2097,7.0,-232
"Scioto County, OH",OH,2016,29999,27662,2337,7.8,317
"Scioto County, OH",OH,2015,29682,27386,2296,7.7,-275
"Scioto County, OH",OH,2014,29957,27335,2622,8.8,-367
"Scioto County, OH",OH,2013,30324,26717,3607,11.9,-769
"Scioto County, OH",OH,2012,31093,27584,3509,11.3,-645
"Scioto County, OH",OH,2011,31738,27769,3969,12.5,-917
"Scioto County, OH",OH,2010,32655,28294,4361,13.4,0
"Scotland County, MO",MO,2021,2311,2250,61,2.6,-65
"Scotland County, MO",MO,2020,2376,2299,77,3.2,24
"Scotland County, MO",MO,2019,2352,2284,68,2.9,-36
"Scotland County, MO",MO,2018,2388,2321,67,2.8,-63
"Scotland County, MO",MO,2017,2451,2375,76,3.1,-1
"Scotland County, MO",MO,2016,2452,2351,101,4.1,15
"Scotland County, MO",MO,2015,2437,2324,113,4.6,53
"Scotland County, MO",MO,2014,2384,2269,115,4.8,16
"Scotland County, MO",MO,2013,2368,2240,128,5.4,39
"Scotland County, MO",MO,2012,2329,2208,121,5.2,9
"Scotland County, MO",MO,2011,2320,2164,156,6.7,24
"Scotland County, MO",MO,2010,2296,2112,184,8.0,0
"Scotland County, NC",NC,2021,11096,10041,1055,9.5,88
"Scotland County, NC",NC,2020,11008,9722,1286,11.7,-401
"Scotland County, NC",NC,2019,11409,10671,738,6.5,92
"Scotland County, NC",NC,2018,11317,10476,841,7.4,-23
"Scotland County, NC",NC,2017,11340,10469,871,7.7,-261
"Scotland County, NC",NC,2016,11601,10540,1061,9.1,-240
"Scotland County, NC",NC,2015,11841,10600,1241,10.5,-132
"Scotland County, NC",NC,2014,11973,10581,1392,11.6,-269
"Scotland County, NC",NC,2013,12242,10448,1794,14.7,-354
"Scotland County, NC",NC,2012,12596,10387,2209,17.5,-326
"Scotland County, NC",NC,2011,12922,10594,2328,18.0,-213
"Scotland County, NC",NC,2010,13135,10842,2293,17.5,0
"Scott County, AR",AR,2021,4216,4076,140,3.3,-129
"Scott County, AR",AR,2020,4345,4150,195,4.5,14
"Scott County, AR",AR,2019,4331,4188,143,3.3,-57
"Scott County, AR",AR,2018,4388,4231,157,3.6,-45
"Scott County, AR",AR,2017,4433,4279,154,3.5,-36
"Scott County, AR",AR,2016,4469,4305,164,3.7,-77
"Scott County, AR",AR,2015,4546,4333,213,4.7,-68
"Scott County, AR",AR,2014,4614,4388,226,4.9,-42
"Scott County, AR",AR,2013,4656,4373,283,6.1,-54
"Scott County, AR",AR,2012,4710,4409,301,6.4,-145
"Scott County, AR",AR,2011,4855,4529,326,6.7,99
"Scott County, AR",AR,2010,4756,4434,322,6.8,0
"Scott County, IA",IA,2021,87116,82382,4734,5.4,-293
"Scott County, IA",IA,2020,87409,81621,5788,6.6,-3752
"Scott County, IA",IA,2019,91161,88287,2874,3.2,2359
"Scott County, IA",IA,2018,88802,86193,2609,2.9,1573
"Scott County, IA",IA,2017,87229,84102,3127,3.6,54
"Scott County, IA",IA,2016,87175,83275,3900,4.5,-732
"Scott County, IA",IA,2015,87907,83842,4065,4.6,-958
"Scott County, IA",IA,2014,88865,84265,4600,5.2,620
"Scott County, IA",IA,2013,88245,83316,4929,5.6,645
"Scott County, IA",IA,2012,87600,82565,5035,5.7,116
"Scott County, IA",IA,2011,87484,82023,5461,6.2,483
"Scott County, IA",IA,2010,87001,81133,5868,6.7,0
"Scott County, IL",IL,2021,2296,2179,117,5.1,-51
"Scott County, IL",IL,2020,2347,2189,158,6.7,-165
"Scott County, IL",IL,2019,2512,2398,114,4.5,26
"Scott County, IL",IL,2018,2486,2358,128,5.1,28
"Scott County, IL",IL,2017,2458,2329,129,5.2,-80
"Scott County, IL",IL,2016,2538,2394,144,5.7,-18
"Scott County, IL",IL,2015,2556,2405,151,5.9,2
"Scott County, IL",IL,2014,2554,2376,178,7.0,-44
"Scott County, IL",IL,2013,2598,2367,231,8.9,-96
"Scott County, IL",IL,2012,2694,2458,236,8.8,-149
"Scott County, IL",IL,2011,2843,2608,235,8.3,-31
"Scott County, IL",IL,2010,2874,2622,252,8.8,0
"Scott County, IN",IN,2021,10362,9961,401,3.9,-101
"Scott County, IN",IN,2020,10463,9569,894,8.5,-159
"Scott County, IN",IN,2019,10622,10247,375,3.5,-13
"Scott County, IN",IN,2018,10635,10226,409,3.8,169
"Scott County, IN",IN,2017,10466,10073,393,3.8,-20
"Scott County, IN",IN,2016,10486,9984,502,4.8,220
"Scott County, IN",IN,2015,10266,9709,557,5.4,73
"Scott County, IN",IN,2014,10193,9502,691,6.8,-60
"Scott County, IN",IN,2013,10253,9354,899,8.8,66
"Scott County, IN",IN,2012,10187,9153,1034,10.2,-207
"Scott County, IN",IN,2011,10394,9186,1208,11.6,-190
"Scott County, IN",IN,2010,10584,9225,1359,12.8,0
"Scott County, KS",KS,2021,2833,2788,45,1.6,9
"Scott County, KS",KS,2020,2824,2758,66,2.3,-9
"Scott County, KS",KS,2019,2833,2780,53,1.9,-35
"Scott County, KS",KS,2018,2868,2813,55,1.9,6
"Scott County, KS",KS,2017,2862,2800,62,2.2,-38
"Scott County, KS",KS,2016,2900,2829,71,2.4,7
"Scott County, KS",KS,2015,2893,2813,80,2.8,38
"Scott County, KS",KS,2014,2855,2778,77,2.7,11
"Scott County, KS",KS,2013,2844,2762,82,2.9,59
"Scott County, KS",KS,2012,2785,2700,85,3.1,46
"Scott County, KS",KS,2011,2739,2638,101,3.7,-30
"Scott County, KS",KS,2010,2769,2664,105,3.8,0
"Scott County, KY",KY,2021,29876,28785,1091,3.7,2
"Scott County, KY",KY,2020,29874,28069,1805,6.0,55
"Scott County, KY",KY,2019,29819,28840,979,3.3,882
"Scott County, KY",KY,2018,28937,28003,934,3.2,212
"Scott County, KY",KY,2017,28725,27691,1034,3.6,733
"Scott County, KY",KY,2016,27992,26943,1049,3.7,1074
"Scott County, KY",KY,2015,26918,25868,1050,3.9,418
"Scott County, KY",KY,2014,26500,25211,1289,4.9,225
"Scott County, KY",KY,2013,26275,24692,1583,6.0,455
"Scott County, KY",KY,2012,25820,24123,1697,6.6,215
"Scott County, KY",KY,2011,25605,23577,2028,7.9,49
"Scott County, KY",KY,2010,25556,23312,2244,8.8,0
"Scott County, MN",MN,2021,82810,80313,2497,3.0,-2415
"Scott County, MN",MN,2020,85225,80122,5103,6.0,55
"Scott County, MN",MN,2019,85170,82678,2492,2.9,1641
"Scott County, MN",MN,2018,83529,81289,2240,2.7,1022
"Scott County, MN",MN,2017,82507,80090,2417,2.9,1847
"Scott County, MN",MN,2016,80660,78068,2592,3.2,1325
"Scott County, MN",MN,2015,79335,76799,2536,3.2,1002
"Scott County, MN",MN,2014,78333,75442,2891,3.7,1288
"Scott County, MN",MN,2013,77045,73616,3429,4.5,1160
"Scott County, MN",MN,2012,75885,72077,3808,5.0,826
"Scott County, MN",MN,2011,75059,70709,4350,5.8,851
"Scott County, MN",MN,2010,74208,69100,5108,6.9,0
"Scott County, MO",MO,2021,20195,19410,785,3.9,346
"Scott County, MO",MO,2020,19849,18800,1049,5.3,44
"Scott County, MO",MO,2019,19805,19143,662,3.3,-207
"Scott County, MO",MO,2018,20012,19338,674,3.4,-92
"Scott County, MO",MO,2017,20104,19214,890,4.4,154
"Scott County, MO",MO,2016,19950,18810,1140,5.7,20
"Scott County, MO",MO,2015,19930,18866,1064,5.3,129
"Scott County, MO",MO,2014,19801,18492,1309,6.6,34
"Scott County, MO",MO,2013,19767,18345,1422,7.2,46
"Scott County, MO",MO,2012,19721,18301,1420,7.2,134
"Scott County, MO",MO,2011,19587,17831,1756,9.0,662
"Scott County, MO",MO,2010,18925,17101,1824,9.6,0
"Scott County, MS",MS,2021,12338,11763,575,4.7,-95
"Scott County, MS",MS,2020,12433,11718,715,5.8,-387
"Scott County, MS",MS,2019,12820,12246,574,4.5,-83
"Scott County, MS",MS,2018,12903,12378,525,4.1,-93
"Scott County, MS",MS,2017,12996,12445,551,4.2,-201
"Scott County, MS",MS,2016,13197,12579,618,4.7,257
"Scott County, MS",MS,2015,12940,12310,630,4.9,314
"Scott County, MS",MS,2014,12626,11926,700,5.5,-122
"Scott County, MS",MS,2013,12748,11911,837,6.6,-487
"Scott County, MS",MS,2012,13235,12248,987,7.5,-471
"Scott County, MS",MS,2011,13706,12574,1132,8.3,118
"Scott County, MS",MS,2010,13588,12534,1054,7.8,0
"Scott County, TN",TN,2021,8020,7613,407,5.1,-129
"Scott County, TN",TN,2020,8149,7467,682,8.4,-274
"Scott County, TN",TN,2019,8423,8054,369,4.4,133
"Scott County, TN",TN,2018,8290,7923,367,4.4,114
"Scott County, TN",TN,2017,8176,7759,417,5.1,148
"Scott County, TN",TN,2016,8028,7432,596,7.4,-66
"Scott County, TN",TN,2015,8094,7346,748,9.2,-178
"Scott County, TN",TN,2014,8272,7303,969,11.7,-339
"Scott County, TN",TN,2013,8611,7369,1242,14.4,-162
"Scott County, TN",TN,2012,8773,7389,1384,15.8,-360
"Scott County, TN",TN,2011,9133,7508,1625,17.8,-142
"Scott County, TN",TN,2010,9275,7671,1604,17.3,0
"Scott County, VA",VA,2021,8792,8477,315,3.6,-211
"Scott County, VA",VA,2020,9003,8522,481,5.3,-218
"Scott County, VA",VA,2019,9221,8937,284,3.1,30
"Scott County, VA",VA,2018,9191,8895,296,3.2,-201
"Scott County, VA",VA,2017,9392,9015,377,4.0,-44
"Scott County, VA",VA,2016,9436,8982,454,4.8,-101
"Scott County, VA",VA,2015,9537,9052,485,5.1,-280
"Scott County, VA",VA,2014,9817,9254,563,5.7,-186
"Scott County, VA",VA,2013,10003,9321,682,6.8,-66
"Scott County, VA",VA,2012,10069,9324,745,7.4,-66
"Scott County, VA",VA,2011,10135,9398,737,7.3,49
"Scott County, VA",VA,2010,10086,9214,872,8.6,0
"Scotts Bluff County, NE",NE,2021,18154,17654,500,2.8,-124
"Scotts Bluff County, NE",NE,2020,18278,17534,744,4.1,-197
"Scotts Bluff County, NE",NE,2019,18475,17796,679,3.7,-111
"Scotts Bluff County, NE",NE,2018,18586,17969,617,3.3,29
"Scotts Bluff County, NE",NE,2017,18557,17913,644,3.5,-394
"Scotts Bluff County, NE",NE,2016,18951,18290,661,3.5,217
"Scotts Bluff County, NE",NE,2015,18734,18102,632,3.4,-30
"Scotts Bluff County, NE",NE,2014,18764,18088,676,3.6,-329
"Scotts Bluff County, NE",NE,2013,19093,18309,784,4.1,-99
"Scotts Bluff County, NE",NE,2012,19192,18316,876,4.6,-24
"Scotts Bluff County, NE",NE,2011,19216,18250,966,5.0,40
"Scotts Bluff County, NE",NE,2010,19176,18103,1073,5.6,0
"Screven County, GA",GA,2021,5122,4834,288,5.6,75
"Screven County, GA",GA,2020,5047,4638,409,8.1,-119
"Screven County, GA",GA,2019,5166,4875,291,5.6,-132
"Screven County, GA",GA,2018,5298,5008,290,5.5,-23
"Screven County, GA",GA,2017,5321,4985,336,6.3,81
"Screven County, GA",GA,2016,5240,4840,400,7.6,254
"Screven County, GA",GA,2015,4986,4564,422,8.5,-369
"Screven County, GA",GA,2014,5355,4817,538,10.0,-200
"Screven County, GA",GA,2013,5555,4860,695,12.5,-115
"Screven County, GA",GA,2012,5670,4898,772,13.6,-82
"Screven County, GA",GA,2011,5752,4852,900,15.6,-74
"Screven County, GA",GA,2010,5826,4824,1002,17.2,0
"Scurry County, TX",TX,2021,6086,5678,408,6.7,-83
"Scurry County, TX",TX,2020,6169,5661,508,8.2,-411
"Scurry County, TX",TX,2019,6580,6367,213,3.2,-281
"Scurry County, TX",TX,2018,6861,6627,234,3.4,-75
"Scurry County, TX",TX,2017,6936,6633,303,4.4,-474
"Scurry County, TX",TX,2016,7410,6973,437,5.9,-760
"Scurry County, TX",TX,2015,8170,7829,341,4.2,-428
"Scurry County, TX",TX,2014,8598,8308,290,3.4,51
"Scurry County, TX",TX,2013,8547,8189,358,4.2,447
"Scurry County, TX",TX,2012,8100,7740,360,4.4,702
"Scurry County, TX",TX,2011,7398,6965,433,5.9,287
"Scurry County, TX",TX,2010,7111,6625,486,6.8,0
"Searcy County, AR",AR,2021,2920,2796,124,4.2,42
"Searcy County, AR",AR,2020,2878,2692,186,6.5,-30
"Searcy County, AR",AR,2019,2908,2779,129,4.4,-16
"Searcy County, AR",AR,2018,2924,2799,125,4.3,-11
"Searcy County, AR",AR,2017,2935,2798,137,4.7,-59
"Searcy County, AR",AR,2016,2994,2857,137,4.6,-45
"Searcy County, AR",AR,2015,3039,2870,169,5.6,23
"Searcy County, AR",AR,2014,3016,2829,187,6.2,-127
"Searcy County, AR",AR,2013,3143,2899,244,7.8,-89
"Searcy County, AR",AR,2012,3232,2977,255,7.9,-86
"Searcy County, AR",AR,2011,3318,3028,290,8.7,-70
"Searcy County, AR",AR,2010,3388,3088,300,8.9,0
"Sebastian County, AR",AR,2021,54294,52275,2019,3.7,-1791
"Sebastian County, AR",AR,2020,56085,52716,3369,6.0,-750
"Sebastian County, AR",AR,2019,56835,55011,1824,3.2,45
"Sebastian County, AR",AR,2018,56790,54795,1995,3.5,-418
"Sebastian County, AR",AR,2017,57208,55131,2077,3.6,-489
"Sebastian County, AR",AR,2016,57697,55543,2154,3.7,-274
"Sebastian County, AR",AR,2015,57971,55224,2747,4.7,349
"Sebastian County, AR",AR,2014,57622,54425,3197,5.5,-860
"Sebastian County, AR",AR,2013,58482,54232,4250,7.3,-779
"Sebastian County, AR",AR,2012,59261,54791,4470,7.5,-39
"Sebastian County, AR",AR,2011,59300,54399,4901,8.3,-172
"Sebastian County, AR",AR,2010,59472,54881,4591,7.7,0
"Sedgwick County, CO",CO,2021,1185,1141,44,3.7,31
"Sedgwick County, CO",CO,2020,1154,1115,39,3.4,-32
"Sedgwick County, CO",CO,2019,1186,1164,22,1.9,9
"Sedgwick County, CO",CO,2018,1177,1149,28,2.4,-4
"Sedgwick County, CO",CO,2017,1181,1157,24,2.0,3
"Sedgwick County, CO",CO,2016,1178,1152,26,2.2,32
"Sedgwick County, CO",CO,2015,1146,1109,37,3.2,60
"Sedgwick County, CO",CO,2014,1086,1036,50,4.6,-4
"Sedgwick County, CO",CO,2013,1090,1023,67,6.1,-26
"Sedgwick County, CO",CO,2012,1116,1037,79,7.1,22
"Sedgwick County, CO",CO,2011,1094,1003,91,8.3,-3
"Sedgwick County, CO",CO,2010,1097,1011,86,7.8,0
"Sedgwick County, KS",KS,2021,255086,243391,11695,4.6,-2398
"Sedgwick County, KS",KS,2020,257484,235491,21993,8.5,3652
"Sedgwick County, KS",KS,2019,253832,245173,8659,3.4,5369
"Sedgwick County, KS",KS,2018,248463,239315,9148,3.7,1983
"Sedgwick County, KS",KS,2017,246480,236093,10387,4.2,-1915
"Sedgwick County, KS",KS,2016,248395,236886,11509,4.6,956
"Sedgwick County, KS",KS,2015,247439,235654,11785,4.8,101
"Sedgwick County, KS",KS,2014,247338,234148,13190,5.3,518
"Sedgwick County, KS",KS,2013,246820,231648,15172,6.1,-827
"Sedgwick County, KS",KS,2012,247647,230665,16982,6.9,-2613
"Sedgwick County, KS",KS,2011,250260,230687,19573,7.8,-2292
"Sedgwick County, KS",KS,2010,252552,230696,21856,8.7,0
"Seminole County, FL",FL,2021,244546,234590,9956,4.1,6966
"Seminole County, FL",FL,2020,237580,219095,18485,7.8,-14379
"Seminole County, FL",FL,2019,251959,244386,7573,3.0,3727
"Seminole County, FL",FL,2018,248232,239979,8253,3.3,2937
"Seminole County, FL",FL,2017,245295,235999,9296,3.8,2483
"Seminole County, FL",FL,2016,242812,232335,10477,4.3,5263
"Seminole County, FL",FL,2015,237549,225741,11808,5.0,1897
"Seminole County, FL",FL,2014,235652,221800,13852,5.9,3343
"Seminole County, FL",FL,2013,232309,216145,16164,7.0,2687
"Seminole County, FL",FL,2012,229622,210480,19142,8.3,359
"Seminole County, FL",FL,2011,229263,207265,21998,9.6,550
"Seminole County, FL",FL,2010,228713,205181,23532,10.3,0
"Seminole County, GA",GA,2021,3059,2945,114,3.7,-37
"Seminole County, GA",GA,2020,3096,2942,154,5.0,-14
"Seminole County, GA",GA,2019,3110,2972,138,4.4,60
"Seminole County, GA",GA,2018,3050,2886,164,5.4,-67
"Seminole County, GA",GA,2017,3117,2915,202,6.5,24
"Seminole County, GA",GA,2016,3093,2846,247,8.0,36
"Seminole County, GA",GA,2015,3057,2805,252,8.2,-58
"Seminole County, GA",GA,2014,3115,2820,295,9.5,-20
"Seminole County, GA",GA,2013,3135,2816,319,10.2,-107
"Seminole County, GA",GA,2012,3242,2893,349,10.8,-26
"Seminole County, GA",GA,2011,3268,2857,411,12.6,-127
"Seminole County, GA",GA,2010,3395,2963,432,12.7,0
"Seminole County, OK",OK,2021,9125,8662,463,5.1,-45
"Seminole County, OK",OK,2020,9170,8479,691,7.5,-222
"Seminole County, OK",OK,2019,9392,8963,429,4.6,-69
"Seminole County, OK",OK,2018,9461,9031,430,4.5,57
"Seminole County, OK",OK,2017,9404,8896,508,5.4,-20
"Seminole County, OK",OK,2016,9424,8795,629,6.7,-168
"Seminole County, OK",OK,2015,9592,8954,638,6.7,38
"Seminole County, OK",OK,2014,9554,8922,632,6.6,-162
"Seminole County, OK",OK,2013,9716,8945,771,7.9,-229
"Seminole County, OK",OK,2012,9945,9189,756,7.6,15
"Seminole County, OK",OK,2011,9930,9143,787,7.9,33
"Seminole County, OK",OK,2010,9897,8987,910,9.2,0
"Seneca County, NY",NY,2021,15025,14317,708,4.7,-491
"Seneca County, NY",NY,2020,15516,14305,1211,7.8,-808
"Seneca County, NY",NY,2019,16324,15722,602,3.7,-113
"Seneca County, NY",NY,2018,16437,15807,630,3.8,67
"Seneca County, NY",NY,2017,16370,15631,739,4.5,876
"Seneca County, NY",NY,2016,15494,14743,751,4.8,-205
"Seneca County, NY",NY,2015,15699,14883,816,5.2,202
"Seneca County, NY",NY,2014,15497,14616,881,5.7,-404
"Seneca County, NY",NY,2013,15901,14770,1131,7.1,-316
"Seneca County, NY",NY,2012,16217,14905,1312,8.1,90
"Seneca County, NY",NY,2011,16127,14840,1287,8.0,-312
"Seneca County, NY",NY,2010,16439,15065,1374,8.4,0
"Seneca County, OH",OH,2021,26771,25509,1262,4.7,-337
"Seneca County, OH",OH,2020,27108,24912,2196,8.1,-548
"Seneca County, OH",OH,2019,27656,26502,1154,4.2,308
"Seneca County, OH",OH,2018,27348,26146,1202,4.4,-197
"Seneca County, OH",OH,2017,27545,26244,1301,4.7,286
"Seneca County, OH",OH,2016,27259,25914,1345,4.9,26
"Seneca County, OH",OH,2015,27233,25903,1330,4.9,0
"Seneca County, OH",OH,2014,27233,25671,1562,5.7,-160
"Seneca County, OH",OH,2013,27393,25273,2120,7.7,-409
"Seneca County, OH",OH,2012,27802,25591,2211,8.0,-920
"Seneca County, OH",OH,2011,28722,25960,2762,9.6,-781
"Seneca County, OH",OH,2010,29503,25974,3529,12.0,0
"Sequatchie County, TN",TN,2021,6189,5916,273,4.4,23
"Sequatchie County, TN",TN,2020,6166,5690,476,7.7,-94
"Sequatchie County, TN",TN,2019,6260,5996,264,4.2,155
"Sequatchie County, TN",TN,2018,6105,5842,263,4.3,138
"Sequatchie County, TN",TN,2017,5967,5666,301,5.0,41
"Sequatchie County, TN",TN,2016,5926,5579,347,5.9,120
"Sequatchie County, TN",TN,2015,5806,5432,374,6.4,60
"Sequatchie County, TN",TN,2014,5746,5316,430,7.5,-184
"Sequatchie County, TN",TN,2013,5930,5421,509,8.6,-22
"Sequatchie County, TN",TN,2012,5952,5444,508,8.5,-127
"Sequatchie County, TN",TN,2011,6079,5449,630,10.4,-29
"Sequatchie County, TN",TN,2010,6108,5358,750,12.3,0
"Sequoyah County, OK",OK,2021,16550,15832,718,4.3,172
"Sequoyah County, OK",OK,2020,16378,15242,1136,6.9,98
"Sequoyah County, OK",OK,2019,16280,15650,630,3.9,-4
"Sequoyah County, OK",OK,2018,16284,15609,675,4.1,-224
"Sequoyah County, OK",OK,2017,16508,15652,856,5.2,-307
"Sequoyah County, OK",OK,2016,16815,15799,1016,6.0,60
"Sequoyah County, OK",OK,2015,16755,15718,1037,6.2,98
"Sequoyah County, OK",OK,2014,16657,15558,1099,6.6,-165
"Sequoyah County, OK",OK,2013,16822,15457,1365,8.1,-315
"Sequoyah County, OK",OK,2012,17137,15756,1381,8.1,-245
"Sequoyah County, OK",OK,2011,17382,15870,1512,8.7,-651
"Sequoyah County, OK",OK,2010,18033,16387,1646,9.1,0
"Sevier County, AR",AR,2021,5368,5132,236,4.4,-175
"Sevier County, AR",AR,2020,5543,5218,325,5.9,17
"Sevier County, AR",AR,2019,5526,5267,259,4.7,-68
"Sevier County, AR",AR,2018,5594,5341,253,4.5,-71
"Sevier County, AR",AR,2017,5665,5407,258,4.6,-39
"Sevier County, AR",AR,2016,5704,5427,277,4.9,16
"Sevier County, AR",AR,2015,5688,5348,340,6.0,-201
"Sevier County, AR",AR,2014,5889,5491,398,6.8,-129
"Sevier County, AR",AR,2013,6018,5533,485,8.1,-206
"Sevier County, AR",AR,2012,6224,5706,518,8.3,-178
"Sevier County, AR",AR,2011,6402,5842,560,8.7,-687
"Sevier County, AR",AR,2010,7089,6613,476,6.7,0
"Sevier County, TN",TN,2021,54854,52705,2149,3.9,755
"Sevier County, TN",TN,2020,54099,48842,5257,9.7,-1030
"Sevier County, TN",TN,2019,55129,53320,1809,3.3,1836
"Sevier County, TN",TN,2018,53293,51443,1850,3.5,1085
"Sevier County, TN",TN,2017,52208,50105,2103,4.0,969
"Sevier County, TN",TN,2016,51239,48696,2543,5.0,1281
"Sevier County, TN",TN,2015,49958,46972,2986,6.0,946
"Sevier County, TN",TN,2014,49012,45496,3516,7.2,-139
"Sevier County, TN",TN,2013,49151,45012,4139,8.4,-289
"Sevier County, TN",TN,2012,49440,45030,4410,8.9,-162
"Sevier County, TN",TN,2011,49602,44566,5036,10.2,486
"Sevier County, TN",TN,2010,49116,43917,5199,10.6,0
"Sevier County, UT",UT,2021,9992,9666,326,3.3,91
"Sevier County, UT",UT,2020,9901,9477,424,4.3,91
"Sevier County, UT",UT,2019,9810,9512,298,3.0,-137
"Sevier County, UT",UT,2018,9947,9613,334,3.4,119
"Sevier County, UT",UT,2017,9828,9462,366,3.7,277
"Sevier County, UT",UT,2016,9551,9145,406,4.3,91
"Sevier County, UT",UT,2015,9460,9047,413,4.4,274
"Sevier County, UT",UT,2014,9186,8792,394,4.3,59
"Sevier County, UT",UT,2013,9127,8673,454,5.0,-116
"Sevier County, UT",UT,2012,9243,8744,499,5.4,-193
"Sevier County, UT",UT,2011,9436,8708,728,7.7,-244
"Sevier County, UT",UT,2010,9680,8867,813,8.4,0
"Seward County, KS",KS,2021,9863,9588,275,2.8,68
"Seward County, KS",KS,2020,9795,9396,399,4.1,215
"Seward County, KS",KS,2019,9580,9289,291,3.0,-30
"Seward County, KS",KS,2018,9610,9307,303,3.2,-260
"Seward County, KS",KS,2017,9870,9526,344,3.5,-408
"Seward County, KS",KS,2016,10278,9831,447,4.3,-373
"Seward County, KS",KS,2015,10651,10193,458,4.3,-522
"Seward County, KS",KS,2014,11173,10785,388,3.5,66
"Seward County, KS",KS,2013,11107,10652,455,4.1,237
"Seward County, KS",KS,2012,10870,10424,446,4.1,-5
"Seward County, KS",KS,2011,10875,10381,494,4.5,79
"Seward County, KS",KS,2010,10796,10270,526,4.9,0
"Seward County, NE",NE,2021,8854,8636,218,2.5,7
"Seward County, NE",NE,2020,8847,8492,355,4.0,-138
"Seward County, NE",NE,2019,8985,8721,264,2.9,95
"Seward County, NE",NE,2018,8890,8653,237,2.7,195
"Seward County, NE",NE,2017,8695,8458,237,2.7,-107
"Seward County, NE",NE,2016,8802,8551,251,2.9,71
"Seward County, NE",NE,2015,8731,8478,253,2.9,-120
"Seward County, NE",NE,2014,8851,8581,270,3.1,-141
"Seward County, NE",NE,2013,8992,8668,324,3.6,53
"Seward County, NE",NE,2012,8939,8633,306,3.4,169
"Seward County, NE",NE,2011,8770,8432,338,3.9,18
"Seward County, NE",NE,2010,8752,8395,357,4.1,0
"Shackelford County, TX",TX,2021,1845,1771,74,4.0,82
"Shackelford County, TX",TX,2020,1763,1670,93,5.3,-119
"Shackelford County, TX",TX,2019,1882,1841,41,2.2,-43
"Shackelford County, TX",TX,2018,1925,1880,45,2.3,51
"Shackelford County, TX",TX,2017,1874,1818,56,3.0,-4
"Shackelford County, TX",TX,2016,1878,1806,72,3.8,-205
"Shackelford County, TX",TX,2015,2083,2023,60,2.9,-287
"Shackelford County, TX",TX,2014,2370,2304,66,2.8,78
"Shackelford County, TX",TX,2013,2292,2216,76,3.3,84
"Shackelford County, TX",TX,2012,2208,2131,77,3.5,204
"Shackelford County, TX",TX,2011,2004,1906,98,4.9,97
"Shackelford County, TX",TX,2010,1907,1800,107,5.6,0
"Shannon County, MO",MO,2021,3366,3177,189,5.6,22
"Shannon County, MO",MO,2020,3344,3103,241,7.2,121
"Shannon County, MO",MO,2019,3223,3055,168,5.2,-9
"Shannon County, MO",MO,2018,3232,3074,158,4.9,-47
"Shannon County, MO",MO,2017,3279,3082,197,6.0,-43
"Shannon County, MO",MO,2016,3322,3079,243,7.3,2
"Shannon County, MO",MO,2015,3320,3044,276,8.3,-96
"Shannon County, MO",MO,2014,3416,3093,323,9.5,57
"Shannon County, MO",MO,2013,3359,3036,323,9.6,313
"Shannon County, MO",MO,2012,3046,2700,346,11.4,-76
"Shannon County, MO",MO,2011,3122,2704,418,13.4,-105
"Shannon County, MO",MO,2010,3227,2752,475,14.7,0
"Sharkey County, MS",MS,2021,1401,1270,131,9.4,-50
"Sharkey County, MS",MS,2020,1451,1296,155,10.7,-28
"Sharkey County, MS",MS,2019,1479,1344,135,9.1,-127
"Sharkey County, MS",MS,2018,1606,1485,121,7.5,-5
"Sharkey County, MS",MS,2017,1611,1479,132,8.2,-97
"Sharkey County, MS",MS,2016,1708,1555,153,9.0,-15
"Sharkey County, MS",MS,2015,1723,1555,168,9.8,-41
"Sharkey County, MS",MS,2014,1764,1568,196,11.1,-80
"Sharkey County, MS",MS,2013,1844,1605,239,13.0,-112
"Sharkey County, MS",MS,2012,1956,1696,260,13.3,-71
"Sharkey County, MS",MS,2011,2027,1738,289,14.3,-33
"Sharkey County, MS",MS,2010,2060,1769,291,14.1,0
"Sharp County, AR",AR,2021,5630,5353,277,4.9,-87
"Sharp County, AR",AR,2020,5717,5306,411,7.2,-45
"Sharp County, AR",AR,2019,5762,5483,279,4.8,-19
"Sharp County, AR",AR,2018,5781,5508,273,4.7,-180
"Sharp County, AR",AR,2017,5961,5660,301,5.0,-101
"Sharp County, AR",AR,2016,6062,5731,331,5.5,34
"Sharp County, AR",AR,2015,6028,5618,410,6.8,22
"Sharp County, AR",AR,2014,6006,5510,496,8.3,-44
"Sharp County, AR",AR,2013,6050,5475,575,9.5,-77
"Sharp County, AR",AR,2012,6127,5529,598,9.8,-132
"Sharp County, AR",AR,2011,6259,5617,642,10.3,-43
"Sharp County, AR",AR,2010,6302,5706,596,9.5,0
"Shasta County, CA",CA,2021,72809,67834,4975,6.8,-320
"Shasta County, CA",CA,2020,73129,66563,6566,9.0,175
"Shasta County, CA",CA,2019,72954,69421,3533,4.8,-934
"Shasta County, CA",CA,2018,73888,70163,3725,5.0,-24
"Shasta County, CA",CA,2017,73912,69594,4318,5.8,-295
"Shasta County, CA",CA,2016,74207,69019,5188,7.0,85
"Shasta County, CA",CA,2015,74122,68325,5797,7.8,-619
"Shasta County, CA",CA,2014,74741,67469,7272,9.7,-308
"Shasta County, CA",CA,2013,75049,66069,8980,12.0,-855
"Shasta County, CA",CA,2012,75904,64968,10936,14.4,-1086
"Shasta County, CA",CA,2011,76990,64507,12483,16.2,-1690
"Shasta County, CA",CA,2010,78680,65168,13512,17.2,0
"Shawano County, WI",WI,2021,21183,20394,789,3.7,207
"Shawano County, WI",WI,2020,20976,19627,1349,6.4,-171
"Shawano County, WI",WI,2019,21147,20499,648,3.1,-328
"Shawano County, WI",WI,2018,21475,20834,641,3.0,-35
"Shawano County, WI",WI,2017,21510,20824,686,3.2,275
"Shawano County, WI",WI,2016,21235,20375,860,4.0,4
"Shawano County, WI",WI,2015,21231,20221,1010,4.8,-39
"Shawano County, WI",WI,2014,21270,20026,1244,5.8,-190
"Shawano County, WI",WI,2013,21460,19869,1591,7.4,-133
"Shawano County, WI",WI,2012,21593,19894,1699,7.9,-125
"Shawano County, WI",WI,2011,21718,19784,1934,8.9,-174
"Shawano County, WI",WI,2010,21892,19689,2203,10.1,0
"Shawnee County, KS",KS,2021,91236,88399,2837,3.1,153
"Shawnee County, KS",KS,2020,91083,85929,5154,5.7,234
"Shawnee County, KS",KS,2019,90849,87860,2989,3.3,-273
"Shawnee County, KS",KS,2018,91122,88019,3103,3.4,-564
"Shawnee County, KS",KS,2017,91686,88343,3343,3.6,-415
"Shawnee County, KS",KS,2016,92101,88415,3686,4.0,623
"Shawnee County, KS",KS,2015,91478,87603,3875,4.2,-523
"Shawnee County, KS",KS,2014,92001,87642,4359,4.7,-250
"Shawnee County, KS",KS,2013,92251,86921,5330,5.8,-78
"Shawnee County, KS",KS,2012,92329,86629,5700,6.2,-1039
"Shawnee County, KS",KS,2011,93368,87134,6234,6.7,-210
"Shawnee County, KS",KS,2010,93578,87123,6455,6.9,0
"Sheboygan County, WI",WI,2021,62287,60350,1937,3.1,210
"Sheboygan County, WI",WI,2020,62077,58505,3572,5.8,-385
"Sheboygan County, WI",WI,2019,62462,60834,1628,2.6,-274
"Sheboygan County, WI",WI,2018,62736,61177,1559,2.5,-22
"Sheboygan County, WI",WI,2017,62758,61028,1730,2.8,1179
"Sheboygan County, WI",WI,2016,61579,59535,2044,3.3,469
"Sheboygan County, WI",WI,2015,61110,58857,2253,3.7,-41
"Sheboygan County, WI",WI,2014,61151,58410,2741,4.5,406
"Sheboygan County, WI",WI,2013,60745,57074,3671,6.0,507
"Sheboygan County, WI",WI,2012,60238,56175,4063,6.7,-661
"Sheboygan County, WI",WI,2011,60899,56044,4855,8.0,-1370
"Sheboygan County, WI",WI,2010,62269,56584,5685,9.1,0
"Shelby County, AL",AL,2021,118212,115683,2529,2.1,332
"Shelby County, AL",AL,2020,117880,112894,4986,4.2,-289
"Shelby County, AL",AL,2019,118169,115441,2728,2.3,2315
"Shelby County, AL",AL,2018,115854,112588,3266,2.8,3263
"Shelby County, AL",AL,2017,112591,108871,3720,3.3,3921
"Shelby County, AL",AL,2016,108670,103986,4684,4.3,738
"Shelby County, AL",AL,2015,107932,103362,4570,4.2,519
"Shelby County, AL",AL,2014,107413,102624,4789,4.5,552
"Shelby County, AL",AL,2013,106861,101840,5021,4.7,1387
"Shelby County, AL",AL,2012,105474,100036,5438,5.2,1265
"Shelby County, AL",AL,2011,104209,97774,6435,6.2,1743
"Shelby County, AL",AL,2010,102466,95317,7149,7.0,0
"Shelby County, IA",IA,2021,6327,6124,203,3.2,-63
"Shelby County, IA",IA,2020,6390,6165,225,3.5,-412
"Shelby County, IA",IA,2019,6802,6665,137,2.0,55
"Shelby County, IA",IA,2018,6747,6613,134,2.0,3
"Shelby County, IA",IA,2017,6744,6586,158,2.3,-115
"Shelby County, IA",IA,2016,6859,6659,200,2.9,-161
"Shelby County, IA",IA,2015,7020,6821,199,2.8,-33
"Shelby County, IA",IA,2014,7053,6833,220,3.1,103
"Shelby County, IA",IA,2013,6950,6689,261,3.8,-69
"Shelby County, IA",IA,2012,7019,6754,265,3.8,275
"Shelby County, IA",IA,2011,6744,6448,296,4.4,151
"Shelby County, IA",IA,2010,6593,6288,305,4.6,0
"Shelby County, IL",IL,2021,10192,9768,424,4.2,-18
"Shelby County, IL",IL,2020,10210,9539,671,6.6,-436
"Shelby County, IL",IL,2019,10646,10250,396,3.7,-111
"Shelby County, IL",IL,2018,10757,10301,456,4.2,330
"Shelby County, IL",IL,2017,10427,9966,461,4.4,-12
"Shelby County, IL",IL,2016,10439,9842,597,5.7,178
"Shelby County, IL",IL,2015,10261,9656,605,5.9,103
"Shelby County, IL",IL,2014,10158,9466,692,6.8,-144
"Shelby County, IL",IL,2013,10302,9403,899,8.7,-455
"Shelby County, IL",IL,2012,10757,9829,928,8.6,-272
"Shelby County, IL",IL,2011,11029,10024,1005,9.1,-170
"Shelby County, IL",IL,2010,11199,10103,1096,9.8,0
"Shelby County, IN",IN,2021,23037,22337,700,3.0,18
"Shelby County, IN",IN,2020,23019,21342,1677,7.3,-227
"Shelby County, IN",IN,2019,23246,22580,666,2.9,122
"Shelby County, IN",IN,2018,23124,22413,711,3.1,238
"Shelby County, IN",IN,2017,22886,22132,754,3.3,-94
"Shelby County, IN",IN,2016,22980,22074,906,3.9,357
"Shelby County, IN",IN,2015,22623,21623,1000,4.4,176
"Shelby County, IN",IN,2014,22447,21174,1273,5.7,65
"Shelby County, IN",IN,2013,22382,20771,1611,7.2,46
"Shelby County, IN",IN,2012,22336,20498,1838,8.2,-227
"Shelby County, IN",IN,2011,22563,20468,2095,9.3,-150
"Shelby County, IN",IN,2010,22713,20289,2424,10.7,0
"Shelby County, KY",KY,2021,25837,24857,980,3.8,427
"Shelby County, KY",KY,2020,25410,24072,1338,5.3,-459
"Shelby County, KY",KY,2019,25869,25036,833,3.2,403
"Shelby County, KY",KY,2018,25466,24612,854,3.4,751
"Shelby County, KY",KY,2017,24715,23841,874,3.5,904
"Shelby County, KY",KY,2016,23811,22972,839,3.5,914
"Shelby County, KY",KY,2015,22897,21987,910,4.0,388
"Shelby County, KY",KY,2014,22509,21400,1109,4.9,-123
"Shelby County, KY",KY,2013,22632,21271,1361,6.0,347
"Shelby County, KY",KY,2012,22285,20887,1398,6.3,261
"Shelby County, KY",KY,2011,22024,20279,1745,7.9,63
"Shelby County, KY",KY,2010,21961,19982,1979,9.0,0
"Shelby County, MO",MO,2021,2985,2886,99,3.3,-44
"Shelby County, MO",MO,2020,3029,2895,134,4.4,6
"Shelby County, MO",MO,2019,3023,2939,84,2.8,6
"Shelby County, MO",MO,2018,3017,2926,91,3.0,-75
"Shelby County, MO",MO,2017,3092,2987,105,3.4,23
"Shelby County, MO",MO,2016,3069,2940,129,4.2,11
"Shelby County, MO",MO,2015,3058,2911,147,4.8,11
"Shelby County, MO",MO,2014,3047,2863,184,6.0,-6
"Shelby County, MO",MO,2013,3053,2881,172,5.6,-50
"Shelby County, MO",MO,2012,3103,2910,193,6.2,-85
"Shelby County, MO",MO,2011,3188,2955,233,7.3,-40
"Shelby County, MO",MO,2010,3228,2952,276,8.6,0
"Shelby County, OH",OH,2021,23791,22797,994,4.2,-149
"Shelby County, OH",OH,2020,23940,22093,1847,7.7,-435
"Shelby County, OH",OH,2019,24375,23505,870,3.6,278
"Shelby County, OH",OH,2018,24097,23194,903,3.7,-68
"Shelby County, OH",OH,2017,24165,23168,997,4.1,-2
"Shelby County, OH",OH,2016,24167,23158,1009,4.2,10
"Shelby County, OH",OH,2015,24157,23107,1050,4.3,444
"Shelby County, OH",OH,2014,23713,22504,1209,5.1,-32
"Shelby County, OH",OH,2013,23745,22159,1586,6.7,-101
"Shelby County, OH",OH,2012,23846,22111,1735,7.3,-322
"Shelby County, OH",OH,2011,24168,21837,2331,9.6,-839
"Shelby County, OH",OH,2010,25007,21892,3115,12.5,0
"Shelby County, TN",TN,2021,447442,416969,30473,6.8,269
"Shelby County, TN",TN,2020,447173,404828,42345,9.5,-1873
"Shelby County, TN",TN,2019,449046,431035,18011,4.0,6440
"Shelby County, TN",TN,2018,442606,424233,18373,4.2,4872
"Shelby County, TN",TN,2017,437734,418685,19049,4.4,3232
"Shelby County, TN",TN,2016,434502,411215,23287,5.4,3610
"Shelby County, TN",TN,2015,430892,403447,27445,6.4,346
"Shelby County, TN",TN,2014,430546,397700,32846,7.6,-9724
"Shelby County, TN",TN,2013,440270,401636,38634,8.8,-5313
"Shelby County, TN",TN,2012,445583,406551,39032,8.8,-4645
"Shelby County, TN",TN,2011,450228,406712,43516,9.7,1111
"Shelby County, TN",TN,2010,449117,404611,44506,9.9,0
"Shelby County, TX",TX,2021,11484,10862,622,5.4,346
"Shelby County, TX",TX,2020,11138,10377,761,6.8,122
"Shelby County, TX",TX,2019,11016,10583,433,3.9,99
"Shelby County, TX",TX,2018,10917,10444,473,4.3,217
"Shelby County, TX",TX,2017,10700,10143,557,5.2,-259
"Shelby County, TX",TX,2016,10959,10300,659,6.0,-424
"Shelby County, TX",TX,2015,11383,10780,603,5.3,-215
"Shelby County, TX",TX,2014,11598,10911,687,5.9,-12
"Shelby County, TX",TX,2013,11610,10741,869,7.5,-487
"Shelby County, TX",TX,2012,12097,11224,873,7.2,121
"Shelby County, TX",TX,2011,11976,10918,1058,8.8,119
"Shelby County, TX",TX,2010,11857,10848,1009,8.5,0
"Shenandoah County, VA",VA,2021,21572,20802,770,3.6,-603
"Shenandoah County, VA",VA,2020,22175,21008,1167,5.3,-378
"Shenandoah County, VA",VA,2019,22553,21987,566,2.5,161
"Shenandoah County, VA",VA,2018,22392,21761,631,2.8,561
"Shenandoah County, VA",VA,2017,21831,21100,731,3.3,975
"Shenandoah County, VA",VA,2016,20856,20084,772,3.7,-264
"Shenandoah County, VA",VA,2015,21120,20230,890,4.2,-178
"Shenandoah County, VA",VA,2014,21298,20253,1045,4.9,353
"Shenandoah County, VA",VA,2013,20945,19798,1147,5.5,145
"Shenandoah County, VA",VA,2012,20800,19504,1296,6.2,-247
"Shenandoah County, VA",VA,2011,21047,19571,1476,7.0,182
"Shenandoah County, VA",VA,2010,20865,19108,1757,8.4,0
"Sherburne County, MN",MN,2021,52101,50294,1807,3.5,-1469
"Sherburne County, MN",MN,2020,53570,50229,3341,6.2,-5
"Sherburne County, MN",MN,2019,53575,51580,1995,3.7,1169
"Sherburne County, MN",MN,2018,52406,50640,1766,3.4,809
"Sherburne County, MN",MN,2017,51597,49655,1942,3.8,933
"Sherburne County, MN",MN,2016,50664,48603,2061,4.1,1073
"Sherburne County, MN",MN,2015,49591,47561,2030,4.1,272
"Sherburne County, MN",MN,2014,49319,47028,2291,4.6,478
"Sherburne County, MN",MN,2013,48841,46196,2645,5.4,161
"Sherburne County, MN",MN,2012,48680,45645,3035,6.2,-303
"Sherburne County, MN",MN,2011,48983,45468,3515,7.2,-50
"Sherburne County, MN",MN,2010,49033,44890,4143,8.4,0
"Sheridan County, KS",KS,2021,1465,1438,27,1.8,0
"Sheridan County, KS",KS,2020,1465,1432,33,2.3,47
"Sheridan County, KS",KS,2019,1418,1387,31,2.2,-9
"Sheridan County, KS",KS,2018,1427,1396,31,2.2,49
"Sheridan County, KS",KS,2017,1378,1347,31,2.2,-78
"Sheridan County, KS",KS,2016,1456,1421,35,2.4,-30
"Sheridan County, KS",KS,2015,1486,1453,33,2.2,25
"Sheridan County, KS",KS,2014,1461,1423,38,2.6,-40
"Sheridan County, KS",KS,2013,1501,1460,41,2.7,-51
"Sheridan County, KS",KS,2012,1552,1509,43,2.8,18
"Sheridan County, KS",KS,2011,1534,1486,48,3.1,20
"Sheridan County, KS",KS,2010,1514,1464,50,3.3,0
"Sheridan County, MT",MT,2021,1784,1725,59,3.3,20
"Sheridan County, MT",MT,2020,1764,1681,83,4.7,5
"Sheridan County, MT",MT,2019,1759,1719,40,2.3,-13
"Sheridan County, MT",MT,2018,1772,1731,41,2.3,-102
"Sheridan County, MT",MT,2017,1874,1823,51,2.7,-84
"Sheridan County, MT",MT,2016,1958,1892,66,3.4,-117
"Sheridan County, MT",MT,2015,2075,2022,53,2.6,-55
"Sheridan County, MT",MT,2014,2130,2074,56,2.6,-44
"Sheridan County, MT",MT,2013,2174,2114,60,2.8,113
"Sheridan County, MT",MT,2012,2061,2002,59,2.9,174
"Sheridan County, MT",MT,2011,1887,1823,64,3.4,65
"Sheridan County, MT",MT,2010,1822,1756,66,3.6,0
"Sheridan County, ND",ND,2021,661,626,35,5.3,-22
"Sheridan County, ND",ND,2020,683,643,40,5.9,0
"Sheridan County, ND",ND,2019,683,656,27,4.0,-14
"Sheridan County, ND",ND,2018,697,668,29,4.2,-45
"Sheridan County, ND",ND,2017,742,709,33,4.4,8
"Sheridan County, ND",ND,2016,734,693,41,5.6,14
"Sheridan County, ND",ND,2015,720,684,36,5.0,3
"Sheridan County, ND",ND,2014,717,682,35,4.9,8
"Sheridan County, ND",ND,2013,709,681,28,3.9,-24
"Sheridan County, ND",ND,2012,733,707,26,3.5,-64
"Sheridan County, ND",ND,2011,797,766,31,3.9,-15
"Sheridan County, ND",ND,2010,812,781,31,3.8,0
"Sheridan County, NE",NE,2021,2755,2705,50,1.8,20
"Sheridan County, NE",NE,2020,2735,2671,64,2.3,27
"Sheridan County, NE",NE,2019,2708,2634,74,2.7,3
"Sheridan County, NE",NE,2018,2705,2635,70,2.6,-34
"Sheridan County, NE",NE,2017,2739,2666,73,2.7,-14
"Sheridan County, NE",NE,2016,2753,2675,78,2.8,12
"Sheridan County, NE",NE,2015,2741,2667,74,2.7,-41
"Sheridan County, NE",NE,2014,2782,2710,72,2.6,-10
"Sheridan County, NE",NE,2013,2792,2703,89,3.2,-9
"Sheridan County, NE",NE,2012,2801,2704,97,3.5,-32
"Sheridan County, NE",NE,2011,2833,2731,102,3.6,16
"Sheridan County, NE",NE,2010,2817,2715,102,3.6,0
"Sheridan County, WY",WY,2021,16018,15344,674,4.2,16
"Sheridan County, WY",WY,2020,16002,15210,792,4.9,410
"Sheridan County, WY",WY,2019,15592,15020,572,3.7,-214
"Sheridan County, WY",WY,2018,15806,15165,641,4.1,-37
"Sheridan County, WY",WY,2017,15843,15205,638,4.0,-284
"Sheridan County, WY",WY,2016,16127,15363,764,4.7,328
"Sheridan County, WY",WY,2015,15799,15139,660,4.2,73
"Sheridan County, WY",WY,2014,15726,14963,763,4.9,161
"Sheridan County, WY",WY,2013,15565,14701,864,5.6,-161
"Sheridan County, WY",WY,2012,15726,14720,1006,6.4,-143
"Sheridan County, WY",WY,2011,15869,14706,1163,7.3,-197
"Sheridan County, WY",WY,2010,16066,14804,1262,7.9,0
"Sherman County, KS",KS,2021,2856,2784,72,2.5,-14
"Sherman County, KS",KS,2020,2870,2778,92,3.2,-4
"Sherman County, KS",KS,2019,2874,2797,77,2.7,-33
"Sherman County, KS",KS,2018,2907,2828,79,2.7,1
"Sherman County, KS",KS,2017,2906,2823,83,2.9,-48
"Sherman County, KS",KS,2016,2954,2857,97,3.3,-145
"Sherman County, KS",KS,2015,3099,3009,90,2.9,4
"Sherman County, KS",KS,2014,3095,2997,98,3.2,-41
"Sherman County, KS",KS,2013,3136,3010,126,4.0,-93
"Sherman County, KS",KS,2012,3229,3106,123,3.8,8
"Sherman County, KS",KS,2011,3221,3093,128,4.0,67
"Sherman County, KS",KS,2010,3154,3006,148,4.7,0
"Sherman County, NE",NE,2021,1701,1666,35,2.1,23
"Sherman County, NE",NE,2020,1678,1626,52,3.1,-18
"Sherman County, NE",NE,2019,1696,1641,55,3.2,-15
"Sherman County, NE",NE,2018,1711,1665,46,2.7,2
"Sherman County, NE",NE,2017,1709,1659,50,2.9,-17
"Sherman County, NE",NE,2016,1726,1671,55,3.2,11
"Sherman County, NE",NE,2015,1715,1665,50,2.9,-13
"Sherman County, NE",NE,2014,1728,1671,57,3.3,-7
"Sherman County, NE",NE,2013,1735,1678,57,3.3,-12
"Sherman County, NE",NE,2012,1747,1683,64,3.7,-12
"Sherman County, NE",NE,2011,1759,1683,76,4.3,32
"Sherman County, NE",NE,2010,1727,1656,71,4.1,0
"Sherman County, OR",OR,2021,963,922,41,4.3,-14
"Sherman County, OR",OR,2020,977,916,61,6.2,52
"Sherman County, OR",OR,2019,925,893,32,3.5,33
"Sherman County, OR",OR,2018,892,857,35,3.9,-1
"Sherman County, OR",OR,2017,893,851,42,4.7,1
"Sherman County, OR",OR,2016,892,852,40,4.5,4
"Sherman County, OR",OR,2015,888,835,53,6.0,2
"Sherman County, OR",OR,2014,886,821,65,7.3,15
"Sherman County, OR",OR,2013,871,791,80,9.2,-30
"Sherman County, OR",OR,2012,901,804,97,10.8,-20
"Sherman County, OR",OR,2011,921,818,103,11.2,12
"Sherman County, OR",OR,2010,909,801,108,11.9,0
"Sherman County, TX",TX,2021,1408,1366,42,3.0,113
"Sherman County, TX",TX,2020,1295,1255,40,3.1,-57
"Sherman County, TX",TX,2019,1352,1320,32,2.4,35
"Sherman County, TX",TX,2018,1317,1282,35,2.7,37
"Sherman County, TX",TX,2017,1280,1240,40,3.1,-71
"Sherman County, TX",TX,2016,1351,1311,40,3.0,-70
"Sherman County, TX",TX,2015,1421,1382,39,2.7,-82
"Sherman County, TX",TX,2014,1503,1455,48,3.2,26
"Sherman County, TX",TX,2013,1477,1417,60,4.1,-23
"Sherman County, TX",TX,2012,1500,1438,62,4.1,-76
"Sherman County, TX",TX,2011,1576,1502,74,4.7,19
"Sherman County, TX",TX,2010,1557,1485,72,4.6,0
"Shiawassee County, MI",MI,2021,31704,29908,1796,5.7,-995
"Shiawassee County, MI",MI,2020,32699,29589,3110,9.5,-765
"Shiawassee County, MI",MI,2019,33464,32011,1453,4.3,220
"Shiawassee County, MI",MI,2018,33244,31799,1445,4.3,-130
"Shiawassee County, MI",MI,2017,33374,31679,1695,5.1,-136
"Shiawassee County, MI",MI,2016,33510,31723,1787,5.3,343
"Shiawassee County, MI",MI,2015,33167,31263,1904,5.7,-89
"Shiawassee County, MI",MI,2014,33256,30742,2514,7.6,153
"Shiawassee County, MI",MI,2013,33103,30022,3081,9.3,-114
"Shiawassee County, MI",MI,2012,33217,30073,3144,9.5,-271
"Shiawassee County, MI",MI,2011,33488,30032,3456,10.3,-826
"Shiawassee County, MI",MI,2010,34314,30015,4299,12.5,0
"Shoshone County, ID",ID,2021,5499,5135,364,6.6,26
"Shoshone County, ID",ID,2020,5473,4963,510,9.3,272
"Shoshone County, ID",ID,2019,5201,4891,310,6.0,97
"Shoshone County, ID",ID,2018,5104,4806,298,5.8,35
"Shoshone County, ID",ID,2017,5069,4749,320,6.3,-39
"Shoshone County, ID",ID,2016,5108,4757,351,6.9,-7
"Shoshone County, ID",ID,2015,5115,4746,369,7.2,-45
"Shoshone County, ID",ID,2014,5160,4689,471,9.1,-422
"Shoshone County, ID",ID,2013,5582,4834,748,13.4,-55
"Shoshone County, ID",ID,2012,5637,4881,756,13.4,141
"Shoshone County, ID",ID,2011,5496,4716,780,14.2,14
"Shoshone County, ID",ID,2010,5482,4632,850,15.5,0
"Sibley County, MN",MN,2021,7965,7677,288,3.6,-386
"Sibley County, MN",MN,2020,8351,7869,482,5.8,-225
"Sibley County, MN",MN,2019,8576,8225,351,4.1,28
"Sibley County, MN",MN,2018,8548,8259,289,3.4,97
"Sibley County, MN",MN,2017,8451,8145,306,3.6,-37
"Sibley County, MN",MN,2016,8488,8125,363,4.3,-42
"Sibley County, MN",MN,2015,8530,8169,361,4.2,242
"Sibley County, MN",MN,2014,8288,7896,392,4.7,-41
"Sibley County, MN",MN,2013,8329,7865,464,5.6,-99
"Sibley County, MN",MN,2012,8428,7921,507,6.0,-91
"Sibley County, MN",MN,2011,8519,7929,590,6.9,3
"Sibley County, MN",MN,2010,8516,7841,675,7.9,0
"Sierra County, CA",CA,2021,1304,1226,78,6.0,21
"Sierra County, CA",CA,2020,1283,1176,107,8.3,-47
"Sierra County, CA",CA,2019,1330,1258,72,5.4,53
"Sierra County, CA",CA,2018,1277,1199,78,6.1,-12
"Sierra County, CA",CA,2017,1289,1204,85,6.6,-45
"Sierra County, CA",CA,2016,1334,1232,102,7.6,-28
"Sierra County, CA",CA,2015,1362,1242,120,8.8,-48
"Sierra County, CA",CA,2014,1410,1266,144,10.2,-38
"Sierra County, CA",CA,2013,1448,1261,187,12.9,-19
"Sierra County, CA",CA,2012,1467,1253,214,14.6,-132
"Sierra County, CA",CA,2011,1599,1357,242,15.1,-15
"Sierra County, CA",CA,2010,1614,1361,253,15.7,0
"Sierra County, NM",NM,2021,4074,3742,332,8.1,6
"Sierra County, NM",NM,2020,4068,3704,364,8.9,111
"Sierra County, NM",NM,2019,3957,3689,268,6.8,-173
"Sierra County, NM",NM,2018,4130,3844,286,6.9,-84
"Sierra County, NM",NM,2017,4214,3890,324,7.7,120
"Sierra County, NM",NM,2016,4094,3745,349,8.5,36
"Sierra County, NM",NM,2015,4058,3685,373,9.2,88
"Sierra County, NM",NM,2014,3970,3610,360,9.1,-43
"Sierra County, NM",NM,2013,4013,3623,390,9.7,38
"Sierra County, NM",NM,2012,3975,3593,382,9.6,110
"Sierra County, NM",NM,2011,3865,3497,368,9.5,-128
"Sierra County, NM",NM,2010,3993,3641,352,8.8,0
"Silver Bow County, MT",MT,2021,17489,16854,635,3.6,123
"Silver Bow County, MT",MT,2020,17366,16244,1122,6.5,-94
"Silver Bow County, MT",MT,2019,17460,16784,676,3.9,69
"Silver Bow County, MT",MT,2018,17391,16687,704,4.0,139
"Silver Bow County, MT",MT,2017,17252,16517,735,4.3,68
"Silver Bow County, MT",MT,2016,17184,16421,763,4.4,44
"Silver Bow County, MT",MT,2015,17140,16385,755,4.4,117
"Silver Bow County, MT",MT,2014,17023,16184,839,4.9,-167
"Silver Bow County, MT",MT,2013,17190,16262,928,5.4,-23
"Silver Bow County, MT",MT,2012,17213,16200,1013,5.9,261
"Silver Bow County, MT",MT,2011,16952,15885,1067,6.3,-10
"Silver Bow County, MT",MT,2010,16962,15874,1088,6.4,0
"Simpson County, KY",KY,2021,8850,8479,371,4.2,334
"Simpson County, KY",KY,2020,8516,7917,599,7.0,-403
"Simpson County, KY",KY,2019,8919,8537,382,4.3,70
"Simpson County, KY",KY,2018,8849,8511,338,3.8,117
"Simpson County, KY",KY,2017,8732,8343,389,4.5,341
"Simpson County, KY",KY,2016,8391,8021,370,4.4,69
"Simpson County, KY",KY,2015,8322,7928,394,4.7,-171
"Simpson County, KY",KY,2014,8493,7994,499,5.9,-363
"Simpson County, KY",KY,2013,8856,8197,659,7.4,-112
"Simpson County, KY",KY,2012,8968,8199,769,8.6,336
"Simpson County, KY",KY,2011,8632,7683,949,11.0,-57
"Simpson County, KY",KY,2010,8689,7552,1137,13.1,0
"Simpson County, MS",MS,2021,10514,9967,547,5.2,147
"Simpson County, MS",MS,2020,10367,9677,690,6.7,-403
"Simpson County, MS",MS,2019,10770,10209,561,5.2,52
"Simpson County, MS",MS,2018,10718,10213,505,4.7,-198
"Simpson County, MS",MS,2017,10916,10368,548,5.0,34
"Simpson County, MS",MS,2016,10882,10278,604,5.6,18
"Simpson County, MS",MS,2015,10864,10216,648,6.0,138
"Simpson County, MS",MS,2014,10726,10032,694,6.5,-228
"Simpson County, MS",MS,2013,10954,10147,807,7.4,-453
"Simpson County, MS",MS,2012,11407,10485,922,8.1,-203
"Simpson County, MS",MS,2011,11610,10574,1036,8.9,209
"Simpson County, MS",MS,2010,11401,10358,1043,9.1,0
"Sioux County, IA",IA,2021,21797,21276,521,2.4,487
"Sioux County, IA",IA,2020,21310,20761,549,2.6,-207
"Sioux County, IA",IA,2019,21517,21134,383,1.8,729
"Sioux County, IA",IA,2018,20788,20418,370,1.8,236
"Sioux County, IA",IA,2017,20552,20146,406,2.0,-244
"Sioux County, IA",IA,2016,20796,20323,473,2.3,33
"Sioux County, IA",IA,2015,20763,20258,505,2.4,629
"Sioux County, IA",IA,2014,20134,19544,590,2.9,541
"Sioux County, IA",IA,2013,19593,18916,677,3.5,141
"Sioux County, IA",IA,2012,19452,18778,674,3.5,-157
"Sioux County, IA",IA,2011,19609,18873,736,3.8,-4
"Sioux County, IA",IA,2010,19613,18831,782,4.0,0
"Sioux County, ND",ND,2021,1213,1170,43,3.5,13
"Sioux County, ND",ND,2020,1200,1152,48,4.0,-24
"Sioux County, ND",ND,2019,1224,1182,42,3.4,-42
"Sioux County, ND",ND,2018,1266,1219,47,3.7,-42
"Sioux County, ND",ND,2017,1308,1260,48,3.7,-28
"Sioux County, ND",ND,2016,1336,1277,59,4.4,53
"Sioux County, ND",ND,2015,1283,1227,56,4.4,-3
"Sioux County, ND",ND,2014,1286,1227,59,4.6,-14
"Sioux County, ND",ND,2013,1300,1240,60,4.6,2
"Sioux County, ND",ND,2012,1298,1234,64,4.9,-26
"Sioux County, ND",ND,2011,1324,1255,69,5.2,15
"Sioux County, ND",ND,2010,1309,1244,65,5.0,0
"Sioux County, NE",NE,2021,770,756,14,1.8,3
"Sioux County, NE",NE,2020,767,750,17,2.2,16
"Sioux County, NE",NE,2019,751,730,21,2.8,2
"Sioux County, NE",NE,2018,749,729,20,2.7,-13
"Sioux County, NE",NE,2017,762,739,23,3.0,-26
"Sioux County, NE",NE,2016,788,767,21,2.7,-3
"Sioux County, NE",NE,2015,791,771,20,2.5,-16
"Sioux County, NE",NE,2014,807,787,20,2.5,4
"Sioux County, NE",NE,2013,803,777,26,3.2,-37
"Sioux County, NE",NE,2012,840,811,29,3.5,-4
"Sioux County, NE",NE,2011,844,815,29,3.4,10
"Sioux County, NE",NE,2010,834,802,32,3.8,0
"Siskiyou County, CA",CA,2021,16561,15222,1339,8.1,-377
"Siskiyou County, CA",CA,2020,16938,15228,1710,10.1,-250
"Siskiyou County, CA",CA,2019,17188,16056,1132,6.6,-176
"Siskiyou County, CA",CA,2018,17364,16184,1180,6.8,-421
"Siskiyou County, CA",CA,2017,17785,16484,1301,7.3,-111
"Siskiyou County, CA",CA,2016,17896,16370,1526,8.5,12
"Siskiyou County, CA",CA,2015,17884,16199,1685,9.4,-93
"Siskiyou County, CA",CA,2014,17977,15961,2016,11.2,-262
"Siskiyou County, CA",CA,2013,18239,15812,2427,13.3,-615
"Siskiyou County, CA",CA,2012,18854,15865,2989,15.9,-571
"Siskiyou County, CA",CA,2011,19425,16070,3355,17.3,-247
"Siskiyou County, CA",CA,2010,19672,16283,3389,17.2,0
"Sitka Borough/city, AK",AK,2021,4496,4295,201,4.5,375
"Sitka Borough/city, AK",AK,2020,4121,3822,299,7.3,-283
"Sitka Borough/city, AK",AK,2019,4404,4242,162,3.7,34
"Sitka Borough/city, AK",AK,2018,4370,4206,164,3.8,-78
"Sitka Borough/city, AK",AK,2017,4448,4260,188,4.2,75
"Sitka Borough/city, AK",AK,2016,4373,4179,194,4.4,-218
"Sitka Borough/city, AK",AK,2015,4591,4387,204,4.4,-78
"Sitka Borough/city, AK",AK,2014,4669,4435,234,5.0,68
"Sitka Borough/city, AK",AK,2013,4601,4348,253,5.5,-26
"Sitka Borough/city, AK",AK,2012,4627,4362,265,5.7,16
"Sitka Borough/city, AK",AK,2011,4611,4323,288,6.2,55
"Sitka Borough/city, AK",AK,2010,4556,4258,298,6.5,0
"Skagit County, WA",WA,2021,61981,58077,3904,6.3,-1572
"Skagit County, WA",WA,2020,63553,57472,6081,9.6,-357
"Skagit County, WA",WA,2019,63910,60383,3527,5.5,3004
"Skagit County, WA",WA,2018,60906,57759,3147,5.2,1286
"Skagit County, WA",WA,2017,59620,56407,3213,5.4,1608
"Skagit County, WA",WA,2016,58012,54287,3725,6.4,1325
"Skagit County, WA",WA,2015,56687,52969,3718,6.6,317
"Skagit County, WA",WA,2014,56370,52423,3947,7.0,-310
"Skagit County, WA",WA,2013,56680,51920,4760,8.4,-149
"Skagit County, WA",WA,2012,56829,51805,5024,8.8,302
"Skagit County, WA",WA,2011,56527,51172,5355,9.5,-1334
"Skagit County, WA",WA,2010,57861,52141,5720,9.9,0
"Skagway Municipality, AK",AK,2021,621,533,88,14.2,-20
"Skagway Municipality, AK",AK,2020,641,503,138,21.5,-141
"Skagway Municipality, AK",AK,2019,782,712,70,9.0,-52
"Skagway Municipality, AK",AK,2018,834,761,73,8.8,7
"Skagway Municipality, AK",AK,2017,827,747,80,9.7,24
"Skagway Municipality, AK",AK,2016,803,717,86,10.7,-5
"Skagway Municipality, AK",AK,2015,808,718,90,11.1,6
"Skagway Municipality, AK",AK,2014,802,708,94,11.7,12
"Skagway Municipality, AK",AK,2013,790,692,98,12.4,38
"Skagway Municipality, AK",AK,2012,752,645,107,14.2,38
"Skagway Municipality, AK",AK,2011,714,596,118,16.5,-5
"Skagway Municipality, AK",AK,2010,719,611,108,15.0,0
"Skamania County, WA",WA,2021,5511,5161,350,6.4,54
"Skamania County, WA",WA,2020,5457,4956,501,9.2,-221
"Skamania County, WA",WA,2019,5678,5366,312,5.5,295
"Skamania County, WA",WA,2018,5383,5085,298,5.5,70
"Skamania County, WA",WA,2017,5313,4994,319,6.0,235
"Skamania County, WA",WA,2016,5078,4731,347,6.8,132
"Skamania County, WA",WA,2015,4946,4591,355,7.2,10
"Skamania County, WA",WA,2014,4936,4542,394,8.0,-56
"Skamania County, WA",WA,2013,4992,4505,487,9.8,-13
"Skamania County, WA",WA,2012,5005,4520,485,9.7,-13
"Skamania County, WA",WA,2011,5018,4466,552,11.0,-41
"Skamania County, WA",WA,2010,5059,4470,589,11.6,0
"Slope County, ND",ND,2021,356,346,10,2.8,-39
"Slope County, ND",ND,2020,395,383,12,3.0,-3
"Slope County, ND",ND,2019,398,390,8,2.0,-8
"Slope County, ND",ND,2018,406,398,8,2.0,-26
"Slope County, ND",ND,2017,432,424,8,1.9,-3
"Slope County, ND",ND,2016,435,424,11,2.5,-26
"Slope County, ND",ND,2015,461,449,12,2.6,-45
"Slope County, ND",ND,2014,506,496,10,2.0,-11
"Slope County, ND",ND,2013,517,506,11,2.1,-9
"Slope County, ND",ND,2012,526,515,11,2.1,34
"Slope County, ND",ND,2011,492,482,10,2.0,22
"Slope County, ND",ND,2010,470,460,10,2.1,0
"Smith County, KS",KS,2021,2012,1977,35,1.7,22
"Smith County, KS",KS,2020,1990,1940,50,2.5,-3
"Smith County, KS",KS,2019,1993,1944,49,2.5,18
"Smith County, KS",KS,2018,1975,1927,48,2.4,-3
"Smith County, KS",KS,2017,1978,1923,55,2.8,-65
"Smith County, KS",KS,2016,2043,1978,65,3.2,-56
"Smith County, KS",KS,2015,2099,2018,81,3.9,-21
"Smith County, KS",KS,2014,2120,2054,66,3.1,-42
"Smith County, KS",KS,2013,2162,2085,77,3.6,-61
"Smith County, KS",KS,2012,2223,2136,87,3.9,-54
"Smith County, KS",KS,2011,2277,2187,90,4.0,-57
"Smith County, KS",KS,2010,2334,2234,100,4.3,0
"Smith County, MS",MS,2021,6560,6264,296,4.5,20
"Smith County, MS",MS,2020,6540,6170,370,5.7,-270
"Smith County, MS",MS,2019,6810,6453,357,5.2,62
"Smith County, MS",MS,2018,6748,6440,308,4.6,6
"Smith County, MS",MS,2017,6742,6413,329,4.9,35
"Smith County, MS",MS,2016,6707,6346,361,5.4,-25
"Smith County, MS",MS,2015,6732,6367,365,5.4,30
"Smith County, MS",MS,2014,6702,6311,391,5.8,-142
"Smith County, MS",MS,2013,6844,6386,458,6.7,-329
"Smith County, MS",MS,2012,7173,6662,511,7.1,-246
"Smith County, MS",MS,2011,7419,6825,594,8.0,89
"Smith County, MS",MS,2010,7330,6684,646,8.8,0
"Smith County, TN",TN,2021,9471,9156,315,3.3,231
"Smith County, TN",TN,2020,9240,8683,557,6.0,-292
"Smith County, TN",TN,2019,9532,9245,287,3.0,306
"Smith County, TN",TN,2018,9226,8945,281,3.0,301
"Smith County, TN",TN,2017,8925,8604,321,3.6,238
"Smith County, TN",TN,2016,8687,8288,399,4.6,183
"Smith County, TN",TN,2015,8504,8031,473,5.6,140
"Smith County, TN",TN,2014,8364,7827,537,6.4,-180
"Smith County, TN",TN,2013,8544,7880,664,7.8,-115
"Smith County, TN",TN,2012,8659,7940,719,8.3,-182
"Smith County, TN",TN,2011,8841,7922,919,10.4,-104
"Smith County, TN",TN,2010,8945,7829,1116,12.5,0
"Smith County, TX",TX,2021,110095,104439,5656,5.1,2593
"Smith County, TX",TX,2020,107502,100209,7293,6.8,494
"Smith County, TX",TX,2019,107008,103438,3570,3.3,1215
"Smith County, TX",TX,2018,105793,101901,3892,3.7,543
"Smith County, TX",TX,2017,105250,100901,4349,4.1,-234
"Smith County, TX",TX,2016,105484,100706,4778,4.5,1707
"Smith County, TX",TX,2015,103777,99100,4677,4.5,1665
"Smith County, TX",TX,2014,102112,96723,5389,5.3,665
"Smith County, TX",TX,2013,101447,94758,6689,6.6,-73
"Smith County, TX",TX,2012,101520,94425,7095,7.0,-576
"Smith County, TX",TX,2011,102096,93893,8203,8.0,780
"Smith County, TX",TX,2010,101316,93200,8116,8.0,0
"Smyth County, VA",VA,2021,13524,12977,547,4.0,99
"Smyth County, VA",VA,2020,13425,12562,863,6.4,-451
"Smyth County, VA",VA,2019,13876,13366,510,3.7,82
"Smyth County, VA",VA,2018,13794,13251,543,3.9,-215
"Smyth County, VA",VA,2017,14009,13317,692,4.9,318
"Smyth County, VA",VA,2016,13691,12909,782,5.7,182
"Smyth County, VA",VA,2015,13509,12641,868,6.4,24
"Smyth County, VA",VA,2014,13485,12439,1046,7.8,88
"Smyth County, VA",VA,2013,13397,12210,1187,8.9,-89
"Smyth County, VA",VA,2012,13486,12218,1268,9.4,-242
"Smyth County, VA",VA,2011,13728,12234,1494,10.9,-12
"Smyth County, VA",VA,2010,13740,12040,1700,12.4,0
"Snohomish County, WA",WA,2021,437145,415354,21791,5.0,-1713
"Snohomish County, WA",WA,2020,438858,400158,38700,8.8,969
"Snohomish County, WA",WA,2019,437889,424765,13124,3.0,8419
"Snohomish County, WA",WA,2018,429470,413908,15562,3.6,8034
"Snohomish County, WA",WA,2017,421436,404794,16642,3.9,6144
"Snohomish County, WA",WA,2016,415292,397875,17417,4.2,11289
"Snohomish County, WA",WA,2015,404003,385767,18236,4.5,6256
"Snohomish County, WA",WA,2014,397747,377774,19973,5.0,9505
"Snohomish County, WA",WA,2013,388242,368625,19617,5.1,1115
"Snohomish County, WA",WA,2012,387127,358508,28619,7.4,4101
"Snohomish County, WA",WA,2011,383026,348470,34556,9.0,-196
"Snohomish County, WA",WA,2010,383222,345153,38069,9.9,0
"Snyder County, PA",PA,2021,19565,18557,1008,5.2,-83
"Snyder County, PA",PA,2020,19648,18143,1505,7.7,-671
"Snyder County, PA",PA,2019,20319,19188,1131,5.6,-207
"Snyder County, PA",PA,2018,20526,19679,847,4.1,-381
"Snyder County, PA",PA,2017,20907,19970,937,4.5,360
"Snyder County, PA",PA,2016,20547,19598,949,4.6,477
"Snyder County, PA",PA,2015,20070,19111,959,4.8,231
"Snyder County, PA",PA,2014,19839,18802,1037,5.2,160
"Snyder County, PA",PA,2013,19679,18371,1308,6.6,-114
"Snyder County, PA",PA,2012,19793,18322,1471,7.4,24
"Snyder County, PA",PA,2011,19769,18281,1488,7.5,-276
"Snyder County, PA",PA,2010,20045,18416,1629,8.1,0
"Socorro County, NM",NM,2021,6166,5777,389,6.3,9
"Socorro County, NM",NM,2020,6157,5736,421,6.8,-358
"Socorro County, NM",NM,2019,6515,6131,384,5.9,9
"Socorro County, NM",NM,2018,6506,6166,340,5.2,-163
"Socorro County, NM",NM,2017,6669,6248,421,6.3,-64
"Socorro County, NM",NM,2016,6733,6233,500,7.4,150
"Socorro County, NM",NM,2015,6583,6080,503,7.6,72
"Socorro County, NM",NM,2014,6511,6038,473,7.3,-141
"Socorro County, NM",NM,2013,6652,6163,489,7.4,-174
"Socorro County, NM",NM,2012,6826,6360,466,6.8,25
"Socorro County, NM",NM,2011,6801,6302,499,7.3,-21
"Socorro County, NM",NM,2010,6822,6314,508,7.4,0
"Solano County, CA",CA,2021,199365,184505,14860,7.5,-2153
"Solano County, CA",CA,2020,201518,181675,19843,9.8,-6905
"Solano County, CA",CA,2019,208423,200424,7999,3.8,-614
"Solano County, CA",CA,2018,209037,200737,8300,4.0,1090
"Solano County, CA",CA,2017,207947,197959,9988,4.8,674
"Solano County, CA",CA,2016,207273,195835,11438,5.5,2404
"Solano County, CA",CA,2015,204869,192237,12632,6.2,2478
"Solano County, CA",CA,2014,202391,186972,15419,7.6,53
"Solano County, CA",CA,2013,202338,183752,18586,9.2,101
"Solano County, CA",CA,2012,202237,180260,21977,10.9,328
"Solano County, CA",CA,2011,201909,176920,24989,12.4,-637
"Solano County, CA",CA,2010,202546,176520,26026,12.8,0
"Somerset County, MD",MD,2021,8824,8154,670,7.6,98
"Somerset County, MD",MD,2020,8726,7989,737,8.4,-566
"Somerset County, MD",MD,2019,9292,8738,554,6.0,-45
"Somerset County, MD",MD,2018,9337,8729,608,6.5,-62
"Somerset County, MD",MD,2017,9399,8778,621,6.6,180
"Somerset County, MD",MD,2016,9219,8573,646,7.0,4
"Somerset County, MD",MD,2015,9215,8470,745,8.1,-56
"Somerset County, MD",MD,2014,9271,8407,864,9.3,-302
"Somerset County, MD",MD,2013,9573,8558,1015,10.6,-164
"Somerset County, MD",MD,2012,9737,8655,1082,11.1,-144
"Somerset County, MD",MD,2011,9881,8716,1165,11.8,-71
"Somerset County, MD",MD,2010,9952,8744,1208,12.1,0
"Somerset County, ME",ME,2021,22318,20920,1398,6.3,308
"Somerset County, ME",ME,2020,22010,20662,1348,6.1,-647
"Somerset County, ME",ME,2019,22657,21738,919,4.1,-305
"Somerset County, ME",ME,2018,22962,21942,1020,4.4,-298
"Somerset County, ME",ME,2017,23260,22107,1153,5.0,-284
"Somerset County, ME",ME,2016,23544,22225,1319,5.6,-245
"Somerset County, ME",ME,2015,23789,22227,1562,6.6,-583
"Somerset County, ME",ME,2014,24372,22476,1896,7.8,-404
"Somerset County, ME",ME,2013,24776,22489,2287,9.2,242
"Somerset County, ME",ME,2012,24534,22167,2367,9.6,-129
"Somerset County, ME",ME,2011,24663,22038,2625,10.6,-141
"Somerset County, ME",ME,2010,24804,21952,2852,11.5,0
"Somerset County, NJ",NJ,2021,175249,166372,8877,5.1,1208
"Somerset County, NJ",NJ,2020,174041,160966,13075,7.5,-4236
"Somerset County, NJ",NJ,2019,178277,173194,5083,2.9,2251
"Somerset County, NJ",NJ,2018,176026,170228,5798,3.3,-714
"Somerset County, NJ",NJ,2017,176740,170185,6555,3.7,3865
"Somerset County, NJ",NJ,2016,172875,165923,6952,4.0,-46
"Somerset County, NJ",NJ,2015,172921,165130,7791,4.5,-24
"Somerset County, NJ",NJ,2014,172945,163952,8993,5.2,-1099
"Somerset County, NJ",NJ,2013,174044,162793,11251,6.5,-1556
"Somerset County, NJ",NJ,2012,175600,162471,13129,7.5,1259
"Somerset County, NJ",NJ,2011,174341,161458,12883,7.4,652
"Somerset County, NJ",NJ,2010,173689,160303,13386,7.7,0
"Somerset County, PA",PA,2021,32597,30399,2198,6.7,-555
"Somerset County, PA",PA,2020,33152,30019,3133,9.5,-696
"Somerset County, PA",PA,2019,33848,32001,1847,5.5,-66
"Somerset County, PA",PA,2018,33914,32116,1798,5.3,-42
"Somerset County, PA",PA,2017,33956,31868,2088,6.1,-278
"Somerset County, PA",PA,2016,34234,31799,2435,7.1,-256
"Somerset County, PA",PA,2015,34490,32090,2400,7.0,-485
"Somerset County, PA",PA,2014,34975,32389,2586,7.4,-688
"Somerset County, PA",PA,2013,35663,32472,3191,8.9,-833
"Somerset County, PA",PA,2012,36496,33332,3164,8.7,-361
"Somerset County, PA",PA,2011,36857,33641,3216,8.7,-162
"Somerset County, PA",PA,2010,37019,33580,3439,9.3,0
"Somervell County, TX",TX,2021,4398,4170,228,5.2,158
"Somervell County, TX",TX,2020,4240,3963,277,6.5,-78
"Somervell County, TX",TX,2019,4318,4163,155,3.6,67
"Somervell County, TX",TX,2018,4251,4074,177,4.2,94
"Somervell County, TX",TX,2017,4157,3966,191,4.6,23
"Somervell County, TX",TX,2016,4134,3935,199,4.8,22
"Somervell County, TX",TX,2015,4112,3904,208,5.1,-19
"Somervell County, TX",TX,2014,4131,3916,215,5.2,-8
"Somervell County, TX",TX,2013,4139,3887,252,6.1,5
"Somervell County, TX",TX,2012,4134,3862,272,6.6,49
"Somervell County, TX",TX,2011,4085,3756,329,8.1,35
"Somervell County, TX",TX,2010,4050,3725,325,8.0,0
"Sonoma County, CA",CA,2021,242752,229439,13313,5.5,-2560
"Sonoma County, CA",CA,2020,245312,225417,19895,8.1,-12237
"Sonoma County, CA",CA,2019,257549,250486,7063,2.7,-3038
"Sonoma County, CA",CA,2018,260587,253298,7289,2.8,819
"Sonoma County, CA",CA,2017,259768,250932,8836,3.4,554
"Sonoma County, CA",CA,2016,259214,248876,10338,4.0,1555
"Sonoma County, CA",CA,2015,257659,246028,11631,4.5,2096
"Sonoma County, CA",CA,2014,255563,241048,14515,5.7,6544
"Sonoma County, CA",CA,2013,249019,231095,17924,7.2,3348
"Sonoma County, CA",CA,2012,245671,223564,22107,9.0,53
"Sonoma County, CA",CA,2011,245618,220088,25530,10.4,1009
"Sonoma County, CA",CA,2010,244609,217546,27063,11.1,0
"Southampton County, VA",VA,2021,8739,8435,304,3.5,-355
"Southampton County, VA",VA,2020,9094,8649,445,4.9,-152
"Southampton County, VA",VA,2019,9246,9003,243,2.6,126
"Southampton County, VA",VA,2018,9120,8869,251,2.8,0
"Southampton County, VA",VA,2017,9120,8796,324,3.6,71
"Southampton County, VA",VA,2016,9049,8699,350,3.9,-185
"Southampton County, VA",VA,2015,9234,8869,365,4.0,78
"Southampton County, VA",VA,2014,9156,8716,440,4.8,-88
"Southampton County, VA",VA,2013,9244,8739,505,5.5,-235
"Southampton County, VA",VA,2012,9479,8896,583,6.2,53
"Southampton County, VA",VA,2011,9426,8704,722,7.7,-84
"Southampton County, VA",VA,2010,9510,8675,835,8.8,0
"Southeast Fairbanks Census Area, AK",AK,2021,3219,3007,212,6.6,274
"Southeast Fairbanks Census Area, AK",AK,2020,2945,2719,226,7.7,73
"Southeast Fairbanks Census Area, AK",AK,2019,2872,2642,230,8.0,-70
"Southeast Fairbanks Census Area, AK",AK,2018,2942,2682,260,8.8,10
"Southeast Fairbanks Census Area, AK",AK,2017,2932,2650,282,9.6,-58
"Southeast Fairbanks Census Area, AK",AK,2016,2990,2681,309,10.3,-7
"Southeast Fairbanks Census Area, AK",AK,2015,2997,2688,309,10.3,89
"Southeast Fairbanks Census Area, AK",AK,2014,2908,2530,378,13.0,-91
"Southeast Fairbanks Census Area, AK",AK,2013,2999,2604,395,13.2,-30
"Southeast Fairbanks Census Area, AK",AK,2012,3029,2634,395,13.0,-165
"Southeast Fairbanks Census Area, AK",AK,2011,3194,2789,405,12.7,-6
"Southeast Fairbanks Census Area, AK",AK,2010,3200,2806,394,12.3,0
"Spalding County, GA",GA,2021,28984,27627,1357,4.7,645
"Spalding County, GA",GA,2020,28339,26205,2134,7.5,-431
"Spalding County, GA",GA,2019,28770,27562,1208,4.2,124
"Spalding County, GA",GA,2018,28646,27277,1369,4.8,42
"Spalding County, GA",GA,2017,28604,26926,1678,5.9,806
"Spalding County, GA",GA,2016,27798,25863,1935,7.0,984
"Spalding County, GA",GA,2015,26814,24620,2194,8.2,-424
"Spalding County, GA",GA,2014,27238,24651,2587,9.5,-499
"Spalding County, GA",GA,2013,27737,24570,3167,11.4,-343
"Spalding County, GA",GA,2012,28080,24608,3472,12.4,-420
"Spalding County, GA",GA,2011,28500,24543,3957,13.9,-262
"Spalding County, GA",GA,2010,28762,24439,4323,15.0,0
"Spartanburg County, SC",SC,2021,156109,149935,6174,4.0,431
"Spartanburg County, SC",SC,2020,155678,145822,9856,6.3,4110
"Spartanburg County, SC",SC,2019,151568,147797,3771,2.5,5309
"Spartanburg County, SC",SC,2018,146259,141770,4489,3.1,2735
"Spartanburg County, SC",SC,2017,143524,137850,5674,4.0,1567
"Spartanburg County, SC",SC,2016,141957,135410,6547,4.6,2167
"Spartanburg County, SC",SC,2015,139790,131890,7900,5.7,2919
"Spartanburg County, SC",SC,2014,136871,128416,8455,6.2,889
"Spartanburg County, SC",SC,2013,135982,125746,10236,7.5,994
"Spartanburg County, SC",SC,2012,134988,122526,12462,9.2,1110
"Spartanburg County, SC",SC,2011,133878,119426,14452,10.8,875
"Spartanburg County, SC",SC,2010,133003,117019,15984,12.0,0
"Spencer County, IN",IN,2021,10418,10133,285,2.7,81
"Spencer County, IN",IN,2020,10337,9754,583,5.6,-553
"Spencer County, IN",IN,2019,10890,10556,334,3.1,-103
"Spencer County, IN",IN,2018,10993,10637,356,3.2,74
"Spencer County, IN",IN,2017,10919,10557,362,3.3,-69
"Spencer County, IN",IN,2016,10988,10543,445,4.0,15
"Spencer County, IN",IN,2015,10973,10522,451,4.1,221
"Spencer County, IN",IN,2014,10752,10202,550,5.1,43
"Spencer County, IN",IN,2013,10709,10009,700,6.5,-94
"Spencer County, IN",IN,2012,10803,10035,768,7.1,-257
"Spencer County, IN",IN,2011,11060,10230,830,7.5,56
"Spencer County, IN",IN,2010,11004,10063,941,8.6,0
"Spencer County, KY",KY,2021,10529,10082,447,4.2,187
"Spencer County, KY",KY,2020,10342,9766,576,5.6,-200
"Spencer County, KY",KY,2019,10542,10193,349,3.3,335
"Spencer County, KY",KY,2018,10207,9849,358,3.5,254
"Spencer County, KY",KY,2017,9953,9578,375,3.8,297
"Spencer County, KY",KY,2016,9656,9294,362,3.7,398
"Spencer County, KY",KY,2015,9258,8867,391,4.2,99
"Spencer County, KY",KY,2014,9159,8679,480,5.2,-185
"Spencer County, KY",KY,2013,9344,8749,595,6.4,77
"Spencer County, KY",KY,2012,9267,8611,656,7.1,0
"Spencer County, KY",KY,2011,9267,8434,833,9.0,19
"Spencer County, KY",KY,2010,9248,8326,922,10.0,0
"Spink County, SD",SD,2021,3067,2969,98,3.2,-8
"Spink County, SD",SD,2020,3075,2959,116,3.8,-79
"Spink County, SD",SD,2019,3154,3062,92,2.9,-70
"Spink County, SD",SD,2018,3224,3120,104,3.2,-2
"Spink County, SD",SD,2017,3226,3124,102,3.2,-76
"Spink County, SD",SD,2016,3302,3199,103,3.1,-36
"Spink County, SD",SD,2015,3338,3237,101,3.0,-76
"Spink County, SD",SD,2014,3414,3297,117,3.4,53
"Spink County, SD",SD,2013,3361,3243,118,3.5,-72
"Spink County, SD",SD,2012,3433,3300,133,3.9,-92
"Spink County, SD",SD,2011,3525,3383,142,4.0,-84
"Spink County, SD",SD,2010,3609,3476,133,3.7,0
"Spokane County, WA",WA,2021,260902,246886,14016,5.4,-3629
"Spokane County, WA",WA,2020,264531,242217,22314,8.4,6716
"Spokane County, WA",WA,2019,257815,244022,13793,5.3,11128
"Spokane County, WA",WA,2018,246687,233903,12784,5.2,5943
"Spokane County, WA",WA,2017,240744,227979,12765,5.3,6071
"Spokane County, WA",WA,2016,234673,220625,14048,6.0,6810
"Spokane County, WA",WA,2015,227863,213461,14402,6.3,2759
"Spokane County, WA",WA,2014,225104,209870,15234,6.8,-2043
"Spokane County, WA",WA,2013,227147,209018,18129,8.0,-2231
"Spokane County, WA",WA,2012,229378,210343,19035,8.3,854
"Spokane County, WA",WA,2011,228524,208676,19848,8.7,-4797
"Spokane County, WA",WA,2010,233321,212013,21308,9.1,0
"Spotsylvania County, VA",VA,2021,66679,64156,2523,3.8,-1350
"Spotsylvania County, VA",VA,2020,68029,63987,4042,5.9,-1024
"Spotsylvania County, VA",VA,2019,69053,67072,1981,2.9,2240
"Spotsylvania County, VA",VA,2018,66813,64787,2026,3.0,808
"Spotsylvania County, VA",VA,2017,66005,63568,2437,3.7,978
"Spotsylvania County, VA",VA,2016,65027,62413,2614,4.0,970
"Spotsylvania County, VA",VA,2015,64057,61127,2930,4.6,-279
"Spotsylvania County, VA",VA,2014,64336,60922,3414,5.3,164
"Spotsylvania County, VA",VA,2013,64172,60530,3642,5.7,123
"Spotsylvania County, VA",VA,2012,64049,60219,3830,6.0,-138
"Spotsylvania County, VA",VA,2011,64187,59890,4297,6.7,742
"Spotsylvania County, VA",VA,2010,63445,58892,4553,7.2,0
"St. Bernard Parish, LA",LA,2021,19908,18549,1359,6.8,-87
"St. Bernard Parish, LA",LA,2020,19995,17889,2106,10.5,-228
"St. Bernard Parish, LA",LA,2019,20223,19273,950,4.7,354
"St. Bernard Parish, LA",LA,2018,19869,18887,982,4.9,323
"St. Bernard Parish, LA",LA,2017,19546,18523,1023,5.2,-25
"St. Bernard Parish, LA",LA,2016,19571,18379,1192,6.1,-70
"St. Bernard Parish, LA",LA,2015,19641,18354,1287,6.6,501
"St. Bernard Parish, LA",LA,2014,19140,17840,1300,6.8,627
"St. Bernard Parish, LA",LA,2013,18513,17202,1311,7.1,801
"St. Bernard Parish, LA",LA,2012,17712,16365,1347,7.6,804
"St. Bernard Parish, LA",LA,2011,16908,15545,1363,8.1,974
"St. Bernard Parish, LA",LA,2010,15934,14681,1253,7.9,0
"St. Charles County, MO",MO,2021,227337,219453,7884,3.5,2108
"St. Charles County, MO",MO,2020,225229,213631,11598,5.1,-3674
"St. Charles County, MO",MO,2019,228903,223448,5455,2.4,4837
"St. Charles County, MO",MO,2018,224066,218501,5565,2.5,2358
"St. Charles County, MO",MO,2017,221708,215396,6312,2.8,798
"St. Charles County, MO",MO,2016,220910,213165,7745,3.5,4688
"St. Charles County, MO",MO,2015,216222,207742,8480,3.9,4828
"St. Charles County, MO",MO,2014,211394,201163,10231,4.8,4993
"St. Charles County, MO",MO,2013,206401,195328,11073,5.4,2218
"St. Charles County, MO",MO,2012,204183,192394,11789,5.8,-1034
"St. Charles County, MO",MO,2011,205217,190796,14421,7.0,875
"St. Charles County, MO",MO,2010,204342,187742,16600,8.1,0
"St. Charles Parish, LA",LA,2021,24370,23150,1220,5.0,12
"St. Charles Parish, LA",LA,2020,24358,22356,2002,8.2,-1070
"St. Charles Parish, LA",LA,2019,25428,24373,1055,4.1,287
"St. Charles Parish, LA",LA,2018,25141,24056,1085,4.3,199
"St. Charles Parish, LA",LA,2017,24942,23820,1122,4.5,-409
"St. Charles Parish, LA",LA,2016,25351,24004,1347,5.3,-160
"St. Charles Parish, LA",LA,2015,25511,24062,1449,5.7,133
"St. Charles Parish, LA",LA,2014,25378,23863,1515,6.0,435
"St. Charles Parish, LA",LA,2013,24943,23442,1501,6.0,110
"St. Charles Parish, LA",LA,2012,24833,23279,1554,6.3,-99
"St. Charles Parish, LA",LA,2011,24932,23225,1707,6.8,-538
"St. Charles Parish, LA",LA,2010,25470,23691,1779,7.0,0
"St. Clair County, AL",AL,2021,41195,40108,1087,2.6,-194
"St. Clair County, AL",AL,2020,41389,39149,2240,5.4,67
"St. Clair County, AL",AL,2019,41322,40148,1174,2.8,774
"St. Clair County, AL",AL,2018,40548,39146,1402,3.5,913
"St. Clair County, AL",AL,2017,39635,38024,1611,4.1,878
"St. Clair County, AL",AL,2016,38757,36745,2012,5.2,287
"St. Clair County, AL",AL,2015,38470,36452,2018,5.2,-107
"St. Clair County, AL",AL,2014,38577,36367,2210,5.7,-215
"St. Clair County, AL",AL,2013,38792,36379,2413,6.2,248
"St. Clair County, AL",AL,2012,38544,35827,2717,7.0,36
"St. Clair County, AL",AL,2011,38508,35152,3356,8.7,212
"St. Clair County, AL",AL,2010,38296,34472,3824,10.0,0
"St. Clair County, IL",IL,2021,123792,116222,7570,6.1,-265
"St. Clair County, IL",IL,2020,124057,112587,11470,9.2,-3316
"St. Clair County, IL",IL,2019,127373,121998,5375,4.2,276
"St. Clair County, IL",IL,2018,127097,120729,6368,5.0,498
"St. Clair County, IL",IL,2017,126599,120179,6420,5.1,-1129
"St. Clair County, IL",IL,2016,127728,119971,7757,6.1,1327
"St. Clair County, IL",IL,2015,126401,118065,8336,6.6,-25
"St. Clair County, IL",IL,2014,126426,116428,9998,7.9,-1240
"St. Clair County, IL",IL,2013,127666,115207,12459,9.8,-2149
"St. Clair County, IL",IL,2012,129815,117358,12457,9.6,-2931
"St. Clair County, IL",IL,2011,132746,119838,12908,9.7,-108
"St. Clair County, IL",IL,2010,132854,119089,13765,10.4,0
"St. Clair County, MI",MI,2021,74255,69862,4393,5.9,-398
"St. Clair County, MI",MI,2020,74653,65913,8740,11.7,-2542
"St. Clair County, MI",MI,2019,77195,73476,3719,4.8,765
"St. Clair County, MI",MI,2018,76430,72759,3671,4.8,359
"St. Clair County, MI",MI,2017,76071,72179,3892,5.1,1456
"St. Clair County, MI",MI,2016,74615,70103,4512,6.0,2046
"St. Clair County, MI",MI,2015,72569,67674,4895,6.7,-1062
"St. Clair County, MI",MI,2014,73631,66608,7023,9.5,-1122
"St. Clair County, MI",MI,2013,74753,66203,8550,11.4,847
"St. Clair County, MI",MI,2012,73906,65253,8653,11.7,63
"St. Clair County, MI",MI,2011,73843,64512,9331,12.6,-3113
"St. Clair County, MI",MI,2010,76956,64761,12195,15.8,0
"St. Clair County, MO",MO,2021,3845,3673,172,4.5,71
"St. Clair County, MO",MO,2020,3774,3541,233,6.2,50
"St. Clair County, MO",MO,2019,3724,3563,161,4.3,-60
"St. Clair County, MO",MO,2018,3784,3622,162,4.3,-93
"St. Clair County, MO",MO,2017,3877,3681,196,5.1,-35
"St. Clair County, MO",MO,2016,3912,3667,245,6.3,-43
"St. Clair County, MO",MO,2015,3955,3675,280,7.1,-19
"St. Clair County, MO",MO,2014,3974,3668,306,7.7,67
"St. Clair County, MO",MO,2013,3907,3600,307,7.9,15
"St. Clair County, MO",MO,2012,3892,3574,318,8.2,-114
"St. Clair County, MO",MO,2011,4006,3593,413,10.3,-113
"St. Clair County, MO",MO,2010,4119,3659,460,11.2,0
"St. Croix County, WI",WI,2021,50927,49212,1715,3.4,73
"St. Croix County, WI",WI,2020,50854,47270,3584,7.0,-63
"St. Croix County, WI",WI,2019,50917,49302,1615,3.2,282
"St. Croix County, WI",WI,2018,50635,49115,1520,3.0,324
"St. Croix County, WI",WI,2017,50311,48755,1556,3.1,774
"St. Croix County, WI",WI,2016,49537,47714,1823,3.7,840
"St. Croix County, WI",WI,2015,48697,46875,1822,3.7,441
"St. Croix County, WI",WI,2014,48256,46130,2126,4.4,453
"St. Croix County, WI",WI,2013,47803,45251,2552,5.3,366
"St. Croix County, WI",WI,2012,47437,44756,2681,5.7,19
"St. Croix County, WI",WI,2011,47418,44459,2959,6.2,325
"St. Croix County, WI",WI,2010,47093,43566,3527,7.5,0
"St. Francis County, AR",AR,2021,7675,7201,474,6.2,-347
"St. Francis County, AR",AR,2020,8022,7388,634,7.9,-171
"St. Francis County, AR",AR,2019,8193,7781,412,5.0,-91
"St. Francis County, AR",AR,2018,8284,7868,416,5.0,-76
"St. Francis County, AR",AR,2017,8360,7937,423,5.1,-495
"St. Francis County, AR",AR,2016,8855,8394,461,5.2,-137
"St. Francis County, AR",AR,2015,8992,8351,641,7.1,-52
"St. Francis County, AR",AR,2014,9044,8274,770,8.5,-176
"St. Francis County, AR",AR,2013,9220,8284,936,10.2,-307
"St. Francis County, AR",AR,2012,9527,8536,991,10.4,-262
"St. Francis County, AR",AR,2011,9789,8747,1042,10.6,-26
"St. Francis County, AR",AR,2010,9815,8806,1009,10.3,0
"St. Francois County, MO",MO,2021,26027,24772,1255,4.8,-222
"St. Francois County, MO",MO,2020,26249,24419,1830,7.0,-207
"St. Francois County, MO",MO,2019,26456,25531,925,3.5,-15
"St. Francois County, MO",MO,2018,26471,25519,952,3.6,-236
"St. Francois County, MO",MO,2017,26707,25545,1162,4.4,497
"St. Francois County, MO",MO,2016,26210,24770,1440,5.5,-42
"St. Francois County, MO",MO,2015,26252,24624,1628,6.2,28
"St. Francois County, MO",MO,2014,26224,24214,2010,7.7,2
"St. Francois County, MO",MO,2013,26222,23957,2265,8.6,378
"St. Francois County, MO",MO,2012,25844,23474,2370,9.2,-830
"St. Francois County, MO",MO,2011,26674,23740,2934,11.0,-468
"St. Francois County, MO",MO,2010,27142,23847,3295,12.1,0
"St. Helena Parish, LA",LA,2021,4257,3867,390,9.2,18
"St. Helena Parish, LA",LA,2020,4239,3720,519,12.2,4
"St. Helena Parish, LA",LA,2019,4235,3984,251,5.9,-91
"St. Helena Parish, LA",LA,2018,4326,4046,280,6.5,3
"St. Helena Parish, LA",LA,2017,4323,4036,287,6.6,-72
"St. Helena Parish, LA",LA,2016,4395,4058,337,7.7,-116
"St. Helena Parish, LA",LA,2015,4511,4104,407,9.0,0
"St. Helena Parish, LA",LA,2014,4511,4067,444,9.8,-56
"St. Helena Parish, LA",LA,2013,4567,4069,498,10.9,-43
"St. Helena Parish, LA",LA,2012,4610,4078,532,11.5,-29
"St. Helena Parish, LA",LA,2011,4639,4034,605,13.0,-58
"St. Helena Parish, LA",LA,2010,4697,4114,583,12.4,0
"St. James Parish, LA",LA,2021,8845,8193,652,7.4,3
"St. James Parish, LA",LA,2020,8842,7924,918,10.4,-474
"St. James Parish, LA",LA,2019,9316,8780,536,5.8,67
"St. James Parish, LA",LA,2018,9249,8680,569,6.2,-146
"St. James Parish, LA",LA,2017,9395,8771,624,6.6,-223
"St. James Parish, LA",LA,2016,9618,8898,720,7.5,-145
"St. James Parish, LA",LA,2015,9763,8942,821,8.4,42
"St. James Parish, LA",LA,2014,9721,8902,819,8.4,50
"St. James Parish, LA",LA,2013,9671,8809,862,8.9,-20
"St. James Parish, LA",LA,2012,9691,8753,938,9.7,-269
"St. James Parish, LA",LA,2011,9960,8807,1153,11.6,-142
"St. James Parish, LA",LA,2010,10102,8985,1117,11.1,0
"St. John the Baptist Parish, LA",LA,2021,19155,17521,1634,8.5,-29
"St. John the Baptist Parish, LA",LA,2020,19184,16930,2254,11.7,-443
"St. John the Baptist Parish, LA",LA,2019,19627,18566,1061,5.4,-30
"St. John the Baptist Parish, LA",LA,2018,19657,18552,1105,5.6,-88
"St. John the Baptist Parish, LA",LA,2017,19745,18533,1212,6.1,-335
"St. John the Baptist Parish, LA",LA,2016,20080,18706,1374,6.8,-213
"St. John the Baptist Parish, LA",LA,2015,20293,18786,1507,7.4,7
"St. John the Baptist Parish, LA",LA,2014,20286,18698,1588,7.8,199
"St. John the Baptist Parish, LA",LA,2013,20087,18419,1668,8.3,-493
"St. John the Baptist Parish, LA",LA,2012,20580,18761,1819,8.8,-409
"St. John the Baptist Parish, LA",LA,2011,20989,18883,2106,10.0,-489
"St. John the Baptist Parish, LA",LA,2010,21478,19331,2147,10.0,0
"St. Johns County, FL",FL,2021,141901,137591,4310,3.0,4234
"St. Johns County, FL",FL,2020,137667,130012,7655,5.6,3053
"St. Johns County, FL",FL,2019,134614,130970,3644,2.7,5483
"St. Johns County, FL",FL,2018,129131,125271,3860,3.0,5221
"St. Johns County, FL",FL,2017,123910,119635,4275,3.5,4944
"St. Johns County, FL",FL,2016,118966,114422,4544,3.8,5168
"St. Johns County, FL",FL,2015,113798,109271,4527,4.0,3369
"St. Johns County, FL",FL,2014,110429,105091,5338,4.8,3424
"St. Johns County, FL",FL,2013,107005,100940,6065,5.7,3693
"St. Johns County, FL",FL,2012,103312,96348,6964,6.7,2502
"St. Johns County, FL",FL,2011,100810,93024,7786,7.7,2491
"St. Johns County, FL",FL,2010,98319,90007,8312,8.5,0
"St. Joseph County, IN",IN,2021,130947,125454,5493,4.2,-2553
"St. Joseph County, IN",IN,2020,133500,122108,11392,8.5,-5014
"St. Joseph County, IN",IN,2019,138514,133631,4883,3.5,1857
"St. Joseph County, IN",IN,2018,136657,131849,4808,3.5,2044
"St. Joseph County, IN",IN,2017,134613,129844,4769,3.5,366
"St. Joseph County, IN",IN,2016,134247,128253,5994,4.5,3863
"St. Joseph County, IN",IN,2015,130384,123868,6516,5.0,1572
"St. Joseph County, IN",IN,2014,128812,120407,8405,6.5,1535
"St. Joseph County, IN",IN,2013,127277,116405,10872,8.5,-586
"St. Joseph County, IN",IN,2012,127863,115943,11920,9.3,-2994
"St. Joseph County, IN",IN,2011,130857,117889,12968,9.9,407
"St. Joseph County, IN",IN,2010,130450,115758,14692,11.3,0
"St. Joseph County, MI",MI,2021,27776,26354,1422,5.1,-1212
"St. Joseph County, MI",MI,2020,28988,26261,2727,9.4,793
"St. Joseph County, MI",MI,2019,28195,26978,1217,4.3,-148
"St. Joseph County, MI",MI,2018,28343,27278,1065,3.8,-391
"St. Joseph County, MI",MI,2017,28734,27542,1192,4.1,-466
"St. Joseph County, MI",MI,2016,29200,27985,1215,4.2,21
"St. Joseph County, MI",MI,2015,29179,27848,1331,4.6,251
"St. Joseph County, MI",MI,2014,28928,27245,1683,5.8,666
"St. Joseph County, MI",MI,2013,28262,26090,2172,7.7,717
"St. Joseph County, MI",MI,2012,27545,25117,2428,8.8,9
"St. Joseph County, MI",MI,2011,27536,24661,2875,10.4,-301
"St. Joseph County, MI",MI,2010,27837,24448,3389,12.2,0
"St. Landry Parish, LA",LA,2021,32024,30008,2016,6.3,-153
"St. Landry Parish, LA",LA,2020,32177,29202,2975,9.2,119
"St. Landry Parish, LA",LA,2019,32058,30121,1937,6.0,23
"St. Landry Parish, LA",LA,2018,32035,30060,1975,6.2,-76
"St. Landry Parish, LA",LA,2017,32111,29970,2141,6.7,-739
"St. Landry Parish, LA",LA,2016,32850,30194,2656,8.1,-792
"St. Landry Parish, LA",LA,2015,33642,30959,2683,8.0,-397
"St. Landry Parish, LA",LA,2014,34039,31489,2550,7.5,339
"St. Landry Parish, LA",LA,2013,33700,31175,2525,7.5,168
"St. Landry Parish, LA",LA,2012,33532,30872,2660,7.9,-204
"St. Landry Parish, LA",LA,2011,33736,30710,3026,9.0,-520
"St. Landry Parish, LA",LA,2010,34256,31142,3114,9.1,0
"St. Lawrence County, NY",NY,2021,42919,40730,2189,5.1,-784
"St. Lawrence County, NY",NY,2020,43703,40266,3437,7.9,-379
"St. Lawrence County, NY",NY,2019,44082,41723,2359,5.4,-224
"St. Lawrence County, NY",NY,2018,44306,41841,2465,5.6,196
"St. Lawrence County, NY",NY,2017,44110,41187,2923,6.6,723
"St. Lawrence County, NY",NY,2016,43387,40479,2908,6.7,-438
"St. Lawrence County, NY",NY,2015,43825,40602,3223,7.4,-3197
"St. Lawrence County, NY",NY,2014,47022,43347,3675,7.8,-1446
"St. Lawrence County, NY",NY,2013,48468,43931,4537,9.4,-62
"St. Lawrence County, NY",NY,2012,48530,43508,5022,10.3,-443
"St. Lawrence County, NY",NY,2011,48973,43858,5115,10.4,-1046
"St. Lawrence County, NY",NY,2010,50019,44765,5254,10.5,0
"St. Louis city, MO",MO,2021,150531,140948,9583,6.4,457
"St. Louis city, MO",MO,2020,150074,137094,12980,8.6,-1873
"St. Louis city, MO",MO,2019,151947,146380,5567,3.7,1073
"St. Louis city, MO",MO,2018,150874,145145,5729,3.8,-3055
"St. Louis city, MO",MO,2017,153929,147124,6805,4.4,-3269
"St. Louis city, MO",MO,2016,157198,148669,8529,5.4,-1612
"St. Louis city, MO",MO,2015,158810,148980,9830,6.2,-749
"St. Louis city, MO",MO,2014,159559,147413,12146,7.6,217
"St. Louis city, MO",MO,2013,159342,145939,13403,8.4,-786
"St. Louis city, MO",MO,2012,160128,146076,14052,8.8,-3428
"St. Louis city, MO",MO,2011,163556,146378,17178,10.5,-607
"St. Louis city, MO",MO,2010,164163,145451,18712,11.4,0
"St. Louis County, MN",MN,2021,97613,93880,3733,3.8,-4053
"St. Louis County, MN",MN,2020,101666,94186,7480,7.4,-1285
"St. Louis County, MN",MN,2019,102951,98568,4383,4.3,516
"St. Louis County, MN",MN,2018,102435,98376,4059,4.0,-571
"St. Louis County, MN",MN,2017,103006,98204,4802,4.7,450
"St. Louis County, MN",MN,2016,102556,96688,5868,5.7,345
"St. Louis County, MN",MN,2015,102211,97018,5193,5.1,-327
"St. Louis County, MN",MN,2014,102538,97198,5340,5.2,194
"St. Louis County, MN",MN,2013,102344,96053,6291,6.1,654
"St. Louis County, MN",MN,2012,101690,95033,6657,6.5,-813
"St. Louis County, MN",MN,2011,102503,94935,7568,7.4,-958
"St. Louis County, MN",MN,2010,103461,95040,8421,8.1,0
"St. Louis County, MO",MO,2021,526087,502408,23679,4.5,4684
"St. Louis County, MO",MO,2020,521403,488660,32743,6.3,-10470
"St. Louis County, MO",MO,2019,531873,516571,15302,2.9,6582
"St. Louis County, MO",MO,2018,525291,509836,15455,2.9,397
"St. Louis County, MO",MO,2017,524894,506987,17907,3.4,-6170
"St. Louis County, MO",MO,2016,531064,508770,22294,4.2,693
"St. Louis County, MO",MO,2015,530371,505340,25031,4.7,3037
"St. Louis County, MO",MO,2014,527334,496520,30814,5.8,4572
"St. Louis County, MO",MO,2013,522762,489821,32941,6.3,-1034
"St. Louis County, MO",MO,2012,523796,488787,35009,6.7,-7769
"St. Louis County, MO",MO,2011,531565,489054,42511,8.0,-1227
"St. Louis County, MO",MO,2010,532792,485674,47118,8.8,0
"St. Lucie County, FL",FL,2021,150366,143002,7364,4.9,3447
"St. Lucie County, FL",FL,2020,146919,134666,12253,8.3,1629
"St. Lucie County, FL",FL,2019,145290,139422,5868,4.0,3647
"St. Lucie County, FL",FL,2018,141643,135201,6442,4.5,3513
"St. Lucie County, FL",FL,2017,138130,130882,7248,5.2,2473
"St. Lucie County, FL",FL,2016,135657,127736,7921,5.8,3834
"St. Lucie County, FL",FL,2015,131823,123346,8477,6.4,1419
"St. Lucie County, FL",FL,2014,130404,119663,10741,8.2,1363
"St. Lucie County, FL",FL,2013,129041,115651,13390,10.4,677
"St. Lucie County, FL",FL,2012,128364,113893,14471,11.3,454
"St. Lucie County, FL",FL,2011,127910,111837,16073,12.6,474
"St. Lucie County, FL",FL,2010,127436,110442,16994,13.3,0
"St. Martin Parish, LA",LA,2021,21901,20668,1233,5.6,128
"St. Martin Parish, LA",LA,2020,21773,19886,1887,8.7,-518
"St. Martin Parish, LA",LA,2019,22291,21193,1098,4.9,-60
"St. Martin Parish, LA",LA,2018,22351,21192,1159,5.2,-221
"St. Martin Parish, LA",LA,2017,22572,21202,1370,6.1,-420
"St. Martin Parish, LA",LA,2016,22992,21208,1784,7.8,-988
"St. Martin Parish, LA",LA,2015,23980,22343,1637,6.8,-589
"St. Martin Parish, LA",LA,2014,24569,23185,1384,5.6,250
"St. Martin Parish, LA",LA,2013,24319,22945,1374,5.6,-22
"St. Martin Parish, LA",LA,2012,24341,22897,1444,5.9,169
"St. Martin Parish, LA",LA,2011,24172,22484,1688,7.0,142
"St. Martin Parish, LA",LA,2010,24030,22227,1803,7.5,0
"St. Mary Parish, LA",LA,2021,19192,17897,1295,6.7,-187
"St. Mary Parish, LA",LA,2020,19379,17494,1885,9.7,-475
"St. Mary Parish, LA",LA,2019,19854,18728,1126,5.7,-275
"St. Mary Parish, LA",LA,2018,20129,18829,1300,6.5,-267
"St. Mary Parish, LA",LA,2017,20396,18793,1603,7.9,-1571
"St. Mary Parish, LA",LA,2016,21967,19903,2064,9.4,-2198
"St. Mary Parish, LA",LA,2015,24165,22338,1827,7.6,-1059
"St. Mary Parish, LA",LA,2014,25224,23671,1553,6.2,233
"St. Mary Parish, LA",LA,2013,24991,23417,1574,6.3,-530
"St. Mary Parish, LA",LA,2012,25521,23697,1824,7.1,315
"St. Mary Parish, LA",LA,2011,25206,23077,2129,8.4,65
"St. Mary Parish, LA",LA,2010,25141,22908,2233,8.9,0
"St. Mary's County, MD",MD,2021,57574,54995,2579,4.5,-918
"St. Mary's County, MD",MD,2020,58492,55673,2819,4.8,214
"St. Mary's County, MD",MD,2019,58278,56404,1874,3.2,1690
"St. Mary's County, MD",MD,2018,56588,54592,1996,3.5,760
"St. Mary's County, MD",MD,2017,55828,53692,2136,3.8,1098
"St. Mary's County, MD",MD,2016,54730,52486,2244,4.1,168
"St. Mary's County, MD",MD,2015,54562,51964,2598,4.8,500
"St. Mary's County, MD",MD,2014,54062,51200,2862,5.3,-196
"St. Mary's County, MD",MD,2013,54258,51049,3209,5.9,-263
"St. Mary's County, MD",MD,2012,54521,51177,3344,6.1,238
"St. Mary's County, MD",MD,2011,54283,50823,3460,6.4,590
"St. Mary's County, MD",MD,2010,53693,50089,3604,6.7,0
"St. Tammany Parish, LA",LA,2021,116814,112322,4492,3.8,162
"St. Tammany Parish, LA",LA,2020,116652,108347,8305,7.1,-4633
"St. Tammany Parish, LA",LA,2019,121285,116422,4863,4.0,2011
"St. Tammany Parish, LA",LA,2018,119274,114348,4926,4.1,1671
"St. Tammany Parish, LA",LA,2017,117603,112576,5027,4.3,-23
"St. Tammany Parish, LA",LA,2016,117626,111775,5851,5.0,627
"St. Tammany Parish, LA",LA,2015,116999,110740,6259,5.3,2494
"St. Tammany Parish, LA",LA,2014,114505,108152,6353,5.5,3358
"St. Tammany Parish, LA",LA,2013,111147,105012,6135,5.5,1837
"St. Tammany Parish, LA",LA,2012,109310,103152,6158,5.6,874
"St. Tammany Parish, LA",LA,2011,108436,101971,6465,6.0,-343
"St. Tammany Parish, LA",LA,2010,108779,102325,6454,5.9,0
"Stafford County, KS",KS,2021,1980,1936,44,2.2,-42
"Stafford County, KS",KS,2020,2022,1951,71,3.5,17
"Stafford County, KS",KS,2019,2005,1952,53,2.6,25
"Stafford County, KS",KS,2018,1980,1929,51,2.6,-31
"Stafford County, KS",KS,2017,2011,1945,66,3.3,-93
"Stafford County, KS",KS,2016,2104,2027,77,3.7,-85
"Stafford County, KS",KS,2015,2189,2101,88,4.0,23
"Stafford County, KS",KS,2014,2166,2085,81,3.7,-56
"Stafford County, KS",KS,2013,2222,2124,98,4.4,-4
"Stafford County, KS",KS,2012,2226,2123,103,4.6,-102
"Stafford County, KS",KS,2011,2328,2211,117,5.0,-38
"Stafford County, KS",KS,2010,2366,2248,118,5.0,0
"Stafford County, VA",VA,2021,72503,69867,2636,3.6,-1336
"Stafford County, VA",VA,2020,73839,69723,4116,5.6,-717
"Stafford County, VA",VA,2019,74556,72525,2031,2.7,2711
"Stafford County, VA",VA,2018,71845,69742,2103,2.9,1746
"Stafford County, VA",VA,2017,70099,67592,2507,3.6,1716
"Stafford County, VA",VA,2016,68383,65749,2634,3.9,1465
"Stafford County, VA",VA,2015,66918,63975,2943,4.4,8
"Stafford County, VA",VA,2014,66910,63415,3495,5.2,804
"Stafford County, VA",VA,2013,66106,62452,3654,5.5,684
"Stafford County, VA",VA,2012,65422,61712,3710,5.7,377
"Stafford County, VA",VA,2011,65045,61043,4002,6.2,1060
"Stafford County, VA",VA,2010,63985,59719,4266,6.7,0
"Stanislaus County, CA",CA,2021,239538,219496,20042,8.4,-2118
"Stanislaus County, CA",CA,2020,241656,214903,26753,11.1,-1230
"Stanislaus County, CA",CA,2019,242886,227939,14947,6.2,-182
"Stanislaus County, CA",CA,2018,243068,227230,15838,6.5,1097
"Stanislaus County, CA",CA,2017,241971,223735,18236,7.5,-766
"Stanislaus County, CA",CA,2016,242737,221769,20968,8.6,1751
"Stanislaus County, CA",CA,2015,240986,217971,23015,9.6,764
"Stanislaus County, CA",CA,2014,240222,213079,27143,11.3,-46
"Stanislaus County, CA",CA,2013,240268,208783,31485,13.1,-1391
"Stanislaus County, CA",CA,2012,241659,205116,36543,15.1,-519
"Stanislaus County, CA",CA,2011,242178,201564,40614,16.8,-1650
"Stanislaus County, CA",CA,2010,243828,201670,42158,17.3,0
"Stanley County, SD",SD,2021,1919,1861,58,3.0,16
"Stanley County, SD",SD,2020,1903,1834,69,3.6,15
"Stanley County, SD",SD,2019,1888,1840,48,2.5,61
"Stanley County, SD",SD,2018,1827,1783,44,2.4,-36
"Stanley County, SD",SD,2017,1863,1805,58,3.1,-16
"Stanley County, SD",SD,2016,1879,1834,45,2.4,34
"Stanley County, SD",SD,2015,1845,1802,43,2.3,-28
"Stanley County, SD",SD,2014,1873,1826,47,2.5,3
"Stanley County, SD",SD,2013,1870,1819,51,2.7,-9
"Stanley County, SD",SD,2012,1879,1825,54,2.9,-58
"Stanley County, SD",SD,2011,1937,1862,75,3.9,-28
"Stanley County, SD",SD,2010,1965,1892,73,3.7,0
"Stanly County, NC",NC,2021,29425,28141,1284,4.4,545
"Stanly County, NC",NC,2020,28880,27112,1768,6.1,-1222
"Stanly County, NC",NC,2019,30102,29004,1098,3.6,657
"Stanly County, NC",NC,2018,29445,28372,1073,3.6,98
"Stanly County, NC",NC,2017,29347,28135,1212,4.1,152
"Stanly County, NC",NC,2016,29195,27841,1354,4.6,428
"Stanly County, NC",NC,2015,28767,27255,1512,5.3,237
"Stanly County, NC",NC,2014,28530,26855,1675,5.9,-377
"Stanly County, NC",NC,2013,28907,26610,2297,7.9,-96
"Stanly County, NC",NC,2012,29003,26050,2953,10.2,18
"Stanly County, NC",NC,2011,28985,25578,3407,11.8,-177
"Stanly County, NC",NC,2010,29162,25356,3806,13.1,0
"Stanton County, KS",KS,2021,1108,1087,21,1.9,33
"Stanton County, KS",KS,2020,1075,1052,23,2.1,80
"Stanton County, KS",KS,2019,995,970,25,2.5,-10
"Stanton County, KS",KS,2018,1005,980,25,2.5,1
"Stanton County, KS",KS,2017,1004,976,28,2.8,-71
"Stanton County, KS",KS,2016,1075,1045,30,2.8,11
"Stanton County, KS",KS,2015,1064,1032,32,3.0,36
"Stanton County, KS",KS,2014,1028,994,34,3.3,-20
"Stanton County, KS",KS,2013,1048,1009,39,3.7,-4
"Stanton County, KS",KS,2012,1052,1015,37,3.5,-17
"Stanton County, KS",KS,2011,1069,1027,42,3.9,-24
"Stanton County, KS",KS,2010,1093,1049,44,4.0,0
"Stanton County, NE",NE,2021,3620,3544,76,2.1,64
"Stanton County, NE",NE,2020,3556,3441,115,3.2,5
"Stanton County, NE",NE,2019,3551,3460,91,2.6,35
"Stanton County, NE",NE,2018,3516,3427,89,2.5,7
"Stanton County, NE",NE,2017,3509,3409,100,2.8,49
"Stanton County, NE",NE,2016,3460,3370,90,2.6,-58
"Stanton County, NE",NE,2015,3518,3429,89,2.5,-60
"Stanton County, NE",NE,2014,3578,3479,99,2.8,-103
"Stanton County, NE",NE,2013,3681,3561,120,3.3,14
"Stanton County, NE",NE,2012,3667,3543,124,3.4,37
"Stanton County, NE",NE,2011,3630,3494,136,3.7,51
"Stanton County, NE",NE,2010,3579,3430,149,4.2,0
"Stark County, IL",IL,2021,2362,2233,129,5.5,10
"Stark County, IL",IL,2020,2352,2178,174,7.4,-175
"Stark County, IL",IL,2019,2527,2388,139,5.5,-68
"Stark County, IL",IL,2018,2595,2434,161,6.2,24
"Stark County, IL",IL,2017,2571,2408,163,6.3,-200
"Stark County, IL",IL,2016,2771,2567,204,7.4,6
"Stark County, IL",IL,2015,2765,2581,184,6.7,-37
"Stark County, IL",IL,2014,2802,2589,213,7.6,-79
"Stark County, IL",IL,2013,2881,2606,275,9.5,-108
"Stark County, IL",IL,2012,2989,2744,245,8.2,16
"Stark County, IL",IL,2011,2973,2711,262,8.8,-50
"Stark County, IL",IL,2010,3023,2725,298,9.9,0
"Stark County, ND",ND,2021,17518,16695,823,4.7,-953
"Stark County, ND",ND,2020,18471,17132,1339,7.2,-585
"Stark County, ND",ND,2019,19056,18709,347,1.8,470
"Stark County, ND",ND,2018,18586,18179,407,2.2,381
"Stark County, ND",ND,2017,18205,17719,486,2.7,157
"Stark County, ND",ND,2016,18048,17341,707,3.9,-2080
"Stark County, ND",ND,2015,20128,19583,545,2.7,-963
"Stark County, ND",ND,2014,21091,20757,334,1.6,1836
"Stark County, ND",ND,2013,19255,18931,324,1.7,1092
"Stark County, ND",ND,2012,18163,17846,317,1.7,2136
"Stark County, ND",ND,2011,16027,15688,339,2.1,1451
"Stark County, ND",ND,2010,14576,14180,396,2.7,0
"Stark County, OH",OH,2021,182193,172691,9502,5.2,-1057
"Stark County, OH",OH,2020,183250,168443,14807,8.1,-4006
"Stark County, OH",OH,2019,187256,178726,8530,4.6,262
"Stark County, OH",OH,2018,186994,177846,9148,4.9,-1263
"Stark County, OH",OH,2017,188257,178467,9790,5.2,1047
"Stark County, OH",OH,2016,187210,176932,10278,5.5,40
"Stark County, OH",OH,2015,187170,177206,9964,5.3,-1584
"Stark County, OH",OH,2014,188754,177806,10948,5.8,-167
"Stark County, OH",OH,2013,188921,174666,14255,7.5,953
"Stark County, OH",OH,2012,187968,173932,14036,7.5,-722
"Stark County, OH",OH,2011,188690,171099,17591,9.3,-3558
"Stark County, OH",OH,2010,192248,170423,21825,11.4,0
"Starke County, IN",IN,2021,9555,9142,413,4.3,-191
"Starke County, IN",IN,2020,9746,8954,792,8.1,-193
"Starke County, IN",IN,2019,9939,9513,426,4.3,-481
"Starke County, IN",IN,2018,10420,9970,450,4.3,-33
"Starke County, IN",IN,2017,10453,9998,455,4.4,-416
"Starke County, IN",IN,2016,10869,10289,580,5.3,323
"Starke County, IN",IN,2015,10546,9923,623,5.9,308
"Starke County, IN",IN,2014,10238,9498,740,7.2,12
"Starke County, IN",IN,2013,10226,9276,950,9.3,113
"Starke County, IN",IN,2012,10113,9056,1057,10.5,-237
"Starke County, IN",IN,2011,10350,9193,1157,11.2,-87
"Starke County, IN",IN,2010,10437,9081,1356,13.0,0
"Starr County, TX",TX,2021,25381,21263,4118,16.2,-531
"Starr County, TX",TX,2020,25912,21375,4537,17.5,1061
"Starr County, TX",TX,2019,24851,22394,2457,9.9,-100
"Starr County, TX",TX,2018,24951,22411,2540,10.2,-979
"Starr County, TX",TX,2017,25930,22854,3076,11.9,-435
"Starr County, TX",TX,2016,26365,22837,3528,13.4,454
"Starr County, TX",TX,2015,25911,22395,3516,13.6,-79
"Starr County, TX",TX,2014,25990,22401,3589,13.8,-321
"Starr County, TX",TX,2013,26311,22345,3966,15.1,354
"Starr County, TX",TX,2012,25957,22207,3750,14.4,-275
"Starr County, TX",TX,2011,26232,21862,4370,16.7,110
"Starr County, TX",TX,2010,26122,21586,4536,17.4,0
"Staunton city, VA",VA,2021,11849,11397,452,3.8,-404
"Staunton city, VA",VA,2020,12253,11483,770,6.3,-143
"Staunton city, VA",VA,2019,12396,12066,330,2.7,261
"Staunton city, VA",VA,2018,12135,11793,342,2.8,160
"Staunton city, VA",VA,2017,11975,11551,424,3.5,167
"Staunton city, VA",VA,2016,11808,11354,454,3.8,-49
"Staunton city, VA",VA,2015,11857,11348,509,4.3,-226
"Staunton city, VA",VA,2014,12083,11472,611,5.1,126
"Staunton city, VA",VA,2013,11957,11278,679,5.7,150
"Staunton city, VA",VA,2012,11807,11064,743,6.3,-178
"Staunton city, VA",VA,2011,11985,11139,846,7.1,121
"Staunton city, VA",VA,2010,11864,10915,949,8.0,0
"Ste. Genevieve County, MO",MO,2021,9232,8916,316,3.4,45
"Ste. Genevieve County, MO",MO,2020,9187,8738,449,4.9,47
"Ste. Genevieve County, MO",MO,2019,9140,8909,231,2.5,-44
"Ste. Genevieve County, MO",MO,2018,9184,8932,252,2.7,101
"Ste. Genevieve County, MO",MO,2017,9083,8760,323,3.6,103
"Ste. Genevieve County, MO",MO,2016,8980,8563,417,4.6,-29
"Ste. Genevieve County, MO",MO,2015,9009,8517,492,5.5,-38
"Ste. Genevieve County, MO",MO,2014,9047,8443,604,6.7,51
"Ste. Genevieve County, MO",MO,2013,8996,8340,656,7.3,23
"Ste. Genevieve County, MO",MO,2012,8973,8297,676,7.5,-300
"Ste. Genevieve County, MO",MO,2011,9273,8398,875,9.4,-90
"Ste. Genevieve County, MO",MO,2010,9363,8407,956,10.2,0
"Stearns County, MN",MN,2021,88222,85060,3162,3.6,-3502
"Stearns County, MN",MN,2020,91724,86347,5377,5.9,55
"Stearns County, MN",MN,2019,91669,88564,3105,3.4,1200
"Stearns County, MN",MN,2018,90469,87616,2853,3.2,-1
"Stearns County, MN",MN,2017,90470,87377,3093,3.4,1581
"Stearns County, MN",MN,2016,88889,85541,3348,3.8,549
"Stearns County, MN",MN,2015,88340,85079,3261,3.7,421
"Stearns County, MN",MN,2014,87919,84245,3674,4.2,1141
"Stearns County, MN",MN,2013,86778,82466,4312,5.0,412
"Stearns County, MN",MN,2012,86366,81673,4693,5.4,194
"Stearns County, MN",MN,2011,86172,80762,5410,6.3,450
"Stearns County, MN",MN,2010,85722,79536,6186,7.2,0
"Steele County, MN",MN,2021,19944,19294,650,3.3,-714
"Steele County, MN",MN,2020,20658,19505,1153,5.6,-728
"Steele County, MN",MN,2019,21386,20666,720,3.4,826
"Steele County, MN",MN,2018,20560,19907,653,3.2,-67
"Steele County, MN",MN,2017,20627,19925,702,3.4,-549
"Steele County, MN",MN,2016,21176,20422,754,3.6,-75
"Steele County, MN",MN,2015,21251,20526,725,3.4,-98
"Steele County, MN",MN,2014,21349,20523,826,3.9,-66
"Steele County, MN",MN,2013,21415,20423,992,4.6,-180
"Steele County, MN",MN,2012,21595,20415,1180,5.5,430
"Steele County, MN",MN,2011,21165,19790,1375,6.5,85
"Steele County, MN",MN,2010,21080,19436,1644,7.8,0
"Steele County, ND",ND,2021,932,904,28,3.0,-31
"Steele County, ND",ND,2020,963,935,28,2.9,-34
"Steele County, ND",ND,2019,997,979,18,1.8,-23
"Steele County, ND",ND,2018,1020,1001,19,1.9,-50
"Steele County, ND",ND,2017,1070,1052,18,1.7,-2
"Steele County, ND",ND,2016,1072,1049,23,2.1,17
"Steele County, ND",ND,2015,1055,1031,24,2.3,38
"Steele County, ND",ND,2014,1017,995,22,2.2,-13
"Steele County, ND",ND,2013,1030,1005,25,2.4,-13
"Steele County, ND",ND,2012,1043,1016,27,2.6,-68
"Steele County, ND",ND,2011,1111,1083,28,2.5,8
"Steele County, ND",ND,2010,1103,1073,30,2.7,0
"Stephens County, GA",GA,2021,10512,10059,453,4.3,84
"Stephens County, GA",GA,2020,10428,9767,661,6.3,-421
"Stephens County, GA",GA,2019,10849,10422,427,3.9,-131
"Stephens County, GA",GA,2018,10980,10471,509,4.6,-159
"Stephens County, GA",GA,2017,11139,10553,586,5.3,106
"Stephens County, GA",GA,2016,11033,10376,657,6.0,294
"Stephens County, GA",GA,2015,10739,10025,714,6.6,-455
"Stephens County, GA",GA,2014,11194,10334,860,7.7,-303
"Stephens County, GA",GA,2013,11497,10450,1047,9.1,-224
"Stephens County, GA",GA,2012,11721,10507,1214,10.4,-1
"Stephens County, GA",GA,2011,11722,10329,1393,11.9,-206
"Stephens County, GA",GA,2010,11928,10442,1486,12.5,0
"Stephens County, OK",OK,2021,18751,17907,844,4.5,321
"Stephens County, OK",OK,2020,18430,16974,1456,7.9,-85
"Stephens County, OK",OK,2019,18515,17760,755,4.1,58
"Stephens County, OK",OK,2018,18457,17757,700,3.8,347
"Stephens County, OK",OK,2017,18110,17048,1062,5.9,-864
"Stephens County, OK",OK,2016,18974,17232,1742,9.2,-1281
"Stephens County, OK",OK,2015,20255,19071,1184,5.8,-31
"Stephens County, OK",OK,2014,20286,19411,875,4.3,-291
"Stephens County, OK",OK,2013,20577,19497,1080,5.2,85
"Stephens County, OK",OK,2012,20492,19516,976,4.8,151
"Stephens County, OK",OK,2011,20341,19212,1129,5.6,406
"Stephens County, OK",OK,2010,19935,18446,1489,7.5,0
"Stephens County, TX",TX,2021,4190,3984,206,4.9,195
"Stephens County, TX",TX,2020,3995,3752,243,6.1,-49
"Stephens County, TX",TX,2019,4044,3922,122,3.0,89
"Stephens County, TX",TX,2018,3955,3811,144,3.6,-21
"Stephens County, TX",TX,2017,3976,3794,182,4.6,-43
"Stephens County, TX",TX,2016,4019,3807,212,5.3,-89
"Stephens County, TX",TX,2015,4108,3935,173,4.2,-177
"Stephens County, TX",TX,2014,4285,4095,190,4.4,86
"Stephens County, TX",TX,2013,4199,3980,219,5.2,-174
"Stephens County, TX",TX,2012,4373,4116,257,5.9,-67
"Stephens County, TX",TX,2011,4440,4082,358,8.1,189
"Stephens County, TX",TX,2010,4251,3932,319,7.5,0
"Stephenson County, IL",IL,2021,20851,19705,1146,5.5,-205
"Stephenson County, IL",IL,2020,21056,19492,1564,7.4,-763
"Stephenson County, IL",IL,2019,21819,20911,908,4.2,-400
"Stephenson County, IL",IL,2018,22219,21190,1029,4.6,537
"Stephenson County, IL",IL,2017,21682,20669,1013,4.7,185
"Stephenson County, IL",IL,2016,21497,20237,1260,5.9,-79
"Stephenson County, IL",IL,2015,21576,20149,1427,6.6,-657
"Stephenson County, IL",IL,2014,22233,20584,1649,7.4,-484
"Stephenson County, IL",IL,2013,22717,20587,2130,9.4,-696
"Stephenson County, IL",IL,2012,23413,21285,2128,9.1,-785
"Stephenson County, IL",IL,2011,24198,21822,2376,9.8,-442
"Stephenson County, IL",IL,2010,24640,21889,2751,11.2,0
"Sterling County, TX",TX,2021,586,556,30,5.1,31
"Sterling County, TX",TX,2020,555,519,36,6.5,-13
"Sterling County, TX",TX,2019,568,550,18,3.2,-9
"Sterling County, TX",TX,2018,577,557,20,3.5,-12
"Sterling County, TX",TX,2017,589,567,22,3.7,-81
"Sterling County, TX",TX,2016,670,644,26,3.9,-77
"Sterling County, TX",TX,2015,747,721,26,3.5,-64
"Sterling County, TX",TX,2014,811,787,24,3.0,61
"Sterling County, TX",TX,2013,750,721,29,3.9,32
"Sterling County, TX",TX,2012,718,693,25,3.5,37
"Sterling County, TX",TX,2011,681,647,34,5.0,4
"Sterling County, TX",TX,2010,677,644,33,4.9,0
"Steuben County, IN",IN,2021,19886,19386,500,2.5,-21
"Steuben County, IN",IN,2020,19907,18649,1258,6.3,-851
"Steuben County, IN",IN,2019,20758,20210,548,2.6,414
"Steuben County, IN",IN,2018,20344,19808,536,2.6,382
"Steuben County, IN",IN,2017,19962,19386,576,2.9,-142
"Steuben County, IN",IN,2016,20104,19379,725,3.6,125
"Steuben County, IN",IN,2015,19979,19203,776,3.9,160
"Steuben County, IN",IN,2014,19819,18864,955,4.8,462
"Steuben County, IN",IN,2013,19357,18167,1190,6.1,423
"Steuben County, IN",IN,2012,18934,17574,1360,7.2,326
"Steuben County, IN",IN,2011,18608,16975,1633,8.8,169
"Steuben County, IN",IN,2010,18439,16439,2000,10.8,0
"Steuben County, NY",NY,2021,41448,39389,2059,5.0,-1206
"Steuben County, NY",NY,2020,42654,39303,3351,7.9,-836
"Steuben County, NY",NY,2019,43490,41579,1911,4.4,-32
"Steuben County, NY",NY,2018,43522,41388,2134,4.9,67
"Steuben County, NY",NY,2017,43455,40984,2471,5.7,268
"Steuben County, NY",NY,2016,43187,40628,2559,5.9,-455
"Steuben County, NY",NY,2015,43642,40872,2770,6.3,-395
"Steuben County, NY",NY,2014,44037,40980,3057,6.9,-1612
"Steuben County, NY",NY,2013,45649,41698,3951,8.7,-117
"Steuben County, NY",NY,2012,45766,41432,4334,9.5,-430
"Steuben County, NY",NY,2011,46196,41952,4244,9.2,-1169
"Steuben County, NY",NY,2010,47365,42744,4621,9.8,0
"Stevens County, KS",KS,2021,2884,2824,60,2.1,82
"Stevens County, KS",KS,2020,2802,2729,73,2.6,214
"Stevens County, KS",KS,2019,2588,2522,66,2.6,-22
"Stevens County, KS",KS,2018,2610,2536,74,2.8,-72
"Stevens County, KS",KS,2017,2682,2597,85,3.2,-239
"Stevens County, KS",KS,2016,2921,2806,115,3.9,-266
"Stevens County, KS",KS,2015,3187,3068,119,3.7,-183
"Stevens County, KS",KS,2014,3370,3270,100,3.0,49
"Stevens County, KS",KS,2013,3321,3222,99,3.0,424
"Stevens County, KS",KS,2012,2897,2795,102,3.5,117
"Stevens County, KS",KS,2011,2780,2669,111,4.0,-91
"Stevens County, KS",KS,2010,2871,2752,119,4.1,0
"Stevens County, MN",MN,2021,5182,5060,122,2.4,-284
"Stevens County, MN",MN,2020,5466,5283,183,3.3,-38
"Stevens County, MN",MN,2019,5504,5347,157,2.9,37
"Stevens County, MN",MN,2018,5467,5328,139,2.5,-64
"Stevens County, MN",MN,2017,5531,5383,148,2.7,-116
"Stevens County, MN",MN,2016,5647,5478,169,3.0,-74
"Stevens County, MN",MN,2015,5721,5557,164,2.9,141
"Stevens County, MN",MN,2014,5580,5395,185,3.3,66
"Stevens County, MN",MN,2013,5514,5304,210,3.8,-98
"Stevens County, MN",MN,2012,5612,5373,239,4.3,13
"Stevens County, MN",MN,2011,5599,5325,274,4.9,48
"Stevens County, MN",MN,2010,5551,5241,310,5.6,0
"Stevens County, WA",WA,2021,19010,17738,1272,6.7,-92
"Stevens County, WA",WA,2020,19102,17374,1728,9.0,-80
"Stevens County, WA",WA,2019,19182,17813,1369,7.1,698
"Stevens County, WA",WA,2018,18484,17176,1308,7.1,316
"Stevens County, WA",WA,2017,18168,16868,1300,7.2,274
"Stevens County, WA",WA,2016,17894,16446,1448,8.1,462
"Stevens County, WA",WA,2015,17432,15924,1508,8.7,71
"Stevens County, WA",WA,2014,17361,15788,1573,9.1,-347
"Stevens County, WA",WA,2013,17708,15832,1876,10.6,-391
"Stevens County, WA",WA,2012,18099,16143,1956,10.8,39
"Stevens County, WA",WA,2011,18060,16049,2011,11.1,-595
"Stevens County, WA",WA,2010,18655,16441,2214,11.9,0
"Stewart County, GA",GA,2021,2562,2464,98,3.8,49
"Stewart County, GA",GA,2020,2513,2373,140,5.6,14
"Stewart County, GA",GA,2019,2499,2389,110,4.4,127
"Stewart County, GA",GA,2018,2372,2257,115,4.8,69
"Stewart County, GA",GA,2017,2303,2165,138,6.0,165
"Stewart County, GA",GA,2016,2138,2000,138,6.5,47
"Stewart County, GA",GA,2015,2091,1944,147,7.0,-93
"Stewart County, GA",GA,2014,2184,2020,164,7.5,-99
"Stewart County, GA",GA,2013,2283,2086,197,8.6,-26
"Stewart County, GA",GA,2012,2309,2101,208,9.0,-20
"Stewart County, GA",GA,2011,2329,2106,223,9.6,-79
"Stewart County, GA",GA,2010,2408,2157,251,10.4,0
"Stewart County, TN",TN,2021,5377,5156,221,4.1,-34
"Stewart County, TN",TN,2020,5411,5070,341,6.3,-138
"Stewart County, TN",TN,2019,5549,5301,248,4.5,241
"Stewart County, TN",TN,2018,5308,5046,262,4.9,118
"Stewart County, TN",TN,2017,5190,4911,279,5.4,19
"Stewart County, TN",TN,2016,5171,4819,352,6.8,22
"Stewart County, TN",TN,2015,5149,4757,392,7.6,-91
"Stewart County, TN",TN,2014,5240,4754,486,9.3,-117
"Stewart County, TN",TN,2013,5357,4773,584,10.9,-180
"Stewart County, TN",TN,2012,5537,4917,620,11.2,-109
"Stewart County, TN",TN,2011,5646,4935,711,12.6,-31
"Stewart County, TN",TN,2010,5677,4961,716,12.6,0
"Stillwater County, MT",MT,2021,5499,5340,159,2.9,125
"Stillwater County, MT",MT,2020,5374,5108,266,4.9,81
"Stillwater County, MT",MT,2019,5293,5124,169,3.2,309
"Stillwater County, MT",MT,2018,4984,4813,171,3.4,111
"Stillwater County, MT",MT,2017,4873,4683,190,3.9,65
"Stillwater County, MT",MT,2016,4808,4609,199,4.1,-125
"Stillwater County, MT",MT,2015,4933,4743,190,3.9,-65
"Stillwater County, MT",MT,2014,4998,4811,187,3.7,-71
"Stillwater County, MT",MT,2013,5069,4867,202,4.0,113
"Stillwater County, MT",MT,2012,4956,4741,215,4.3,131
"Stillwater County, MT",MT,2011,4825,4586,239,5.0,59
"Stillwater County, MT",MT,2010,4766,4492,274,5.7,0
"Stoddard County, MO",MO,2021,13325,12730,595,4.5,140
"Stoddard County, MO",MO,2020,13185,12417,768,5.8,192
"Stoddard County, MO",MO,2019,12993,12415,578,4.4,-69
"Stoddard County, MO",MO,2018,13062,12493,569,4.4,-159
"Stoddard County, MO",MO,2017,13221,12557,664,5.0,-65
"Stoddard County, MO",MO,2016,13286,12436,850,6.4,128
"Stoddard County, MO",MO,2015,13158,12270,888,6.7,53
"Stoddard County, MO",MO,2014,13105,12078,1027,7.8,-87
"Stoddard County, MO",MO,2013,13192,12015,1177,8.9,-211
"Stoddard County, MO",MO,2012,13403,12203,1200,9.0,-236
"Stoddard County, MO",MO,2011,13639,12244,1395,10.2,93
"Stoddard County, MO",MO,2010,13546,12144,1402,10.3,0
"Stokes County, NC",NC,2021,20998,20112,886,4.2,475
"Stokes County, NC",NC,2020,20523,19248,1275,6.2,-977
"Stokes County, NC",NC,2019,21500,20740,760,3.5,219
"Stokes County, NC",NC,2018,21281,20494,787,3.7,-49
"Stokes County, NC",NC,2017,21330,20426,904,4.2,-475
"Stokes County, NC",NC,2016,21805,20762,1043,4.8,23
"Stokes County, NC",NC,2015,21782,20614,1168,5.4,-2
"Stokes County, NC",NC,2014,21784,20503,1281,5.9,-438
"Stokes County, NC",NC,2013,22222,20524,1698,7.6,-364
"Stokes County, NC",NC,2012,22586,20433,2153,9.5,-45
"Stokes County, NC",NC,2011,22631,20272,2359,10.4,-298
"Stokes County, NC",NC,2010,22929,20343,2586,11.3,0
"Stone County, AR",AR,2021,4531,4303,228,5.0,-93
"Stone County, AR",AR,2020,4624,4295,329,7.1,-114
"Stone County, AR",AR,2019,4738,4519,219,4.6,-49
"Stone County, AR",AR,2018,4787,4574,213,4.4,-5
"Stone County, AR",AR,2017,4792,4562,230,4.8,44
"Stone County, AR",AR,2016,4748,4504,244,5.1,25
"Stone County, AR",AR,2015,4723,4432,291,6.2,-12
"Stone County, AR",AR,2014,4735,4382,353,7.5,-91
"Stone County, AR",AR,2013,4826,4430,396,8.2,-245
"Stone County, AR",AR,2012,5071,4670,401,7.9,-301
"Stone County, AR",AR,2011,5372,4916,456,8.5,-145
"Stone County, AR",AR,2010,5517,5115,402,7.3,0
"Stone County, MO",MO,2021,13611,12719,892,6.6,463
"Stone County, MO",MO,2020,13148,11898,1250,9.5,-665
"Stone County, MO",MO,2019,13813,13165,648,4.7,114
"Stone County, MO",MO,2018,13699,13067,632,4.6,-117
"Stone County, MO",MO,2017,13816,13055,761,5.5,399
"Stone County, MO",MO,2016,13417,12478,939,7.0,121
"Stone County, MO",MO,2015,13296,12228,1068,8.0,30
"Stone County, MO",MO,2014,13266,11981,1285,9.7,-297
"Stone County, MO",MO,2013,13563,12125,1438,10.6,-55
"Stone County, MO",MO,2012,13618,12052,1566,11.5,-507
"Stone County, MO",MO,2011,14125,12318,1807,12.8,-303
"Stone County, MO",MO,2010,14428,12448,1980,13.7,0
"Stone County, MS",MS,2021,6931,6555,376,5.4,91
"Stone County, MS",MS,2020,6840,6331,509,7.4,-68
"Stone County, MS",MS,2019,6908,6485,423,6.1,199
"Stone County, MS",MS,2018,6709,6309,400,6.0,150
"Stone County, MS",MS,2017,6559,6147,412,6.3,94
"Stone County, MS",MS,2016,6465,6021,444,6.9,74
"Stone County, MS",MS,2015,6391,5911,480,7.5,78
"Stone County, MS",MS,2014,6313,5768,545,8.6,-151
"Stone County, MS",MS,2013,6464,5851,613,9.5,-299
"Stone County, MS",MS,2012,6763,6079,684,10.1,-293
"Stone County, MS",MS,2011,7056,6314,742,10.5,201
"Stone County, MS",MS,2010,6855,6149,706,10.3,0
"Stonewall County, TX",TX,2021,587,563,24,4.1,19
"Stonewall County, TX",TX,2020,568,539,29,5.1,-9
"Stonewall County, TX",TX,2019,577,560,17,2.9,-7
"Stonewall County, TX",TX,2018,584,564,20,3.4,-26
"Stonewall County, TX",TX,2017,610,588,22,3.6,-30
"Stonewall County, TX",TX,2016,640,612,28,4.4,-23
"Stonewall County, TX",TX,2015,663,634,29,4.4,-33
"Stonewall County, TX",TX,2014,696,669,27,3.9,-11
"Stonewall County, TX",TX,2013,707,673,34,4.8,-39
"Stonewall County, TX",TX,2012,746,714,32,4.3,1
"Stonewall County, TX",TX,2011,745,703,42,5.6,-2
"Stonewall County, TX",TX,2010,747,704,43,5.8,0
"Storey County, NV",NV,2021,2050,1955,95,4.6,41
"Storey County, NV",NV,2020,2009,1838,171,8.5,-45
"Storey County, NV",NV,2019,2054,1975,79,3.8,77
"Storey County, NV",NV,2018,1977,1893,84,4.2,79
"Storey County, NV",NV,2017,1898,1803,95,5.0,7
"Storey County, NV",NV,2016,1891,1770,121,6.4,38
"Storey County, NV",NV,2015,1853,1714,139,7.5,22
"Storey County, NV",NV,2014,1831,1660,171,9.3,-52
"Storey County, NV",NV,2013,1883,1657,226,12.0,-21
"Storey County, NV",NV,2012,1904,1641,263,13.8,-54
"Storey County, NV",NV,2011,1958,1644,314,16.0,-57
"Storey County, NV",NV,2010,2015,1673,342,17.0,0
"Story County, IA",IA,2021,57384,55683,1701,3.0,293
"Story County, IA",IA,2020,57091,55080,2011,3.5,-2351
"Story County, IA",IA,2019,59442,58409,1033,1.7,728
"Story County, IA",IA,2018,58714,57780,934,1.6,805
"Story County, IA",IA,2017,57909,56779,1130,2.0,639
"Story County, IA",IA,2016,57270,55939,1331,2.3,-170
"Story County, IA",IA,2015,57440,56019,1421,2.5,808
"Story County, IA",IA,2014,56632,54999,1633,2.9,1806
"Story County, IA",IA,2013,54826,52998,1828,3.3,1283
"Story County, IA",IA,2012,53543,51624,1919,3.6,115
"Story County, IA",IA,2011,53428,51283,2145,4.0,239
"Story County, IA",IA,2010,53189,50916,2273,4.3,0
"Strafford County, NH",NH,2021,72806,70416,2390,3.3,-403
"Strafford County, NH",NH,2020,73209,68574,4635,6.3,-1598
"Strafford County, NH",NH,2019,74807,73011,1796,2.4,773
"Strafford County, NH",NH,2018,74034,72271,1763,2.4,1155
"Strafford County, NH",NH,2017,72879,71060,1819,2.5,365
"Strafford County, NH",NH,2016,72514,70666,1848,2.5,1154
"Strafford County, NH",NH,2015,71360,69110,2250,3.2,570
"Strafford County, NH",NH,2014,70790,67943,2847,4.0,476
"Strafford County, NH",NH,2013,70314,66776,3538,5.0,284
"Strafford County, NH",NH,2012,70030,66275,3755,5.4,370
"Strafford County, NH",NH,2011,69660,65934,3726,5.3,-14
"Strafford County, NH",NH,2010,69674,65540,4134,5.9,0
"Stutsman County, ND",ND,2021,10389,10077,312,3.0,-186
"Stutsman County, ND",ND,2020,10575,10209,366,3.5,34
"Stutsman County, ND",ND,2019,10541,10324,217,2.1,-207
"Stutsman County, ND",ND,2018,10748,10505,243,2.3,-343
"Stutsman County, ND",ND,2017,11091,10832,259,2.3,36
"Stutsman County, ND",ND,2016,11055,10782,273,2.5,431
"Stutsman County, ND",ND,2015,10624,10350,274,2.6,307
"Stutsman County, ND",ND,2014,10317,10038,279,2.7,-65
"Stutsman County, ND",ND,2013,10382,10059,323,3.1,20
"Stutsman County, ND",ND,2012,10362,10021,341,3.3,-443
"Stutsman County, ND",ND,2011,10805,10409,396,3.7,-479
"Stutsman County, ND",ND,2010,11284,10826,458,4.1,0
"Sublette County, WY",WY,2021,3990,3766,224,5.6,-30
"Sublette County, WY",WY,2020,4020,3730,290,7.2,-63
"Sublette County, WY",WY,2019,4083,3891,192,4.7,-186
"Sublette County, WY",WY,2018,4269,4086,183,4.3,1
"Sublette County, WY",WY,2017,4268,4071,197,4.6,36
"Sublette County, WY",WY,2016,4232,3958,274,6.5,-299
"Sublette County, WY",WY,2015,4531,4298,233,5.1,-286
"Sublette County, WY",WY,2014,4817,4601,216,4.5,-191
"Sublette County, WY",WY,2013,5008,4770,238,4.8,-499
"Sublette County, WY",WY,2012,5507,5230,277,5.0,-316
"Sublette County, WY",WY,2011,5823,5540,283,4.9,161
"Sublette County, WY",WY,2010,5662,5305,357,6.3,0
"Suffolk city, VA",VA,2021,44227,42283,1944,4.4,-1117
"Suffolk city, VA",VA,2020,45344,42448,2896,6.4,-475
"Suffolk city, VA",VA,2019,45819,44444,1375,3.0,874
"Suffolk city, VA",VA,2018,44945,43510,1435,3.2,540
"Suffolk city, VA",VA,2017,44405,42616,1789,4.0,1392
"Suffolk city, VA",VA,2016,43013,41030,1983,4.6,555
"Suffolk city, VA",VA,2015,42458,40380,2078,4.9,-50
"Suffolk city, VA",VA,2014,42508,40105,2403,5.7,520
"Suffolk city, VA",VA,2013,41988,39393,2595,6.2,256
"Suffolk city, VA",VA,2012,41732,38861,2871,6.9,-110
"Suffolk city, VA",VA,2011,41842,38738,3104,7.4,26
"Suffolk city, VA",VA,2010,41816,38562,3254,7.8,0
"Suffolk County, MA",MA,2021,453174,426176,26998,6.0,-3024
"Suffolk County, MA",MA,2020,456198,409219,46979,10.3,-5930
"Suffolk County, MA",MA,2019,462128,449409,12719,2.8,4432
"Suffolk County, MA",MA,2018,457696,443490,14206,3.1,13170
"Suffolk County, MA",MA,2017,444526,429084,15442,3.5,17318
"Suffolk County, MA",MA,2016,427208,411526,15682,3.7,6269
"Suffolk County, MA",MA,2015,420939,402435,18504,4.4,5295
"Suffolk County, MA",MA,2014,415644,393729,21915,5.3,8318
"Suffolk County, MA",MA,2013,407326,382380,24946,6.1,3499
"Suffolk County, MA",MA,2012,403827,378940,24887,6.2,5812
"Suffolk County, MA",MA,2011,398015,371705,26310,6.6,4118
"Suffolk County, MA",MA,2010,393897,364690,29207,7.4,0
"Suffolk County, NY",NY,2021,776355,740989,35366,4.6,-2606
"Suffolk County, NY",NY,2020,778961,715866,63095,8.1,-18485
"Suffolk County, NY",NY,2019,797446,769100,28346,3.6,4249
"Suffolk County, NY",NY,2018,793197,762913,30284,3.8,2152
"Suffolk County, NY",NY,2017,791045,755844,35201,4.4,16807
"Suffolk County, NY",NY,2016,774238,739954,34284,4.4,-612
"Suffolk County, NY",NY,2015,774850,738096,36754,4.7,9781
"Suffolk County, NY",NY,2014,765069,723564,41505,5.4,-15450
"Suffolk County, NY",NY,2013,780519,727742,52777,6.8,2292
"Suffolk County, NY",NY,2012,778227,716784,61443,7.9,6589
"Suffolk County, NY",NY,2011,771638,712479,59159,7.7,-6913
"Suffolk County, NY",NY,2010,778551,716989,61562,7.9,0
"Sullivan County, IN",IN,2021,7836,7535,301,3.8,-129
"Sullivan County, IN",IN,2020,7965,7407,558,7.0,-244
"Sullivan County, IN",IN,2019,8209,7856,353,4.3,-396
"Sullivan County, IN",IN,2018,8605,8209,396,4.6,27
"Sullivan County, IN",IN,2017,8578,8202,376,4.4,-129
"Sullivan County, IN",IN,2016,8707,8202,505,5.8,52
"Sullivan County, IN",IN,2015,8655,8119,536,6.2,2
"Sullivan County, IN",IN,2014,8653,8036,617,7.1,-63
"Sullivan County, IN",IN,2013,8716,7943,773,8.9,-91
"Sullivan County, IN",IN,2012,8807,7999,808,9.2,-102
"Sullivan County, IN",IN,2011,8909,8098,811,9.1,-177
"Sullivan County, IN",IN,2010,9086,8196,890,9.8,0
"Sullivan County, MO",MO,2021,2650,2521,129,4.9,-102
"Sullivan County, MO",MO,2020,2752,2634,118,4.3,99
"Sullivan County, MO",MO,2019,2653,2565,88,3.3,-140
"Sullivan County, MO",MO,2018,2793,2706,87,3.1,41
"Sullivan County, MO",MO,2017,2752,2641,111,4.0,-16
"Sullivan County, MO",MO,2016,2768,2609,159,5.7,5
"Sullivan County, MO",MO,2015,2763,2595,168,6.1,32
"Sullivan County, MO",MO,2014,2731,2550,181,6.6,24
"Sullivan County, MO",MO,2013,2707,2530,177,6.5,-54
"Sullivan County, MO",MO,2012,2761,2566,195,7.1,-62
"Sullivan County, MO",MO,2011,2823,2583,240,8.5,-102
"Sullivan County, MO",MO,2010,2925,2669,256,8.8,0
"Sullivan County, NH",NH,2021,22909,22147,762,3.3,-8
"Sullivan County, NH",NH,2020,22917,21664,1253,5.5,-342
"Sullivan County, NH",NH,2019,23259,22715,544,2.3,-49
"Sullivan County, NH",NH,2018,23308,22794,514,2.2,-49
"Sullivan County, NH",NH,2017,23357,22818,539,2.3,-269
"Sullivan County, NH",NH,2016,23626,23075,551,2.3,-88
"Sullivan County, NH",NH,2015,23714,23057,657,2.8,-76
"Sullivan County, NH",NH,2014,23790,22946,844,3.5,-351
"Sullivan County, NH",NH,2013,24141,23116,1025,4.2,106
"Sullivan County, NH",NH,2012,24035,22966,1069,4.4,70
"Sullivan County, NH",NH,2011,23965,22857,1108,4.6,-103
"Sullivan County, NH",NH,2010,24068,22762,1306,5.4,0
"Sullivan County, NY",NY,2021,36118,34350,1768,4.9,-342
"Sullivan County, NY",NY,2020,36460,33409,3051,8.4,-992
"Sullivan County, NY",NY,2019,37452,36028,1424,3.8,751
"Sullivan County, NY",NY,2018,36701,35203,1498,4.1,1763
"Sullivan County, NY",NY,2017,34938,33233,1705,4.9,890
"Sullivan County, NY",NY,2016,34048,32392,1656,4.9,390
"Sullivan County, NY",NY,2015,33658,31826,1832,5.4,417
"Sullivan County, NY",NY,2014,33241,31034,2207,6.6,-1320
"Sullivan County, NY",NY,2013,34561,31677,2884,8.3,-704
"Sullivan County, NY",NY,2012,35265,32006,3259,9.2,-270
"Sullivan County, NY",NY,2011,35535,32361,3174,8.9,-974
"Sullivan County, NY",NY,2010,36509,33196,3313,9.1,0
"Sullivan County, PA",PA,2021,2569,2380,189,7.4,-45
"Sullivan County, PA",PA,2020,2614,2391,223,8.5,-69
"Sullivan County, PA",PA,2019,2683,2539,144,5.4,-36
"Sullivan County, PA",PA,2018,2719,2579,140,5.1,3
"Sullivan County, PA",PA,2017,2716,2551,165,6.1,-128
"Sullivan County, PA",PA,2016,2844,2642,202,7.1,-192
"Sullivan County, PA",PA,2015,3036,2845,191,6.3,-21
"Sullivan County, PA",PA,2014,3057,2868,189,6.2,10
"Sullivan County, PA",PA,2013,3047,2802,245,8.0,-49
"Sullivan County, PA",PA,2012,3096,2859,237,7.7,62
"Sullivan County, PA",PA,2011,3034,2817,217,7.2,82
"Sullivan County, PA",PA,2010,2952,2722,230,7.8,0
"Sullivan County, TN",TN,2021,68879,65973,2906,4.2,-388
"Sullivan County, TN",TN,2020,69267,64374,4893,7.1,-1661
"Sullivan County, TN",TN,2019,70928,68302,2626,3.7,439
"Sullivan County, TN",TN,2018,70489,67894,2595,3.7,433
"Sullivan County, TN",TN,2017,70056,67226,2830,4.0,241
"Sullivan County, TN",TN,2016,69815,66193,3622,5.2,519
"Sullivan County, TN",TN,2015,69296,65319,3977,5.7,-718
"Sullivan County, TN",TN,2014,70014,65343,4671,6.7,-1765
"Sullivan County, TN",TN,2013,71779,66347,5432,7.6,-1054
"Sullivan County, TN",TN,2012,72833,67252,5581,7.7,-1608
"Sullivan County, TN",TN,2011,74441,68171,6270,8.4,763
"Sullivan County, TN",TN,2010,73678,66902,6776,9.2,0
"Sully County, SD",SD,2021,810,779,31,3.8,23
"Sully County, SD",SD,2020,787,766,21,2.7,-9
"Sully County, SD",SD,2019,796,776,20,2.5,-6
"Sully County, SD",SD,2018,802,783,19,2.4,-31
"Sully County, SD",SD,2017,833,809,24,2.9,-30
"Sully County, SD",SD,2016,863,843,20,2.3,-13
"Sully County, SD",SD,2015,876,854,22,2.5,-15
"Sully County, SD",SD,2014,891,867,24,2.7,3
"Sully County, SD",SD,2013,888,863,25,2.8,-2
"Sully County, SD",SD,2012,890,864,26,2.9,6
"Sully County, SD",SD,2011,884,851,33,3.7,-7
"Sully County, SD",SD,2010,891,859,32,3.6,0
"Summers County, WV",WV,2021,4471,4261,210,4.7,134
"Summers County, WV",WV,2020,4337,4007,330,7.6,-13
"Summers County, WV",WV,2019,4350,4110,240,5.5,98
"Summers County, WV",WV,2018,4252,3996,256,6.0,-154
"Summers County, WV",WV,2017,4406,4146,260,5.9,-179
"Summers County, WV",WV,2016,4585,4304,281,6.1,12
"Summers County, WV",WV,2015,4573,4259,314,6.9,49
"Summers County, WV",WV,2014,4524,4207,317,7.0,-30
"Summers County, WV",WV,2013,4554,4211,343,7.5,-80
"Summers County, WV",WV,2012,4634,4238,396,8.5,-55
"Summers County, WV",WV,2011,4689,4266,423,9.0,-89
"Summers County, WV",WV,2010,4778,4325,453,9.5,0
"Summit County, CO",CO,2021,22727,21818,909,4.0,765
"Summit County, CO",CO,2020,21962,19912,2050,9.3,-808
"Summit County, CO",CO,2019,22770,22383,387,1.7,479
"Summit County, CO",CO,2018,22291,21841,450,2.0,628
"Summit County, CO",CO,2017,21663,21287,376,1.7,523
"Summit County, CO",CO,2016,21140,20722,418,2.0,570
"Summit County, CO",CO,2015,20570,20070,500,2.4,499
"Summit County, CO",CO,2014,20071,19398,673,3.4,722
"Summit County, CO",CO,2013,19349,18394,955,4.9,84
"Summit County, CO",CO,2012,19265,18085,1180,6.1,60
"Summit County, CO",CO,2011,19205,17904,1301,6.8,155
"Summit County, CO",CO,2010,19050,17698,1352,7.1,0
"Summit County, OH",OH,2021,265068,250658,14410,5.4,-2895
"Summit County, OH",OH,2020,267963,245734,22229,8.3,-6862
"Summit County, OH",OH,2019,274825,262992,11833,4.3,2110
"Summit County, OH",OH,2018,272715,260047,12668,4.6,-2161
"Summit County, OH",OH,2017,274876,260984,13892,5.1,1397
"Summit County, OH",OH,2016,273479,259430,14049,5.1,844
"Summit County, OH",OH,2015,272635,258933,13702,5.0,-310
"Summit County, OH",OH,2014,272945,256847,16098,5.9,1969
"Summit County, OH",OH,2013,270976,250368,20608,7.6,-1477
"Summit County, OH",OH,2012,272453,252147,20306,7.5,-3402
"Summit County, OH",OH,2011,275855,250799,25056,9.1,-6066
"Summit County, OH",OH,2010,281921,251986,29935,10.6,0
"Summit County, UT",UT,2021,24987,24266,721,2.9,377
"Summit County, UT",UT,2020,24610,22837,1773,7.2,-473
"Summit County, UT",UT,2019,25083,24478,605,2.4,518
"Summit County, UT",UT,2018,24565,23866,699,2.8,126
"Summit County, UT",UT,2017,24439,23706,733,3.0,648
"Summit County, UT",UT,2016,23791,23066,725,3.0,838
"Summit County, UT",UT,2015,22953,22208,745,3.2,603
"Summit County, UT",UT,2014,22350,21619,731,3.3,611
"Summit County, UT",UT,2013,21739,20909,830,3.8,583
"Summit County, UT",UT,2012,21156,20233,923,4.4,90
"Summit County, UT",UT,2011,21066,19715,1351,6.4,293
"Summit County, UT",UT,2010,20773,19209,1564,7.5,0
"Sumner County, KS",KS,2021,10735,10293,442,4.1,-106
"Sumner County, KS",KS,2020,10841,9975,866,8.0,-56
"Sumner County, KS",KS,2019,10897,10533,364,3.3,105
"Sumner County, KS",KS,2018,10792,10422,370,3.4,37
"Sumner County, KS",KS,2017,10755,10347,408,3.8,-226
"Sumner County, KS",KS,2016,10981,10517,464,4.2,-128
"Sumner County, KS",KS,2015,11109,10615,494,4.4,26
"Sumner County, KS",KS,2014,11083,10558,525,4.7,-88
"Sumner County, KS",KS,2013,11171,10541,630,5.6,-170
"Sumner County, KS",KS,2012,11341,10620,721,6.4,-283
"Sumner County, KS",KS,2011,11624,10749,875,7.5,-329
"Sumner County, KS",KS,2010,11953,10905,1048,8.8,0
"Sumner County, TN",TN,2021,105810,102294,3516,3.3,2389
"Sumner County, TN",TN,2020,103421,96746,6675,6.5,-920
"Sumner County, TN",TN,2019,104341,101534,2807,2.7,4374
"Sumner County, TN",TN,2018,99967,97188,2779,2.8,4070
"Sumner County, TN",TN,2017,95897,93026,2871,3.0,3503
"Sumner County, TN",TN,2016,92394,88792,3602,3.9,3614
"Sumner County, TN",TN,2015,88780,84723,4057,4.6,2128
"Sumner County, TN",TN,2014,86652,82079,4573,5.3,958
"Sumner County, TN",TN,2013,85694,80413,5281,6.2,807
"Sumner County, TN",TN,2012,84887,79265,5622,6.6,203
"Sumner County, TN",TN,2011,84684,77922,6762,8.0,1403
"Sumner County, TN",TN,2010,83281,75786,7495,9.0,0
"Sumter County, AL",AL,2021,4520,4317,203,4.5,-260
"Sumter County, AL",AL,2020,4780,4410,370,7.7,-52
"Sumter County, AL",AL,2019,4832,4601,231,4.8,-41
"Sumter County, AL",AL,2018,4873,4591,282,5.8,-153
"Sumter County, AL",AL,2017,5026,4689,337,6.7,-43
"Sumter County, AL",AL,2016,5069,4678,391,7.7,-27
"Sumter County, AL",AL,2015,5096,4687,409,8.0,-285
"Sumter County, AL",AL,2014,5381,4927,454,8.4,-78
"Sumter County, AL",AL,2013,5459,4959,500,9.2,34
"Sumter County, AL",AL,2012,5425,4842,583,10.7,-130
"Sumter County, AL",AL,2011,5555,4832,723,13.0,-219
"Sumter County, AL",AL,2010,5774,5018,756,13.1,0
"Sumter County, FL",FL,2021,34621,32790,1831,5.3,1961
"Sumter County, FL",FL,2020,32660,29876,2784,8.5,314
"Sumter County, FL",FL,2019,32346,30789,1557,4.8,1260
"Sumter County, FL",FL,2018,31086,29435,1651,5.3,1057
"Sumter County, FL",FL,2017,30029,28163,1866,6.2,539
"Sumter County, FL",FL,2016,29490,27358,2132,7.2,740
"Sumter County, FL",FL,2015,28750,26518,2232,7.8,507
"Sumter County, FL",FL,2014,28243,25819,2424,8.6,713
"Sumter County, FL",FL,2013,27530,24872,2658,9.7,818
"Sumter County, FL",FL,2012,26712,23804,2908,10.9,811
"Sumter County, FL",FL,2011,25901,22746,3155,12.2,821
"Sumter County, FL",FL,2010,25080,21850,3230,12.9,0
"Sumter County, GA",GA,2021,12334,11627,707,5.7,-252
"Sumter County, GA",GA,2020,12586,11651,935,7.4,-305
"Sumter County, GA",GA,2019,12891,12255,636,4.9,157
"Sumter County, GA",GA,2018,12734,11967,767,6.0,-296
"Sumter County, GA",GA,2017,13030,12138,892,6.8,181
"Sumter County, GA",GA,2016,12849,11864,985,7.7,157
"Sumter County, GA",GA,2015,12692,11618,1074,8.5,-726
"Sumter County, GA",GA,2014,13418,12140,1278,9.5,21
"Sumter County, GA",GA,2013,13397,11897,1500,11.2,-508
"Sumter County, GA",GA,2012,13905,12276,1629,11.7,6
"Sumter County, GA",GA,2011,13899,12170,1729,12.4,-407
"Sumter County, GA",GA,2010,14306,12385,1921,13.4,0
"Sumter County, SC",SC,2021,42665,40705,1960,4.6,-206
"Sumter County, SC",SC,2020,42871,40077,2794,6.5,385
"Sumter County, SC",SC,2019,42486,41081,1405,3.3,-216
"Sumter County, SC",SC,2018,42702,41001,1701,4.0,-370
"Sumter County, SC",SC,2017,43072,40864,2208,5.1,-1062
"Sumter County, SC",SC,2016,44134,41595,2539,5.8,-221
"Sumter County, SC",SC,2015,44355,41354,3001,6.8,-34
"Sumter County, SC",SC,2014,44389,41229,3160,7.1,66
"Sumter County, SC",SC,2013,44323,40545,3778,8.5,-461
"Sumter County, SC",SC,2012,44784,40111,4673,10.4,-219
"Sumter County, SC",SC,2011,45003,39640,5363,11.9,181
"Sumter County, SC",SC,2010,44822,39159,5663,12.6,0
"Sunflower County, MS",MS,2021,7389,6715,674,9.1,-46
"Sunflower County, MS",MS,2020,7435,6626,809,10.9,-22
"Sunflower County, MS",MS,2019,7457,6775,682,9.1,-317
"Sunflower County, MS",MS,2018,7774,7149,625,8.0,-170
"Sunflower County, MS",MS,2017,7944,7267,677,8.5,-363
"Sunflower County, MS",MS,2016,8307,7520,787,9.5,-147
"Sunflower County, MS",MS,2015,8454,7555,899,10.6,-183
"Sunflower County, MS",MS,2014,8637,7548,1089,12.6,-359
"Sunflower County, MS",MS,2013,8996,7751,1245,13.8,-578
"Sunflower County, MS",MS,2012,9574,8225,1349,14.1,-284
"Sunflower County, MS",MS,2011,9858,8403,1455,14.8,-14
"Sunflower County, MS",MS,2010,9872,8391,1481,15.0,0
"Surry County, NC",NC,2021,32011,30618,1393,4.4,281
"Surry County, NC",NC,2020,31730,29615,2115,6.7,-1977
"Surry County, NC",NC,2019,33707,32502,1205,3.6,153
"Surry County, NC",NC,2018,33554,32357,1197,3.6,424
"Surry County, NC",NC,2017,33130,31747,1383,4.2,-288
"Surry County, NC",NC,2016,33418,31820,1598,4.8,123
"Surry County, NC",NC,2015,33295,31513,1782,5.4,289
"Surry County, NC",NC,2014,33006,31034,1972,6.0,-333
"Surry County, NC",NC,2013,33339,30636,2703,8.1,-604
"Surry County, NC",NC,2012,33943,30594,3349,9.9,-70
"Surry County, NC",NC,2011,34013,30342,3671,10.8,-531
"Surry County, NC",NC,2010,34544,30438,4106,11.9,0
"Surry County, VA",VA,2021,3482,3349,133,3.8,-121
"Surry County, VA",VA,2020,3603,3398,205,5.7,-113
"Surry County, VA",VA,2019,3716,3590,126,3.4,-72
"Surry County, VA",VA,2018,3788,3660,128,3.4,15
"Surry County, VA",VA,2017,3773,3609,164,4.3,113
"Surry County, VA",VA,2016,3660,3471,189,5.2,-71
"Surry County, VA",VA,2015,3731,3545,186,5.0,55
"Surry County, VA",VA,2014,3676,3452,224,6.1,43
"Surry County, VA",VA,2013,3633,3374,259,7.1,-49
"Surry County, VA",VA,2012,3682,3401,281,7.6,-71
"Surry County, VA",VA,2011,3753,3437,316,8.4,53
"Surry County, VA",VA,2010,3700,3361,339,9.2,0
"Susquehanna County, PA",PA,2021,19956,18865,1091,5.5,-73
"Susquehanna County, PA",PA,2020,20029,18558,1471,7.3,-722
"Susquehanna County, PA",PA,2019,20751,19835,916,4.4,70
"Susquehanna County, PA",PA,2018,20681,19823,858,4.1,-105
"Susquehanna County, PA",PA,2017,20786,19787,999,4.8,-118
"Susquehanna County, PA",PA,2016,20904,19729,1175,5.6,-506
"Susquehanna County, PA",PA,2015,21410,20192,1218,5.7,-11
"Susquehanna County, PA",PA,2014,21421,20136,1285,6.0,-843
"Susquehanna County, PA",PA,2013,22264,20730,1534,6.9,-198
"Susquehanna County, PA",PA,2012,22462,20790,1672,7.4,578
"Susquehanna County, PA",PA,2011,21884,20178,1706,7.8,332
"Susquehanna County, PA",PA,2010,21552,19729,1823,8.5,0
"Sussex County, DE",DE,2021,111615,106257,5358,4.8,4409
"Sussex County, DE",DE,2020,107206,99465,7741,7.2,-305
"Sussex County, DE",DE,2019,107511,103526,3985,3.7,1953
"Sussex County, DE",DE,2018,105558,101613,3945,3.7,2471
"Sussex County, DE",DE,2017,103087,98503,4584,4.4,2735
"Sussex County, DE",DE,2016,100352,95852,4500,4.5,2889
"Sussex County, DE",DE,2015,97463,92732,4731,4.9,2776
"Sussex County, DE",DE,2014,94687,89345,5342,5.6,2303
"Sussex County, DE",DE,2013,92384,86152,6232,6.7,-642
"Sussex County, DE",DE,2012,93026,86418,6608,7.1,1009
"Sussex County, DE",DE,2011,92017,84850,7167,7.8,1499
"Sussex County, DE",DE,2010,90518,82581,7937,8.8,0
"Sussex County, NJ",NJ,2021,76170,71642,4528,5.9,14
"Sussex County, NJ",NJ,2020,76156,69247,6909,9.1,-1119
"Sussex County, NJ",NJ,2019,77275,74754,2521,3.3,1292
"Sussex County, NJ",NJ,2018,75983,73110,2873,3.8,41
"Sussex County, NJ",NJ,2017,75942,72659,3283,4.3,760
"Sussex County, NJ",NJ,2016,75182,71667,3515,4.7,-830
"Sussex County, NJ",NJ,2015,76012,71918,4094,5.4,-1189
"Sussex County, NJ",NJ,2014,77201,72262,4939,6.4,-1928
"Sussex County, NJ",NJ,2013,79129,72728,6401,8.1,-1981
"Sussex County, NJ",NJ,2012,81110,73766,7344,9.1,-643
"Sussex County, NJ",NJ,2011,81753,74190,7563,9.3,-622
"Sussex County, NJ",NJ,2010,82375,74496,7879,9.6,0
"Sussex County, VA",VA,2021,3593,3359,234,6.5,-96
"Sussex County, VA",VA,2020,3689,3373,316,8.6,-129
"Sussex County, VA",VA,2019,3818,3646,172,4.5,21
"Sussex County, VA",VA,2018,3797,3611,186,4.9,-58
"Sussex County, VA",VA,2017,3855,3628,227,5.9,-97
"Sussex County, VA",VA,2016,3952,3708,244,6.2,-136
"Sussex County, VA",VA,2015,4088,3812,276,6.8,-32
"Sussex County, VA",VA,2014,4120,3804,316,7.7,-63
"Sussex County, VA",VA,2013,4183,3804,379,9.1,-87
"Sussex County, VA",VA,2012,4270,3860,410,9.6,-105
"Sussex County, VA",VA,2011,4375,3917,458,10.5,84
"Sussex County, VA",VA,2010,4291,3791,500,11.7,0
"Sutter County, CA",CA,2021,45214,41145,4069,9.0,-226
"Sutter County, CA",CA,2020,45440,40238,5202,11.4,-104
"Sutter County, CA",CA,2019,45544,42143,3401,7.5,704
"Sutter County, CA",CA,2018,44840,41395,3445,7.7,-125
"Sutter County, CA",CA,2017,44965,41028,3937,8.8,-18
"Sutter County, CA",CA,2016,44983,40612,4371,9.7,249
"Sutter County, CA",CA,2015,44734,39925,4809,10.8,504
"Sutter County, CA",CA,2014,44230,38574,5656,12.8,-439
"Sutter County, CA",CA,2013,44669,38061,6608,14.8,-847
"Sutter County, CA",CA,2012,45516,37750,7766,17.1,-410
"Sutter County, CA",CA,2011,45926,37447,8479,18.5,-163
"Sutter County, CA",CA,2010,46089,37433,8656,18.8,0
"Sutton County, TX",TX,2021,1149,1054,95,8.3,-55
"Sutton County, TX",TX,2020,1204,1085,119,9.9,-196
"Sutton County, TX",TX,2019,1400,1348,52,3.7,-44
"Sutton County, TX",TX,2018,1444,1388,56,3.9,-52
"Sutton County, TX",TX,2017,1496,1419,77,5.1,-96
"Sutton County, TX",TX,2016,1592,1465,127,8.0,-128
"Sutton County, TX",TX,2015,1720,1615,105,6.1,-298
"Sutton County, TX",TX,2014,2018,1945,73,3.6,-43
"Sutton County, TX",TX,2013,2061,1966,95,4.6,51
"Sutton County, TX",TX,2012,2010,1913,97,4.8,62
"Sutton County, TX",TX,2011,1948,1809,139,7.1,-49
"Sutton County, TX",TX,2010,1997,1801,196,9.8,0
"Suwannee County, FL",FL,2021,17414,16637,777,4.5,-223
"Suwannee County, FL",FL,2020,17637,16549,1088,6.2,-492
"Suwannee County, FL",FL,2019,18129,17502,627,3.5,99
"Suwannee County, FL",FL,2018,18030,17343,687,3.8,-170
"Suwannee County, FL",FL,2017,18200,17410,790,4.3,-43
"Suwannee County, FL",FL,2016,18243,17342,901,4.9,238
"Suwannee County, FL",FL,2015,18005,17014,991,5.5,61
"Suwannee County, FL",FL,2014,17944,16781,1163,6.5,-84
"Suwannee County, FL",FL,2013,18028,16726,1302,7.2,-192
"Suwannee County, FL",FL,2012,18220,16714,1506,8.3,-531
"Suwannee County, FL",FL,2011,18751,17028,1723,9.2,-237
"Suwannee County, FL",FL,2010,18988,17184,1804,9.5,0
"Swain County, NC",NC,2021,6833,6525,308,4.5,88
"Swain County, NC",NC,2020,6745,6188,557,8.3,-235
"Swain County, NC",NC,2019,6980,6708,272,3.9,158
"Swain County, NC",NC,2018,6822,6525,297,4.4,75
"Swain County, NC",NC,2017,6747,6405,342,5.1,-349
"Swain County, NC",NC,2016,7096,6663,433,6.1,329
"Swain County, NC",NC,2015,6767,6254,513,7.6,285
"Swain County, NC",NC,2014,6482,5915,567,8.7,-125
"Swain County, NC",NC,2013,6607,5807,800,12.1,20
"Swain County, NC",NC,2012,6587,5596,991,15.0,68
"Swain County, NC",NC,2011,6519,5500,1019,15.6,229
"Swain County, NC",NC,2010,6290,5371,919,14.6,0
"Sweet Grass County, MT",MT,2021,1904,1859,45,2.4,46
"Sweet Grass County, MT",MT,2020,1858,1793,65,3.5,25
"Sweet Grass County, MT",MT,2019,1833,1781,52,2.8,43
"Sweet Grass County, MT",MT,2018,1790,1735,55,3.1,-17
"Sweet Grass County, MT",MT,2017,1807,1750,57,3.2,11
"Sweet Grass County, MT",MT,2016,1796,1738,58,3.2,6
"Sweet Grass County, MT",MT,2015,1790,1738,52,2.9,8
"Sweet Grass County, MT",MT,2014,1782,1719,63,3.5,12
"Sweet Grass County, MT",MT,2013,1770,1705,65,3.7,22
"Sweet Grass County, MT",MT,2012,1748,1682,66,3.8,44
"Sweet Grass County, MT",MT,2011,1704,1628,76,4.5,-36
"Sweet Grass County, MT",MT,2010,1740,1646,94,5.4,0
"Sweetwater County, WY",WY,2021,19449,18360,1089,5.6,-1054
"Sweetwater County, WY",WY,2020,20503,18998,1505,7.3,-782
"Sweetwater County, WY",WY,2019,21285,20430,855,4.0,-98
"Sweetwater County, WY",WY,2018,21383,20486,897,4.2,-237
"Sweetwater County, WY",WY,2017,21620,20612,1008,4.7,-520
"Sweetwater County, WY",WY,2016,22140,20794,1346,6.1,-416
"Sweetwater County, WY",WY,2015,22556,21509,1047,4.6,-470
"Sweetwater County, WY",WY,2014,23026,22061,965,4.2,-513
"Sweetwater County, WY",WY,2013,23539,22499,1040,4.4,-317
"Sweetwater County, WY",WY,2012,23856,22684,1172,4.9,278
"Sweetwater County, WY",WY,2011,23578,22261,1317,5.6,555
"Sweetwater County, WY",WY,2010,23023,21395,1628,7.1,0
"Swift County, MN",MN,2021,4640,4470,170,3.7,-266
"Swift County, MN",MN,2020,4906,4612,294,6.0,-51
"Swift County, MN",MN,2019,4957,4727,230,4.6,-82
"Swift County, MN",MN,2018,5039,4843,196,3.9,-33
"Swift County, MN",MN,2017,5072,4862,210,4.1,27
"Swift County, MN",MN,2016,5045,4773,272,5.4,-141
"Swift County, MN",MN,2015,5186,4867,319,6.2,307
"Swift County, MN",MN,2014,4879,4638,241,4.9,-21
"Swift County, MN",MN,2013,4900,4611,289,5.9,-190
"Swift County, MN",MN,2012,5090,4775,315,6.2,-115
"Swift County, MN",MN,2011,5205,4832,373,7.2,-39
"Swift County, MN",MN,2010,5244,4818,426,8.1,0
"Swisher County, TX",TX,2021,2593,2465,128,4.9,94
"Swisher County, TX",TX,2020,2499,2369,130,5.2,-85
"Swisher County, TX",TX,2019,2584,2489,95,3.7,-43
"Swisher County, TX",TX,2018,2627,2514,113,4.3,-44
"Swisher County, TX",TX,2017,2671,2561,110,4.1,-45
"Swisher County, TX",TX,2016,2716,2600,116,4.3,-17
"Swisher County, TX",TX,2015,2733,2602,131,4.8,-145
"Swisher County, TX",TX,2014,2878,2699,179,6.2,-81
"Swisher County, TX",TX,2013,2959,2707,252,8.5,-84
"Swisher County, TX",TX,2012,3043,2863,180,5.9,-106
"Swisher County, TX",TX,2011,3149,2930,219,7.0,-37
"Swisher County, TX",TX,2010,3186,2976,210,6.6,0
"Switzerland County, IN",IN,2021,4666,4505,161,3.5,-139
"Switzerland County, IN",IN,2020,4805,4413,392,8.2,-238
"Switzerland County, IN",IN,2019,5043,4877,166,3.3,-34
"Switzerland County, IN",IN,2018,5077,4882,195,3.8,79
"Switzerland County, IN",IN,2017,4998,4800,198,4.0,-2
"Switzerland County, IN",IN,2016,5000,4759,241,4.8,147
"Switzerland County, IN",IN,2015,4853,4614,239,4.9,47
"Switzerland County, IN",IN,2014,4806,4523,283,5.9,-85
"Switzerland County, IN",IN,2013,4891,4533,358,7.3,-4
"Switzerland County, IN",IN,2012,4895,4522,373,7.6,-106
"Switzerland County, IN",IN,2011,5001,4600,401,8.0,-28
"Switzerland County, IN",IN,2010,5029,4573,456,9.1,0
"Talbot County, GA",GA,2021,2775,2649,126,4.5,19
"Talbot County, GA",GA,2020,2756,2570,186,6.7,-74
"Talbot County, GA",GA,2019,2830,2700,130,4.6,-11
"Talbot County, GA",GA,2018,2841,2696,145,5.1,20
"Talbot County, GA",GA,2017,2821,2647,174,6.2,76
"Talbot County, GA",GA,2016,2745,2559,186,6.8,78
"Talbot County, GA",GA,2015,2667,2457,210,7.9,-134
"Talbot County, GA",GA,2014,2801,2580,221,7.9,-56
"Talbot County, GA",GA,2013,2857,2594,263,9.2,-54
"Talbot County, GA",GA,2012,2911,2623,288,9.9,-4
"Talbot County, GA",GA,2011,2915,2609,306,10.5,32
"Talbot County, GA",GA,2010,2883,2588,295,10.2,0
"Talbot County, MD",MD,2021,17647,16718,929,5.3,-340
"Talbot County, MD",MD,2020,17987,16896,1091,6.1,-1621
"Talbot County, MD",MD,2019,19608,18959,649,3.3,-374
"Talbot County, MD",MD,2018,19982,19292,690,3.5,14
"Talbot County, MD",MD,2017,19968,19208,760,3.8,451
"Talbot County, MD",MD,2016,19517,18727,790,4.0,258
"Talbot County, MD",MD,2015,19259,18331,928,4.8,141
"Talbot County, MD",MD,2014,19118,18089,1029,5.4,-40
"Talbot County, MD",MD,2013,19158,17941,1217,6.4,-262
"Talbot County, MD",MD,2012,19420,18042,1378,7.1,-37
"Talbot County, MD",MD,2011,19457,17994,1463,7.5,21
"Talbot County, MD",MD,2010,19436,17849,1587,8.2,0
"Taliaferro County, GA",GA,2021,535,508,27,5.0,2
"Taliaferro County, GA",GA,2020,533,495,38,7.1,-14
"Taliaferro County, GA",GA,2019,547,518,29,5.3,-23
"Taliaferro County, GA",GA,2018,570,539,31,5.4,-11
"Taliaferro County, GA",GA,2017,581,542,39,6.7,33
"Taliaferro County, GA",GA,2016,548,510,38,6.9,-39
"Taliaferro County, GA",GA,2015,587,540,47,8.0,-5
"Taliaferro County, GA",GA,2014,592,527,65,11.0,3
"Taliaferro County, GA",GA,2013,589,519,70,11.9,-15
"Taliaferro County, GA",GA,2012,604,519,85,14.1,-13
"Taliaferro County, GA",GA,2011,617,521,96,15.6,-20
"Taliaferro County, GA",GA,2010,637,521,116,18.2,0
"Talladega County, AL",AL,2021,35695,34215,1480,4.1,-738
"Talladega County, AL",AL,2020,36433,33605,2828,7.8,220
"Talladega County, AL",AL,2019,36213,34912,1301,3.6,499
"Talladega County, AL",AL,2018,35714,34201,1513,4.2,665
"Talladega County, AL",AL,2017,35049,33254,1795,5.1,521
"Talladega County, AL",AL,2016,34528,32244,2284,6.6,-524
"Talladega County, AL",AL,2015,35052,32736,2316,6.6,-393
"Talladega County, AL",AL,2014,35445,32710,2735,7.7,-302
"Talladega County, AL",AL,2013,35747,32632,3115,8.7,691
"Talladega County, AL",AL,2012,35056,31693,3363,9.6,-204
"Talladega County, AL",AL,2011,35260,31207,4053,11.5,163
"Talladega County, AL",AL,2010,35097,30455,4642,13.2,0
"Tallahatchie County, MS",MS,2021,4800,4507,293,6.1,-289
"Tallahatchie County, MS",MS,2020,5089,4716,373,7.3,-279
"Tallahatchie County, MS",MS,2019,5368,5064,304,5.7,109
"Tallahatchie County, MS",MS,2018,5259,4970,289,5.5,-204
"Tallahatchie County, MS",MS,2017,5463,5162,301,5.5,-248
"Tallahatchie County, MS",MS,2016,5711,5316,395,6.9,-82
"Tallahatchie County, MS",MS,2015,5793,5350,443,7.6,-30
"Tallahatchie County, MS",MS,2014,5823,5278,545,9.4,13
"Tallahatchie County, MS",MS,2013,5810,5166,644,11.1,-23
"Tallahatchie County, MS",MS,2012,5833,5188,645,11.1,-257
"Tallahatchie County, MS",MS,2011,6090,5367,723,11.9,196
"Tallahatchie County, MS",MS,2010,5894,5193,701,11.9,0
"Tallapoosa County, AL",AL,2021,17910,17186,724,4.0,-294
"Tallapoosa County, AL",AL,2020,18204,16822,1382,7.6,-533
"Tallapoosa County, AL",AL,2019,18737,18145,592,3.2,584
"Tallapoosa County, AL",AL,2018,18153,17406,747,4.1,-258
"Tallapoosa County, AL",AL,2017,18411,17618,793,4.3,-15
"Tallapoosa County, AL",AL,2016,18426,17396,1030,5.6,-270
"Tallapoosa County, AL",AL,2015,18696,17550,1146,6.1,248
"Tallapoosa County, AL",AL,2014,18448,17072,1376,7.5,64
"Tallapoosa County, AL",AL,2013,18384,16874,1510,8.2,-77
"Tallapoosa County, AL",AL,2012,18461,16830,1631,8.8,111
"Tallapoosa County, AL",AL,2011,18350,16274,2076,11.3,-725
"Tallapoosa County, AL",AL,2010,19075,16615,2460,12.9,0
"Tama County, IA",IA,2021,9146,8719,427,4.7,-149
"Tama County, IA",IA,2020,9295,8828,467,5.0,-397
"Tama County, IA",IA,2019,9692,9407,285,2.9,71
"Tama County, IA",IA,2018,9621,9336,285,3.0,-56
"Tama County, IA",IA,2017,9677,9347,330,3.4,-141
"Tama County, IA",IA,2016,9818,9411,407,4.1,150
"Tama County, IA",IA,2015,9668,9251,417,4.3,430
"Tama County, IA",IA,2014,9238,8752,486,5.3,118
"Tama County, IA",IA,2013,9120,8613,507,5.6,-6
"Tama County, IA",IA,2012,9126,8576,550,6.0,-104
"Tama County, IA",IA,2011,9230,8657,573,6.2,-104
"Tama County, IA",IA,2010,9334,8723,611,6.5,0
"Taney County, MO",MO,2021,26276,24306,1970,7.5,316
"Taney County, MO",MO,2020,25960,22689,3271,12.6,-942
"Taney County, MO",MO,2019,26902,25588,1314,4.9,12
"Taney County, MO",MO,2018,26890,25512,1378,5.1,-39
"Taney County, MO",MO,2017,26929,25309,1620,6.0,618
"Taney County, MO",MO,2016,26311,24362,1949,7.4,289
"Taney County, MO",MO,2015,26022,23886,2136,8.2,379
"Taney County, MO",MO,2014,25643,23134,2509,9.8,-130
"Taney County, MO",MO,2013,25773,23004,2769,10.7,432
"Taney County, MO",MO,2012,25341,22392,2949,11.6,-698
"Taney County, MO",MO,2011,26039,22549,3490,13.4,83
"Taney County, MO",MO,2010,25956,22368,3588,13.8,0
"Tangipahoa Parish, LA",LA,2021,56131,52524,3607,6.4,5
"Tangipahoa Parish, LA",LA,2020,56126,50450,5676,10.1,1168
"Tangipahoa Parish, LA",LA,2019,54958,52036,2922,5.3,258
"Tangipahoa Parish, LA",LA,2018,54700,51725,2975,5.4,-197
"Tangipahoa Parish, LA",LA,2017,54897,51769,3128,5.7,668
"Tangipahoa Parish, LA",LA,2016,54229,50567,3662,6.8,232
"Tangipahoa Parish, LA",LA,2015,53997,50124,3873,7.2,489
"Tangipahoa Parish, LA",LA,2014,53508,49512,3996,7.5,600
"Tangipahoa Parish, LA",LA,2013,52908,48836,4072,7.7,-314
"Tangipahoa Parish, LA",LA,2012,53222,48894,4328,8.1,-200
"Tangipahoa Parish, LA",LA,2011,53422,48547,4875,9.1,-143
"Tangipahoa Parish, LA",LA,2010,53565,48649,4916,9.2,0
"Taos County, NM",NM,2021,14663,13352,1311,8.9,-42
"Taos County, NM",NM,2020,14705,13068,1637,11.1,-650
"Taos County, NM",NM,2019,15355,14420,935,6.1,212
"Taos County, NM",NM,2018,15143,14167,976,6.4,-103
"Taos County, NM",NM,2017,15246,14057,1189,7.8,184
"Taos County, NM",NM,2016,15062,13780,1282,8.5,42
"Taos County, NM",NM,2015,15020,13628,1392,9.3,-85
"Taos County, NM",NM,2014,15105,13628,1477,9.8,-30
"Taos County, NM",NM,2013,15135,13577,1558,10.3,123
"Taos County, NM",NM,2012,15012,13470,1542,10.3,-64
"Taos County, NM",NM,2011,15076,13546,1530,10.1,-190
"Taos County, NM",NM,2010,15266,13700,1566,10.3,0
"Tarrant County, TX",TX,2021,1099856,1041556,58300,5.3,29736
"Tarrant County, TX",TX,2020,1070120,991029,79091,7.4,3235
"Tarrant County, TX",TX,2019,1066885,1031409,35476,3.3,17171
"Tarrant County, TX",TX,2018,1049714,1012587,37127,3.5,21126
"Tarrant County, TX",TX,2017,1028588,989989,38599,3.8,17045
"Tarrant County, TX",TX,2016,1011543,971204,40339,4.0,19648
"Tarrant County, TX",TX,2015,991895,950296,41599,4.2,2316
"Tarrant County, TX",TX,2014,989579,939109,50470,5.1,10021
"Tarrant County, TX",TX,2013,979558,919846,59712,6.1,15679
"Tarrant County, TX",TX,2012,963879,901503,62376,6.5,13862
"Tarrant County, TX",TX,2011,950017,875968,74049,7.8,23795
"Tarrant County, TX",TX,2010,926222,850393,75829,8.2,0
"Tate County, MS",MS,2021,12106,11429,677,5.6,162
"Tate County, MS",MS,2020,11944,11049,895,7.5,-261
"Tate County, MS",MS,2019,12205,11517,688,5.6,-47
"Tate County, MS",MS,2018,12252,11627,625,5.1,182
"Tate County, MS",MS,2017,12070,11441,629,5.2,44
"Tate County, MS",MS,2016,12026,11308,718,6.0,66
"Tate County, MS",MS,2015,11960,11104,856,7.2,221
"Tate County, MS",MS,2014,11739,10733,1006,8.6,-233
"Tate County, MS",MS,2013,11972,10912,1060,8.9,-588
"Tate County, MS",MS,2012,12560,11423,1137,9.1,-303
"Tate County, MS",MS,2011,12863,11560,1303,10.1,209
"Tate County, MS",MS,2010,12654,11329,1325,10.5,0
"Tattnall County, GA",GA,2021,9621,9313,308,3.2,-49
"Tattnall County, GA",GA,2020,9670,9258,412,4.3,-101
"Tattnall County, GA",GA,2019,9771,9387,384,3.9,65
"Tattnall County, GA",GA,2018,9706,9293,413,4.3,19
"Tattnall County, GA",GA,2017,9687,9205,482,5.0,357
"Tattnall County, GA",GA,2016,9330,8825,505,5.4,159
"Tattnall County, GA",GA,2015,9171,8596,575,6.3,-337
"Tattnall County, GA",GA,2014,9508,8844,664,7.0,-42
"Tattnall County, GA",GA,2013,9550,8795,755,7.9,-230
"Tattnall County, GA",GA,2012,9780,8979,801,8.2,-73
"Tattnall County, GA",GA,2011,9853,8996,857,8.7,151
"Tattnall County, GA",GA,2010,9702,8813,889,9.2,0
"Taylor County, FL",FL,2021,8112,7708,404,5.0,-39
"Taylor County, FL",FL,2020,8151,7586,565,6.9,-8
"Taylor County, FL",FL,2019,8159,7858,301,3.7,-433
"Taylor County, FL",FL,2018,8592,8254,338,3.9,-109
"Taylor County, FL",FL,2017,8701,8304,397,4.6,-165
"Taylor County, FL",FL,2016,8866,8383,483,5.4,-149
"Taylor County, FL",FL,2015,9015,8404,611,6.8,-334
"Taylor County, FL",FL,2014,9349,8689,660,7.1,-115
"Taylor County, FL",FL,2013,9464,8690,774,8.2,114
"Taylor County, FL",FL,2012,9350,8484,866,9.3,-38
"Taylor County, FL",FL,2011,9388,8445,943,10.0,-2
"Taylor County, FL",FL,2010,9390,8430,960,10.2,0
"Taylor County, GA",GA,2021,2950,2782,168,5.7,182
"Taylor County, GA",GA,2020,2768,2569,199,7.2,-271
"Taylor County, GA",GA,2019,3039,2909,130,4.3,249
"Taylor County, GA",GA,2018,2790,2607,183,6.6,-58
"Taylor County, GA",GA,2017,2848,2598,250,8.8,-475
"Taylor County, GA",GA,2016,3323,3071,252,7.6,580
"Taylor County, GA",GA,2015,2743,2487,256,9.3,-100
"Taylor County, GA",GA,2014,2843,2551,292,10.3,-326
"Taylor County, GA",GA,2013,3169,2801,368,11.6,66
"Taylor County, GA",GA,2012,3103,2694,409,13.2,-68
"Taylor County, GA",GA,2011,3171,2718,453,14.3,-95
"Taylor County, GA",GA,2010,3266,2788,478,14.6,0
"Taylor County, IA",IA,2021,3100,3003,97,3.1,6
"Taylor County, IA",IA,2020,3094,2984,110,3.6,-156
"Taylor County, IA",IA,2019,3250,3192,58,1.8,-32
"Taylor County, IA",IA,2018,3282,3218,64,2.0,15
"Taylor County, IA",IA,2017,3267,3196,71,2.2,20
"Taylor County, IA",IA,2016,3247,3152,95,2.9,7
"Taylor County, IA",IA,2015,3240,3138,102,3.1,-3
"Taylor County, IA",IA,2014,3243,3124,119,3.7,71
"Taylor County, IA",IA,2013,3172,3050,122,3.8,16
"Taylor County, IA",IA,2012,3156,3026,130,4.1,-9
"Taylor County, IA",IA,2011,3165,3012,153,4.8,-17
"Taylor County, IA",IA,2010,3182,3001,181,5.7,0
"Taylor County, KY",KY,2021,12363,11879,484,3.9,-608
"Taylor County, KY",KY,2020,12971,12220,751,5.8,150
"Taylor County, KY",KY,2019,12821,12308,513,4.0,280
"Taylor County, KY",KY,2018,12541,12028,513,4.1,-334
"Taylor County, KY",KY,2017,12875,12323,552,4.3,657
"Taylor County, KY",KY,2016,12218,11622,596,4.9,445
"Taylor County, KY",KY,2015,11773,11072,701,6.0,492
"Taylor County, KY",KY,2014,11281,10413,868,7.7,-109
"Taylor County, KY",KY,2013,11390,10323,1067,9.4,-303
"Taylor County, KY",KY,2012,11693,10565,1128,9.6,-265
"Taylor County, KY",KY,2011,11958,10664,1294,10.8,90
"Taylor County, KY",KY,2010,11868,10398,1470,12.4,0
"Taylor County, TX",TX,2021,67165,64246,2919,4.3,1600
"Taylor County, TX",TX,2020,65565,61986,3579,5.5,-431
"Taylor County, TX",TX,2019,65996,64105,1891,2.9,1289
"Taylor County, TX",TX,2018,64707,62647,2060,3.2,975
"Taylor County, TX",TX,2017,63732,61462,2270,3.6,410
"Taylor County, TX",TX,2016,63322,60949,2373,3.7,-52
"Taylor County, TX",TX,2015,63374,61031,2343,3.7,-941
"Taylor County, TX",TX,2014,64315,61569,2746,4.3,-215
"Taylor County, TX",TX,2013,64530,61099,3431,5.3,199
"Taylor County, TX",TX,2012,64331,60712,3619,5.6,-291
"Taylor County, TX",TX,2011,64622,60239,4383,6.8,252
"Taylor County, TX",TX,2010,64370,59989,4381,6.8,0
"Taylor County, WI",WI,2021,11197,10823,374,3.3,100
"Taylor County, WI",WI,2020,11097,10555,542,4.9,120
"Taylor County, WI",WI,2019,10977,10594,383,3.5,-92
"Taylor County, WI",WI,2018,11069,10729,340,3.1,-72
"Taylor County, WI",WI,2017,11141,10759,382,3.4,93
"Taylor County, WI",WI,2016,11048,10605,443,4.0,376
"Taylor County, WI",WI,2015,10672,10214,458,4.3,47
"Taylor County, WI",WI,2014,10625,10067,558,5.3,-360
"Taylor County, WI",WI,2013,10985,10286,699,6.4,-80
"Taylor County, WI",WI,2012,11065,10283,782,7.1,-201
"Taylor County, WI",WI,2011,11266,10337,929,8.2,-184
"Taylor County, WI",WI,2010,11450,10296,1154,10.1,0
"Taylor County, WV",WV,2021,7848,7485,363,4.6,124
"Taylor County, WV",WV,2020,7724,7167,557,7.2,-193
"Taylor County, WV",WV,2019,7917,7531,386,4.9,56
"Taylor County, WV",WV,2018,7861,7485,376,4.8,6
"Taylor County, WV",WV,2017,7855,7469,386,4.9,11
"Taylor County, WV",WV,2016,7844,7401,443,5.6,12
"Taylor County, WV",WV,2015,7832,7374,458,5.8,15
"Taylor County, WV",WV,2014,7817,7409,408,5.2,48
"Taylor County, WV",WV,2013,7769,7335,434,5.6,203
"Taylor County, WV",WV,2012,7566,7066,500,6.6,139
"Taylor County, WV",WV,2011,7427,6890,537,7.2,-9
"Taylor County, WV",WV,2010,7436,6863,573,7.7,0
"Tazewell County, IL",IL,2021,61358,58305,3053,5.0,-493
"Tazewell County, IL",IL,2020,61851,56747,5104,8.3,-2395
"Tazewell County, IL",IL,2019,64246,61545,2701,4.2,-824
"Tazewell County, IL",IL,2018,65070,61926,3144,4.8,348
"Tazewell County, IL",IL,2017,64722,61264,3458,5.3,-1328
"Tazewell County, IL",IL,2016,66050,61804,4246,6.4,-865
"Tazewell County, IL",IL,2015,66915,62712,4203,6.3,-816
"Tazewell County, IL",IL,2014,67731,63132,4599,6.8,-1267
"Tazewell County, IL",IL,2013,68998,63046,5952,8.6,-2147
"Tazewell County, IL",IL,2012,71145,65789,5356,7.5,-354
"Tazewell County, IL",IL,2011,71499,65546,5953,8.3,-1
"Tazewell County, IL",IL,2010,71500,64357,7143,10.0,0
"Tazewell County, VA",VA,2021,14995,14210,785,5.2,-515
"Tazewell County, VA",VA,2020,15510,14328,1182,7.6,-357
"Tazewell County, VA",VA,2019,15867,15185,682,4.3,-198
"Tazewell County, VA",VA,2018,16065,15364,701,4.4,-238
"Tazewell County, VA",VA,2017,16303,15391,912,5.6,338
"Tazewell County, VA",VA,2016,15965,14787,1178,7.4,-705
"Tazewell County, VA",VA,2015,16670,15454,1216,7.3,-603
"Tazewell County, VA",VA,2014,17273,15895,1378,8.0,-392
"Tazewell County, VA",VA,2013,17665,16174,1491,8.4,-275
"Tazewell County, VA",VA,2012,17940,16485,1455,8.1,-232
"Tazewell County, VA",VA,2011,18172,16726,1446,8.0,-255
"Tazewell County, VA",VA,2010,18427,16771,1656,9.0,0
"Tehama County, CA",CA,2021,25443,23617,1826,7.2,-187
"Tehama County, CA",CA,2020,25630,23282,2348,9.2,34
"Tehama County, CA",CA,2019,25596,24137,1459,5.7,111
"Tehama County, CA",CA,2018,25485,24014,1471,5.8,-26
"Tehama County, CA",CA,2017,25511,23875,1636,6.4,440
"Tehama County, CA",CA,2016,25071,23280,1791,7.1,52
"Tehama County, CA",CA,2015,25019,23029,1990,8.0,-22
"Tehama County, CA",CA,2014,25041,22605,2436,9.7,35
"Tehama County, CA",CA,2013,25006,22065,2941,11.8,-205
"Tehama County, CA",CA,2012,25211,21693,3518,14.0,-340
"Tehama County, CA",CA,2011,25551,21659,3892,15.2,-211
"Tehama County, CA",CA,2010,25762,21699,4063,15.8,0
"Telfair County, GA",GA,2021,3735,3467,268,7.2,-64
"Telfair County, GA",GA,2020,3799,3426,373,9.8,-508
"Telfair County, GA",GA,2019,4307,3894,413,9.6,-63
"Telfair County, GA",GA,2018,4370,4073,297,6.8,-462
"Telfair County, GA",GA,2017,4832,4451,381,7.9,21
"Telfair County, GA",GA,2016,4811,4403,408,8.5,39
"Telfair County, GA",GA,2015,4772,4350,422,8.8,-470
"Telfair County, GA",GA,2014,5242,4729,513,9.8,-46
"Telfair County, GA",GA,2013,5288,4688,600,11.3,-36
"Telfair County, GA",GA,2012,5324,4706,618,11.6,56
"Telfair County, GA",GA,2011,5268,4579,689,13.1,18
"Telfair County, GA",GA,2010,5250,4468,782,14.9,0
"Teller County, CO",CO,2021,13074,12429,645,4.9,238
"Teller County, CO",CO,2020,12836,11924,912,7.1,152
"Teller County, CO",CO,2019,12684,12315,369,2.9,270
"Teller County, CO",CO,2018,12414,11992,422,3.4,279
"Teller County, CO",CO,2017,12135,11774,361,3.0,404
"Teller County, CO",CO,2016,11731,11315,416,3.5,329
"Teller County, CO",CO,2015,11402,10912,490,4.3,-175
"Teller County, CO",CO,2014,11577,10902,675,5.8,-129
"Teller County, CO",CO,2013,11706,10806,900,7.7,-173
"Teller County, CO",CO,2012,11879,10869,1010,8.5,-250
"Teller County, CO",CO,2011,12129,10964,1165,9.6,-183
"Teller County, CO",CO,2010,12312,11110,1202,9.8,0
"Tensas Parish, LA",LA,2021,1318,1240,78,5.9,-24
"Tensas Parish, LA",LA,2020,1342,1221,121,9.0,-55
"Tensas Parish, LA",LA,2019,1397,1284,113,8.1,-52
"Tensas Parish, LA",LA,2018,1449,1339,110,7.6,-105
"Tensas Parish, LA",LA,2017,1554,1423,131,8.4,-74
"Tensas Parish, LA",LA,2016,1628,1468,160,9.8,-82
"Tensas Parish, LA",LA,2015,1710,1544,166,9.7,-67
"Tensas Parish, LA",LA,2014,1777,1612,165,9.3,12
"Tensas Parish, LA",LA,2013,1765,1606,159,9.0,-54
"Tensas Parish, LA",LA,2012,1819,1631,188,10.3,-161
"Tensas Parish, LA",LA,2011,1980,1736,244,12.3,-132
"Tensas Parish, LA",LA,2010,2112,1836,276,13.1,0
"Terrebonne Parish, LA",LA,2021,45015,42418,2597,5.8,-644
"Terrebonne Parish, LA",LA,2020,45659,41907,3752,8.2,-778
"Terrebonne Parish, LA",LA,2019,46437,44363,2074,4.5,-176
"Terrebonne Parish, LA",LA,2018,46613,44313,2300,4.9,-205
"Terrebonne Parish, LA",LA,2017,46818,44157,2661,5.7,-2193
"Terrebonne Parish, LA",LA,2016,49011,45592,3419,7.0,-3789
"Terrebonne Parish, LA",LA,2015,52800,49667,3133,5.9,-1658
"Terrebonne Parish, LA",LA,2014,54458,51868,2590,4.8,1372
"Terrebonne Parish, LA",LA,2013,53086,50521,2565,4.8,1797
"Terrebonne Parish, LA",LA,2012,51289,48690,2599,5.1,1169
"Terrebonne Parish, LA",LA,2011,50120,47165,2955,5.9,-794
"Terrebonne Parish, LA",LA,2010,50914,47811,3103,6.1,0
"Terrell County, GA",GA,2021,3568,3347,221,6.2,41
"Terrell County, GA",GA,2020,3527,3264,263,7.5,-26
"Terrell County, GA",GA,2019,3553,3369,184,5.2,-29
"Terrell County, GA",GA,2018,3582,3340,242,6.8,-121
"Terrell County, GA",GA,2017,3703,3479,224,6.0,46
"Terrell County, GA",GA,2016,3657,3417,240,6.6,67
"Terrell County, GA",GA,2015,3590,3318,272,7.6,-23
"Terrell County, GA",GA,2014,3613,3322,291,8.1,-46
"Terrell County, GA",GA,2013,3659,3304,355,9.7,-82
"Terrell County, GA",GA,2012,3741,3339,402,10.7,-101
"Terrell County, GA",GA,2011,3842,3385,457,11.9,-89
"Terrell County, GA",GA,2010,3931,3444,487,12.4,0
"Terrell County, TX",TX,2021,411,396,15,3.6,34
"Terrell County, TX",TX,2020,377,360,17,4.5,4
"Terrell County, TX",TX,2019,373,360,13,3.5,-1
"Terrell County, TX",TX,2018,374,361,13,3.5,-16
"Terrell County, TX",TX,2017,390,372,18,4.6,-17
"Terrell County, TX",TX,2016,407,390,17,4.2,-28
"Terrell County, TX",TX,2015,435,414,21,4.8,-44
"Terrell County, TX",TX,2014,479,457,22,4.6,-44
"Terrell County, TX",TX,2013,523,497,26,5.0,-24
"Terrell County, TX",TX,2012,547,522,25,4.6,30
"Terrell County, TX",TX,2011,517,484,33,6.4,16
"Terrell County, TX",TX,2010,501,467,34,6.8,0
"Terry County, TX",TX,2021,4776,4484,292,6.1,5
"Terry County, TX",TX,2020,4771,4422,349,7.3,-167
"Terry County, TX",TX,2019,4938,4758,180,3.6,-144
"Terry County, TX",TX,2018,5082,4873,209,4.1,-123
"Terry County, TX",TX,2017,5205,4942,263,5.1,-147
"Terry County, TX",TX,2016,5352,5096,256,4.8,-53
"Terry County, TX",TX,2015,5405,5150,255,4.7,-199
"Terry County, TX",TX,2014,5604,5360,244,4.4,82
"Terry County, TX",TX,2013,5522,5192,330,6.0,-129
"Terry County, TX",TX,2012,5651,5284,367,6.5,-198
"Terry County, TX",TX,2011,5849,5420,429,7.3,85
"Terry County, TX",TX,2010,5764,5333,431,7.5,0
"Teton County, ID",ID,2021,7105,6898,207,2.9,404
"Teton County, ID",ID,2020,6701,6316,385,5.7,27
"Teton County, ID",ID,2019,6674,6522,152,2.3,224
"Teton County, ID",ID,2018,6450,6302,148,2.3,277
"Teton County, ID",ID,2017,6173,6015,158,2.6,193
"Teton County, ID",ID,2016,5980,5793,187,3.1,150
"Teton County, ID",ID,2015,5830,5644,186,3.2,229
"Teton County, ID",ID,2014,5601,5398,203,3.6,106
"Teton County, ID",ID,2013,5495,5189,306,5.6,162
"Teton County, ID",ID,2012,5333,5010,323,6.1,11
"Teton County, ID",ID,2011,5322,4970,352,6.6,-130
"Teton County, ID",ID,2010,5452,5036,416,7.6,0
"Teton County, MT",MT,2021,2820,2732,88,3.1,29
"Teton County, MT",MT,2020,2791,2672,119,4.3,5
"Teton County, MT",MT,2019,2786,2693,93,3.3,65
"Teton County, MT",MT,2018,2721,2629,92,3.4,-76
"Teton County, MT",MT,2017,2797,2686,111,4.0,-31
"Teton County, MT",MT,2016,2828,2722,106,3.7,-63
"Teton County, MT",MT,2015,2891,2777,114,3.9,9
"Teton County, MT",MT,2014,2882,2774,108,3.7,-74
"Teton County, MT",MT,2013,2956,2830,126,4.3,14
"Teton County, MT",MT,2012,2942,2803,139,4.7,1
"Teton County, MT",MT,2011,2941,2782,159,5.4,-92
"Teton County, MT",MT,2010,3033,2854,179,5.9,0
"Teton County, WY",WY,2021,15886,15375,511,3.2,748
"Teton County, WY",WY,2020,15138,14251,887,5.9,-729
"Teton County, WY",WY,2019,15867,15417,450,2.8,400
"Teton County, WY",WY,2018,15467,15002,465,3.0,10
"Teton County, WY",WY,2017,15457,15007,450,2.9,210
"Teton County, WY",WY,2016,15247,14715,532,3.5,673
"Teton County, WY",WY,2015,14574,14016,558,3.8,302
"Teton County, WY",WY,2014,14272,13579,693,4.9,366
"Teton County, WY",WY,2013,13906,13120,786,5.7,256
"Teton County, WY",WY,2012,13650,12710,940,6.9,174
"Teton County, WY",WY,2011,13476,12404,1072,8.0,-92
"Teton County, WY",WY,2010,13568,12446,1122,8.3,0
"Texas County, MO",MO,2021,9000,8590,410,4.6,62
"Texas County, MO",MO,2020,8938,8425,513,5.7,57
"Texas County, MO",MO,2019,8881,8504,377,4.2,-131
"Texas County, MO",MO,2018,9012,8652,360,4.0,-351
"Texas County, MO",MO,2017,9363,8902,461,4.9,49
"Texas County, MO",MO,2016,9314,8731,583,6.3,-38
"Texas County, MO",MO,2015,9352,8718,634,6.8,-51
"Texas County, MO",MO,2014,9403,8656,747,7.9,-277
"Texas County, MO",MO,2013,9680,8879,801,8.3,94
"Texas County, MO",MO,2012,9586,8776,810,8.4,-137
"Texas County, MO",MO,2011,9723,8758,965,9.9,-75
"Texas County, MO",MO,2010,9798,8727,1071,10.9,0
"Texas County, OK",OK,2021,11412,11202,210,1.8,166
"Texas County, OK",OK,2020,11246,10982,264,2.3,72
"Texas County, OK",OK,2019,11174,10970,204,1.8,2175
"Texas County, OK",OK,2018,8999,8762,237,2.6,-337
"Texas County, OK",OK,2017,9336,9060,276,3.0,-60
"Texas County, OK",OK,2016,9396,9089,307,3.3,-292
"Texas County, OK",OK,2015,9688,9384,304,3.1,345
"Texas County, OK",OK,2014,9343,9010,333,3.6,64
"Texas County, OK",OK,2013,9279,8884,395,4.3,329
"Texas County, OK",OK,2012,8950,8589,361,4.0,133
"Texas County, OK",OK,2011,8817,8447,370,4.2,222
"Texas County, OK",OK,2010,8595,8193,402,4.7,0
"Thayer County, NE",NE,2021,2690,2644,46,1.7,-100
"Thayer County, NE",NE,2020,2790,2715,75,2.7,-25
"Thayer County, NE",NE,2019,2815,2742,73,2.6,-67
"Thayer County, NE",NE,2018,2882,2816,66,2.3,-7
"Thayer County, NE",NE,2017,2889,2823,66,2.3,-30
"Thayer County, NE",NE,2016,2919,2848,71,2.4,-59
"Thayer County, NE",NE,2015,2978,2908,70,2.4,-56
"Thayer County, NE",NE,2014,3034,2957,77,2.5,-14
"Thayer County, NE",NE,2013,3048,2965,83,2.7,45
"Thayer County, NE",NE,2012,3003,2913,90,3.0,76
"Thayer County, NE",NE,2011,2927,2831,96,3.3,128
"Thayer County, NE",NE,2010,2799,2691,108,3.9,0
"Thomas County, GA",GA,2021,17576,16841,735,4.2,579
"Thomas County, GA",GA,2020,16997,15944,1053,6.2,-36
"Thomas County, GA",GA,2019,17033,16339,694,4.1,114
"Thomas County, GA",GA,2018,16919,16116,803,4.7,-463
"Thomas County, GA",GA,2017,17382,16366,1016,5.8,-151
"Thomas County, GA",GA,2016,17533,16425,1108,6.3,907
"Thomas County, GA",GA,2015,16626,15403,1223,7.4,-497
"Thomas County, GA",GA,2014,17123,15619,1504,8.8,-657
"Thomas County, GA",GA,2013,17780,16187,1593,9.0,-642
"Thomas County, GA",GA,2012,18422,16662,1760,9.6,108
"Thomas County, GA",GA,2011,18314,16420,1894,10.3,366
"Thomas County, GA",GA,2010,17948,15894,2054,11.4,0
"Thomas County, KS",KS,2021,4259,4181,78,1.8,26
"Thomas County, KS",KS,2020,4233,4121,112,2.6,-98
"Thomas County, KS",KS,2019,4331,4235,96,2.2,44
"Thomas County, KS",KS,2018,4287,4181,106,2.5,14
"Thomas County, KS",KS,2017,4273,4163,110,2.6,-99
"Thomas County, KS",KS,2016,4372,4252,120,2.7,-55
"Thomas County, KS",KS,2015,4427,4310,117,2.6,41
"Thomas County, KS",KS,2014,4386,4260,126,2.9,-89
"Thomas County, KS",KS,2013,4475,4319,156,3.5,-84
"Thomas County, KS",KS,2012,4559,4402,157,3.4,-65
"Thomas County, KS",KS,2011,4624,4457,167,3.6,80
"Thomas County, KS",KS,2010,4544,4367,177,3.9,0
"Thomas County, NE",NE,2021,430,419,11,2.6,0
"Thomas County, NE",NE,2020,430,413,17,4.0,-2
"Thomas County, NE",NE,2019,432,416,16,3.7,-9
"Thomas County, NE",NE,2018,441,428,13,2.9,1
"Thomas County, NE",NE,2017,440,426,14,3.2,-11
"Thomas County, NE",NE,2016,451,436,15,3.3,14
"Thomas County, NE",NE,2015,437,424,13,3.0,9
"Thomas County, NE",NE,2014,428,413,15,3.5,-25
"Thomas County, NE",NE,2013,453,436,17,3.8,27
"Thomas County, NE",NE,2012,426,410,16,3.8,0
"Thomas County, NE",NE,2011,426,404,22,5.2,31
"Thomas County, NE",NE,2010,395,376,19,4.8,0
"Throckmorton County, TX",TX,2021,1008,980,28,2.8,375
"Throckmorton County, TX",TX,2020,633,603,30,4.7,-8
"Throckmorton County, TX",TX,2019,641,617,24,3.7,-53
"Throckmorton County, TX",TX,2018,694,671,23,3.3,8
"Throckmorton County, TX",TX,2017,686,656,30,4.4,-57
"Throckmorton County, TX",TX,2016,743,717,26,3.5,-38
"Throckmorton County, TX",TX,2015,781,756,25,3.2,-50
"Throckmorton County, TX",TX,2014,831,798,33,4.0,37
"Throckmorton County, TX",TX,2013,794,754,40,5.0,-35
"Throckmorton County, TX",TX,2012,829,785,44,5.3,-43
"Throckmorton County, TX",TX,2011,872,809,63,7.2,-6
"Throckmorton County, TX",TX,2010,878,825,53,6.0,0
"Thurston County, NE",NE,2021,3195,3088,107,3.3,70
"Thurston County, NE",NE,2020,3125,2967,158,5.1,43
"Thurston County, NE",NE,2019,3082,2943,139,4.5,76
"Thurston County, NE",NE,2018,3006,2881,125,4.2,-36
"Thurston County, NE",NE,2017,3042,2889,153,5.0,47
"Thurston County, NE",NE,2016,2995,2852,143,4.8,13
"Thurston County, NE",NE,2015,2982,2824,158,5.3,-39
"Thurston County, NE",NE,2014,3021,2839,182,6.0,-70
"Thurston County, NE",NE,2013,3091,2860,231,7.5,-44
"Thurston County, NE",NE,2012,3135,2869,266,8.5,11
"Thurston County, NE",NE,2011,3124,2805,319,10.2,71
"Thurston County, NE",NE,2010,3053,2756,297,9.7,0
"Thurston County, WA",WA,2021,145252,137708,7544,5.2,-2230
"Thurston County, WA",WA,2020,147482,135613,11869,8.0,3346
"Thurston County, WA",WA,2019,144136,137010,7126,4.9,5285
"Thurston County, WA",WA,2018,138851,132256,6595,4.7,3935
"Thurston County, WA",WA,2017,134916,128322,6594,4.9,5020
"Thurston County, WA",WA,2016,129896,122677,7219,5.6,4135
"Thurston County, WA",WA,2015,125761,118488,7273,5.8,2539
"Thurston County, WA",WA,2014,123222,115445,7777,6.3,521
"Thurston County, WA",WA,2013,122701,113589,9112,7.4,-61
"Thurston County, WA",WA,2012,122762,113263,9499,7.7,566
"Thurston County, WA",WA,2011,122196,112328,9868,8.1,-2339
"Thurston County, WA",WA,2010,124535,114417,10118,8.1,0
"Tift County, GA",GA,2021,21225,20501,724,3.4,692
"Tift County, GA",GA,2020,20533,19496,1037,5.1,193
"Tift County, GA",GA,2019,20340,19643,697,3.4,945
"Tift County, GA",GA,2018,19395,18610,785,4.0,79
"Tift County, GA",GA,2017,19316,18407,909,4.7,763
"Tift County, GA",GA,2016,18553,17541,1012,5.5,416
"Tift County, GA",GA,2015,18137,17009,1128,6.2,-86
"Tift County, GA",GA,2014,18223,16890,1333,7.3,-446
"Tift County, GA",GA,2013,18669,17094,1575,8.4,-419
"Tift County, GA",GA,2012,19088,17191,1897,9.9,187
"Tift County, GA",GA,2011,18901,16635,2266,12.0,63
"Tift County, GA",GA,2010,18838,16557,2281,12.1,0
"Tillamook County, OR",OR,2021,12137,11469,668,5.5,275
"Tillamook County, OR",OR,2020,11862,10910,952,8.0,10
"Tillamook County, OR",OR,2019,11852,11399,453,3.8,98
"Tillamook County, OR",OR,2018,11754,11255,499,4.2,80
"Tillamook County, OR",OR,2017,11674,11186,488,4.2,62
"Tillamook County, OR",OR,2016,11612,11051,561,4.8,216
"Tillamook County, OR",OR,2015,11396,10771,625,5.5,165
"Tillamook County, OR",OR,2014,11231,10470,761,6.8,229
"Tillamook County, OR",OR,2013,11002,10094,908,8.3,-230
"Tillamook County, OR",OR,2012,11232,10144,1088,9.7,-429
"Tillamook County, OR",OR,2011,11661,10492,1169,10.0,-153
"Tillamook County, OR",OR,2010,11814,10568,1246,10.5,0
"Tillman County, OK",OK,2021,2921,2797,124,4.2,-97
"Tillman County, OK",OK,2020,3018,2827,191,6.3,30
"Tillman County, OK",OK,2019,2988,2883,105,3.5,-101
"Tillman County, OK",OK,2018,3089,2978,111,3.6,-168
"Tillman County, OK",OK,2017,3257,3127,130,4.0,-51
"Tillman County, OK",OK,2016,3308,3167,141,4.3,-47
"Tillman County, OK",OK,2015,3355,3215,140,4.2,62
"Tillman County, OK",OK,2014,3293,3145,148,4.5,-70
"Tillman County, OK",OK,2013,3363,3187,176,5.2,-36
"Tillman County, OK",OK,2012,3399,3240,159,4.7,54
"Tillman County, OK",OK,2011,3345,3159,186,5.6,-57
"Tillman County, OK",OK,2010,3402,3199,203,6.0,0
"Tioga County, NY",NY,2021,21974,21005,969,4.4,-554
"Tioga County, NY",NY,2020,22528,20836,1692,7.5,-663
"Tioga County, NY",NY,2019,23191,22267,924,4.0,-168
"Tioga County, NY",NY,2018,23359,22344,1015,4.3,191
"Tioga County, NY",NY,2017,23168,21984,1184,5.1,141
"Tioga County, NY",NY,2016,23027,21824,1203,5.2,-319
"Tioga County, NY",NY,2015,23346,22042,1304,5.6,-402
"Tioga County, NY",NY,2014,23748,22288,1460,6.1,-1195
"Tioga County, NY",NY,2013,24943,23121,1822,7.3,-486
"Tioga County, NY",NY,2012,25429,23394,2035,8.0,-424
"Tioga County, NY",NY,2011,25853,23851,2002,7.7,-735
"Tioga County, NY",NY,2010,26588,24427,2161,8.1,0
"Tioga County, PA",PA,2021,18887,17633,1254,6.6,-223
"Tioga County, PA",PA,2020,19110,17382,1728,9.0,-118
"Tioga County, PA",PA,2019,19228,18185,1043,5.4,178
"Tioga County, PA",PA,2018,19050,18028,1022,5.4,-246
"Tioga County, PA",PA,2017,19296,18126,1170,6.1,-596
"Tioga County, PA",PA,2016,19892,18489,1403,7.1,-452
"Tioga County, PA",PA,2015,20344,18994,1350,6.6,-94
"Tioga County, PA",PA,2014,20438,19004,1434,7.0,-746
"Tioga County, PA",PA,2013,21184,19426,1758,8.3,-498
"Tioga County, PA",PA,2012,21682,20065,1617,7.5,529
"Tioga County, PA",PA,2011,21153,19704,1449,6.9,1026
"Tioga County, PA",PA,2010,20127,18508,1619,8.0,0
"Tippah County, MS",MS,2021,9427,8993,434,4.6,245
"Tippah County, MS",MS,2020,9182,8552,630,6.9,-378
"Tippah County, MS",MS,2019,9560,9071,489,5.1,129
"Tippah County, MS",MS,2018,9431,9011,420,4.5,-9
"Tippah County, MS",MS,2017,9440,9007,433,4.6,87
"Tippah County, MS",MS,2016,9353,8823,530,5.7,-57
"Tippah County, MS",MS,2015,9410,8804,606,6.4,711
"Tippah County, MS",MS,2014,8699,7970,729,8.4,-39
"Tippah County, MS",MS,2013,8738,7886,852,9.8,-393
"Tippah County, MS",MS,2012,9131,8229,902,9.9,-176
"Tippah County, MS",MS,2011,9307,8231,1076,11.6,308
"Tippah County, MS",MS,2010,8999,7817,1182,13.1,0
"Tippecanoe County, IN",IN,2021,93208,90171,3037,3.3,1439
"Tippecanoe County, IN",IN,2020,91769,85742,6027,6.6,-6515
"Tippecanoe County, IN",IN,2019,98284,95360,2924,3.0,27
"Tippecanoe County, IN",IN,2018,98257,95164,3093,3.1,2661
"Tippecanoe County, IN",IN,2017,95596,92552,3044,3.2,1114
"Tippecanoe County, IN",IN,2016,94482,90699,3783,4.0,1374
"Tippecanoe County, IN",IN,2015,93108,89182,3926,4.2,1744
"Tippecanoe County, IN",IN,2014,91364,86782,4582,5.0,1565
"Tippecanoe County, IN",IN,2013,89799,83941,5858,6.5,1257
"Tippecanoe County, IN",IN,2012,88542,82474,6068,6.9,881
"Tippecanoe County, IN",IN,2011,87661,81267,6394,7.3,1104
"Tippecanoe County, IN",IN,2010,86557,79118,7439,8.6,0
"Tipton County, IN",IN,2021,8960,8691,269,3.0,-68
"Tipton County, IN",IN,2020,9028,8465,563,6.2,-335
"Tipton County, IN",IN,2019,9363,9114,249,2.7,115
"Tipton County, IN",IN,2018,9248,8993,255,2.8,703
"Tipton County, IN",IN,2017,8545,8287,258,3.0,8
"Tipton County, IN",IN,2016,8537,8213,324,3.8,157
"Tipton County, IN",IN,2015,8380,8047,333,4.0,210
"Tipton County, IN",IN,2014,8170,7747,423,5.2,196
"Tipton County, IN",IN,2013,7974,7446,528,6.6,-43
"Tipton County, IN",IN,2012,8017,7403,614,7.7,43
"Tipton County, IN",IN,2011,7974,7271,703,8.8,-74
"Tipton County, IN",IN,2010,8048,7244,804,10.0,0
"Tipton County, TN",TN,2021,27707,26518,1189,4.3,88
"Tipton County, TN",TN,2020,27619,25795,1824,6.6,-751
"Tipton County, TN",TN,2019,28370,27268,1102,3.9,329
"Tipton County, TN",TN,2018,28041,26860,1181,4.2,416
"Tipton County, TN",TN,2017,27625,26401,1224,4.4,96
"Tipton County, TN",TN,2016,27529,25958,1571,5.7,-18
"Tipton County, TN",TN,2015,27547,25611,1936,7.0,111
"Tipton County, TN",TN,2014,27436,25159,2277,8.3,-613
"Tipton County, TN",TN,2013,28049,25398,2651,9.5,-235
"Tipton County, TN",TN,2012,28284,25736,2548,9.0,-506
"Tipton County, TN",TN,2011,28790,25775,3015,10.5,-297
"Tipton County, TN",TN,2010,29087,25733,3354,11.5,0
"Tishomingo County, MS",MS,2021,8317,7938,379,4.6,71
"Tishomingo County, MS",MS,2020,8246,7714,532,6.5,-433
"Tishomingo County, MS",MS,2019,8679,8235,444,5.1,187
"Tishomingo County, MS",MS,2018,8492,8093,399,4.7,155
"Tishomingo County, MS",MS,2017,8337,7912,425,5.1,120
"Tishomingo County, MS",MS,2016,8217,7757,460,5.6,230
"Tishomingo County, MS",MS,2015,7987,7472,515,6.4,419
"Tishomingo County, MS",MS,2014,7568,6979,589,7.8,-130
"Tishomingo County, MS",MS,2013,7698,6991,707,9.2,-272
"Tishomingo County, MS",MS,2012,7970,7164,806,10.1,-114
"Tishomingo County, MS",MS,2011,8084,7131,953,11.8,263
"Tishomingo County, MS",MS,2010,7821,6852,969,12.4,0
"Titus County, TX",TX,2021,13563,12837,726,5.4,410
"Titus County, TX",TX,2020,13153,12268,885,6.7,371
"Titus County, TX",TX,2019,12782,12253,529,4.1,7
"Titus County, TX",TX,2018,12775,12127,648,5.1,-81
"Titus County, TX",TX,2017,12856,12157,699,5.4,-28
"Titus County, TX",TX,2016,12884,12088,796,6.2,143
"Titus County, TX",TX,2015,12741,12002,739,5.8,-153
"Titus County, TX",TX,2014,12894,12071,823,6.4,-161
"Titus County, TX",TX,2013,13055,12077,978,7.5,-181
"Titus County, TX",TX,2012,13236,12248,988,7.5,-480
"Titus County, TX",TX,2011,13716,12551,1165,8.5,-293
"Titus County, TX",TX,2010,14009,12808,1201,8.6,0
"Toa Alta Municipio, PR",PR,2021,29869,27968,1901,6.4,
"Toa Alta Municipio, PR",PR,2020,N.A.,N.A.,N.A.,N.A.,
"Toa Alta Municipio, PR",PR,2019,27324,25786,1538,5.6,637
"Toa Alta Municipio, PR",PR,2018,26687,25013,1674,6.3,121
"Toa Alta Municipio, PR",PR,2017,26566,24512,2054,7.7,15
"Toa Alta Municipio, PR",PR,2016,26551,24343,2208,8.3,215
"Toa Alta Municipio, PR",PR,2015,26336,24140,2196,8.3,397
"Toa Alta Municipio, PR",PR,2014,25939,23561,2378,9.2,-351
"Toa Alta Municipio, PR",PR,2013,26290,23838,2452,9.3,-346
"Toa Alta Municipio, PR",PR,2012,26636,23951,2685,10.1,-58
"Toa Alta Municipio, PR",PR,2011,26694,23589,3105,11.6,-608
"Toa Alta Municipio, PR",PR,2010,27302,24016,3286,12.0,0
"Toa Baja Municipio, PR",PR,2021,31133,29024,2109,6.8,
"Toa Baja Municipio, PR",PR,2020,N.A.,N.A.,N.A.,N.A.,
"Toa Baja Municipio, PR",PR,2019,28942,27265,1677,5.8,106
"Toa Baja Municipio, PR",PR,2018,28836,26929,1907,6.6,-349
"Toa Baja Municipio, PR",PR,2017,29185,26823,2362,8.1,-568
"Toa Baja Municipio, PR",PR,2016,29753,27071,2682,9.0,-277
"Toa Baja Municipio, PR",PR,2015,30030,27316,2714,9.0,-233
"Toa Baja Municipio, PR",PR,2014,30263,27171,3092,10.2,-946
"Toa Baja Municipio, PR",PR,2013,31209,27921,3288,10.5,-700
"Toa Baja Municipio, PR",PR,2012,31909,28534,3375,10.6,-707
"Toa Baja Municipio, PR",PR,2011,32616,28600,4016,12.3,-1366
"Toa Baja Municipio, PR",PR,2010,33982,29678,4304,12.7,0
"Todd County, KY",KY,2021,5521,5320,201,3.6,129
"Todd County, KY",KY,2020,5392,5141,251,4.7,-43
"Todd County, KY",KY,2019,5435,5231,204,3.8,139
"Todd County, KY",KY,2018,5296,5090,206,3.9,-32
"Todd County, KY",KY,2017,5328,5108,220,4.1,25
"Todd County, KY",KY,2016,5303,5070,233,4.4,73
"Todd County, KY",KY,2015,5230,4980,250,4.8,-233
"Todd County, KY",KY,2014,5463,5168,295,5.4,-172
"Todd County, KY",KY,2013,5635,5220,415,7.4,-41
"Todd County, KY",KY,2012,5676,5242,434,7.6,-45
"Todd County, KY",KY,2011,5721,5224,497,8.7,17
"Todd County, KY",KY,2010,5704,5127,577,10.1,0
"Todd County, MN",MN,2021,13158,12672,486,3.7,-717
"Todd County, MN",MN,2020,13875,13110,765,5.5,170
"Todd County, MN",MN,2019,13705,13064,641,4.7,157
"Todd County, MN",MN,2018,13548,12982,566,4.2,-13
"Todd County, MN",MN,2017,13561,13021,540,4.0,661
"Todd County, MN",MN,2016,12900,12292,608,4.7,-140
"Todd County, MN",MN,2015,13040,12457,583,4.5,193
"Todd County, MN",MN,2014,12847,12236,611,4.8,-17
"Todd County, MN",MN,2013,12864,12169,695,5.4,-183
"Todd County, MN",MN,2012,13047,12286,761,5.8,-276
"Todd County, MN",MN,2011,13323,12417,906,6.8,-203
"Todd County, MN",MN,2010,13526,12477,1049,7.8,0
"Todd County, SD",SD,2021,3111,2963,148,4.8,68
"Todd County, SD",SD,2020,3043,2858,185,6.1,-85
"Todd County, SD",SD,2019,3128,2955,173,5.5,10
"Todd County, SD",SD,2018,3118,2940,178,5.7,-8
"Todd County, SD",SD,2017,3126,2934,192,6.1,49
"Todd County, SD",SD,2016,3077,2876,201,6.5,11
"Todd County, SD",SD,2015,3066,2844,222,7.2,-61
"Todd County, SD",SD,2014,3127,2862,265,8.5,-76
"Todd County, SD",SD,2013,3203,2894,309,9.6,-51
"Todd County, SD",SD,2012,3254,2954,300,9.2,-149
"Todd County, SD",SD,2011,3403,3120,283,8.3,0
"Todd County, SD",SD,2010,3403,3145,258,7.6,0
"Tolland County, CT",CT,2021,83876,79597,4279,5.1,-2029
"Tolland County, CT",CT,2020,85905,80682,5223,6.1,-2943
"Tolland County, CT",CT,2019,88848,86113,2735,3.1,1193
"Tolland County, CT",CT,2018,87655,84661,2994,3.4,603
"Tolland County, CT",CT,2017,87052,83777,3275,3.8,1636
"Tolland County, CT",CT,2016,85416,81803,3613,4.2,188
"Tolland County, CT",CT,2015,85228,81079,4149,4.9,419
"Tolland County, CT",CT,2014,84809,79875,4934,5.8,1255
"Tolland County, CT",CT,2013,83554,77709,5845,7.0,-1139
"Tolland County, CT",CT,2012,84693,78466,6227,7.4,-1606
"Tolland County, CT",CT,2011,86299,79650,6649,7.7,-41
"Tolland County, CT",CT,2010,86340,79251,7089,8.2,0
"Tom Green County, TX",TX,2021,54009,51382,2627,4.9,699
"Tom Green County, TX",TX,2020,53310,49931,3379,6.3,-673
"Tom Green County, TX",TX,2019,53983,52351,1632,3.0,-132
"Tom Green County, TX",TX,2018,54115,52400,1715,3.2,356
"Tom Green County, TX",TX,2017,53759,51770,1989,3.7,-513
"Tom Green County, TX",TX,2016,54272,51838,2434,4.5,-296
"Tom Green County, TX",TX,2015,54568,52313,2255,4.1,-12
"Tom Green County, TX",TX,2014,54580,52349,2231,4.1,451
"Tom Green County, TX",TX,2013,54129,51314,2815,5.2,466
"Tom Green County, TX",TX,2012,53663,50819,2844,5.3,452
"Tom Green County, TX",TX,2011,53211,49775,3436,6.5,548
"Tom Green County, TX",TX,2010,52663,49196,3467,6.6,0
"Tompkins County, NY",NY,2021,48914,47093,1821,3.7,-600
"Tompkins County, NY",NY,2020,49514,46632,2882,5.8,-914
"Tompkins County, NY",NY,2019,50428,48664,1764,3.5,-662
"Tompkins County, NY",NY,2018,51090,49252,1838,3.6,251
"Tompkins County, NY",NY,2017,50839,48645,2194,4.3,462
"Tompkins County, NY",NY,2016,50377,48245,2132,4.2,41
"Tompkins County, NY",NY,2015,50336,48107,2229,4.4,-4342
"Tompkins County, NY",NY,2014,54678,52262,2416,4.4,-1152
"Tompkins County, NY",NY,2013,55830,52848,2982,5.3,854
"Tompkins County, NY",NY,2012,54976,51558,3418,6.2,717
"Tompkins County, NY",NY,2011,54259,50948,3311,6.1,-539
"Tompkins County, NY",NY,2010,54798,51355,3443,6.3,0
"Tooele County, UT",UT,2021,36804,35747,1057,2.9,750
"Tooele County, UT",UT,2020,36054,34351,1703,4.7,1022
"Tooele County, UT",UT,2019,35032,34052,980,2.8,1544
"Tooele County, UT",UT,2018,33488,32417,1071,3.2,1033
"Tooele County, UT",UT,2017,32455,31325,1130,3.5,1742
"Tooele County, UT",UT,2016,30713,29582,1131,3.7,1333
"Tooele County, UT",UT,2015,29380,28188,1192,4.1,734
"Tooele County, UT",UT,2014,28646,27335,1311,4.6,578
"Tooele County, UT",UT,2013,28068,26667,1401,5.0,835
"Tooele County, UT",UT,2012,27233,25793,1440,5.3,130
"Tooele County, UT",UT,2011,27103,25077,2026,7.5,-235
"Tooele County, UT",UT,2010,27338,25024,2314,8.5,0
"Toole County, MT",MT,2021,2056,2003,53,2.6,-93
"Toole County, MT",MT,2020,2149,2046,103,4.8,5
"Toole County, MT",MT,2019,2144,2092,52,2.4,-4
"Toole County, MT",MT,2018,2148,2093,55,2.6,-14
"Toole County, MT",MT,2017,2162,2096,66,3.1,-62
"Toole County, MT",MT,2016,2224,2144,80,3.6,-75
"Toole County, MT",MT,2015,2299,2219,80,3.5,-49
"Toole County, MT",MT,2014,2348,2277,71,3.0,-41
"Toole County, MT",MT,2013,2389,2298,91,3.8,-112
"Toole County, MT",MT,2012,2501,2399,102,4.1,113
"Toole County, MT",MT,2011,2388,2283,105,4.4,-62
"Toole County, MT",MT,2010,2450,2340,110,4.5,0
"Toombs County, GA",GA,2021,12171,11627,544,4.5,12
"Toombs County, GA",GA,2020,12159,11372,787,6.5,132
"Toombs County, GA",GA,2019,12027,11422,605,5.0,131
"Toombs County, GA",GA,2018,11896,11196,700,5.9,-38
"Toombs County, GA",GA,2017,11934,11148,786,6.6,145
"Toombs County, GA",GA,2016,11789,10856,933,7.9,54
"Toombs County, GA",GA,2015,11735,10693,1042,8.9,-485
"Toombs County, GA",GA,2014,12220,11009,1211,9.9,-551
"Toombs County, GA",GA,2013,12771,11375,1396,10.9,302
"Toombs County, GA",GA,2012,12469,11023,1446,11.6,62
"Toombs County, GA",GA,2011,12407,10755,1652,13.3,67
"Toombs County, GA",GA,2010,12340,10805,1535,12.4,0
"Torrance County, NM",NM,2021,5412,4986,426,7.9,90
"Torrance County, NM",NM,2020,5322,4835,487,9.2,-385
"Torrance County, NM",NM,2019,5707,5316,391,6.9,44
"Torrance County, NM",NM,2018,5663,5235,428,7.6,19
"Torrance County, NM",NM,2017,5644,5167,477,8.5,90
"Torrance County, NM",NM,2016,5554,5042,512,9.2,51
"Torrance County, NM",NM,2015,5503,5000,503,9.1,-98
"Torrance County, NM",NM,2014,5601,5059,542,9.7,-28
"Torrance County, NM",NM,2013,5629,5056,573,10.2,-138
"Torrance County, NM",NM,2012,5767,5166,601,10.4,-69
"Torrance County, NM",NM,2011,5836,5189,647,11.1,-138
"Torrance County, NM",NM,2010,5974,5309,665,11.1,0
"Towner County, ND",ND,2021,1138,1101,37,3.3,-21
"Towner County, ND",ND,2020,1159,1126,33,2.8,-1
"Towner County, ND",ND,2019,1160,1131,29,2.5,-49
"Towner County, ND",ND,2018,1209,1181,28,2.3,-51
"Towner County, ND",ND,2017,1260,1229,31,2.5,-68
"Towner County, ND",ND,2016,1328,1299,29,2.2,96
"Towner County, ND",ND,2015,1232,1199,33,2.7,11
"Towner County, ND",ND,2014,1221,1179,42,3.4,21
"Towner County, ND",ND,2013,1200,1154,46,3.8,-52
"Towner County, ND",ND,2012,1252,1212,40,3.2,-93
"Towner County, ND",ND,2011,1345,1306,39,2.9,-54
"Towner County, ND",ND,2010,1399,1362,37,2.6,0
"Towns County, GA",GA,2021,4055,3895,160,3.9,184
"Towns County, GA",GA,2020,3871,3617,254,6.6,-109
"Towns County, GA",GA,2019,3980,3781,199,5.0,58
"Towns County, GA",GA,2018,3922,3699,223,5.7,120
"Towns County, GA",GA,2017,3802,3550,252,6.6,-306
"Towns County, GA",GA,2016,4108,3825,283,6.9,235
"Towns County, GA",GA,2015,3873,3562,311,8.0,-260
"Towns County, GA",GA,2014,4133,3751,382,9.2,-22
"Towns County, GA",GA,2013,4155,3717,438,10.5,-270
"Towns County, GA",GA,2012,4425,3931,494,11.2,76
"Towns County, GA",GA,2011,4349,3807,542,12.5,-6
"Towns County, GA",GA,2010,4355,3788,567,13.0,0
"Traill County, ND",ND,2021,4439,4304,135,3.0,-44
"Traill County, ND",ND,2020,4483,4322,161,3.6,10
"Traill County, ND",ND,2019,4473,4368,105,2.3,-48
"Traill County, ND",ND,2018,4521,4413,108,2.4,-125
"Traill County, ND",ND,2017,4646,4533,113,2.4,57
"Traill County, ND",ND,2016,4589,4461,128,2.8,174
"Traill County, ND",ND,2015,4415,4290,125,2.8,7
"Traill County, ND",ND,2014,4408,4295,113,2.6,-42
"Traill County, ND",ND,2013,4450,4322,128,2.9,-54
"Traill County, ND",ND,2012,4504,4368,136,3.0,-88
"Traill County, ND",ND,2011,4592,4430,162,3.5,21
"Traill County, ND",ND,2010,4571,4405,166,3.6,0
"Transylvania County, NC",NC,2021,14101,13524,577,4.1,344
"Transylvania County, NC",NC,2020,13757,12938,819,6.0,-816
"Transylvania County, NC",NC,2019,14573,14042,531,3.6,489
"Transylvania County, NC",NC,2018,14084,13545,539,3.8,71
"Transylvania County, NC",NC,2017,14013,13409,604,4.3,98
"Transylvania County, NC",NC,2016,13915,13237,678,4.9,382
"Transylvania County, NC",NC,2015,13533,12806,727,5.4,188
"Transylvania County, NC",NC,2014,13345,12588,757,5.7,-82
"Transylvania County, NC",NC,2013,13427,12458,969,7.2,-141
"Transylvania County, NC",NC,2012,13568,12360,1208,8.9,106
"Transylvania County, NC",NC,2011,13462,12196,1266,9.4,-394
"Transylvania County, NC",NC,2010,13856,12517,1339,9.7,0
"Traverse County, MN",MN,2021,1632,1582,50,3.1,-133
"Traverse County, MN",MN,2020,1765,1684,81,4.6,-19
"Traverse County, MN",MN,2019,1784,1715,69,3.9,0
"Traverse County, MN",MN,2018,1784,1722,62,3.5,4
"Traverse County, MN",MN,2017,1780,1716,64,3.6,75
"Traverse County, MN",MN,2016,1705,1639,66,3.9,-135
"Traverse County, MN",MN,2015,1840,1762,78,4.2,124
"Traverse County, MN",MN,2014,1716,1635,81,4.7,55
"Traverse County, MN",MN,2013,1661,1576,85,5.1,-116
"Traverse County, MN",MN,2012,1777,1687,90,5.1,-70
"Traverse County, MN",MN,2011,1847,1736,111,6.0,-35
"Traverse County, MN",MN,2010,1882,1765,117,6.2,0
"Travis County, TX",TX,2021,770868,739716,31152,4.0,40277
"Travis County, TX",TX,2020,730591,684165,46426,6.4,1885
"Travis County, TX",TX,2019,728706,709594,19112,2.6,16490
"Travis County, TX",TX,2018,712216,691743,20473,2.9,18791
"Travis County, TX",TX,2017,693425,672102,21323,3.1,14945
"Travis County, TX",TX,2016,678480,656873,21607,3.2,22561
"Travis County, TX",TX,2015,655919,634230,21689,3.3,12514
"Travis County, TX",TX,2014,643405,616779,26626,4.1,14787
"Travis County, TX",TX,2013,628618,596682,31936,5.1,17776
"Travis County, TX",TX,2012,610842,577445,33397,5.5,17336
"Travis County, TX",TX,2011,593506,554438,39068,6.6,17095
"Travis County, TX",TX,2010,576411,537174,39237,6.8,0
"Treasure County, MT",MT,2021,346,335,11,3.2,5
"Treasure County, MT",MT,2020,341,329,12,3.5,-4
"Treasure County, MT",MT,2019,345,335,10,2.9,9
"Treasure County, MT",MT,2018,336,326,10,3.0,-6
"Treasure County, MT",MT,2017,342,329,13,3.8,-11
"Treasure County, MT",MT,2016,353,337,16,4.5,-4
"Treasure County, MT",MT,2015,357,339,18,5.0,10
"Treasure County, MT",MT,2014,347,333,14,4.0,-8
"Treasure County, MT",MT,2013,355,339,16,4.5,-24
"Treasure County, MT",MT,2012,379,361,18,4.7,1
"Treasure County, MT",MT,2011,378,358,20,5.3,-21
"Treasure County, MT",MT,2010,399,378,21,5.3,0
"Trego County, KS",KS,2021,1419,1389,30,2.1,-28
"Trego County, KS",KS,2020,1447,1399,48,3.3,31
"Trego County, KS",KS,2019,1416,1377,39,2.8,31
"Trego County, KS",KS,2018,1385,1343,42,3.0,-57
"Trego County, KS",KS,2017,1442,1394,48,3.3,-41
"Trego County, KS",KS,2016,1483,1424,59,4.0,-30
"Trego County, KS",KS,2015,1513,1460,53,3.5,22
"Trego County, KS",KS,2014,1491,1445,46,3.1,-3
"Trego County, KS",KS,2013,1494,1439,55,3.7,-21
"Trego County, KS",KS,2012,1515,1450,65,4.3,14
"Trego County, KS",KS,2011,1501,1432,69,4.6,-9
"Trego County, KS",KS,2010,1510,1440,70,4.6,0
"Trempealeau County, WI",WI,2021,15613,15033,580,3.7,-188
"Trempealeau County, WI",WI,2020,15801,14690,1111,7.0,-212
"Trempealeau County, WI",WI,2019,16013,15465,548,3.4,-355
"Trempealeau County, WI",WI,2018,16368,15906,462,2.8,-151
"Trempealeau County, WI",WI,2017,16519,16018,501,3.0,-103
"Trempealeau County, WI",WI,2016,16622,16024,598,3.6,46
"Trempealeau County, WI",WI,2015,16576,15943,633,3.8,68
"Trempealeau County, WI",WI,2014,16508,15767,741,4.5,97
"Trempealeau County, WI",WI,2013,16411,15501,910,5.5,61
"Trempealeau County, WI",WI,2012,16350,15432,918,5.6,185
"Trempealeau County, WI",WI,2011,16165,15119,1046,6.5,167
"Trempealeau County, WI",WI,2010,15998,14810,1188,7.4,0
"Treutlen County, GA",GA,2021,2630,2518,112,4.3,-28
"Treutlen County, GA",GA,2020,2658,2497,161,6.1,-74
"Treutlen County, GA",GA,2019,2732,2586,146,5.3,18
"Treutlen County, GA",GA,2018,2714,2555,159,5.9,-48
"Treutlen County, GA",GA,2017,2762,2575,187,6.8,19
"Treutlen County, GA",GA,2016,2743,2529,214,7.8,72
"Treutlen County, GA",GA,2015,2671,2440,231,8.6,-119
"Treutlen County, GA",GA,2014,2790,2493,297,10.6,-33
"Treutlen County, GA",GA,2013,2823,2478,345,12.2,-70
"Treutlen County, GA",GA,2012,2893,2509,384,13.3,-88
"Treutlen County, GA",GA,2011,2981,2589,392,13.1,27
"Treutlen County, GA",GA,2010,2954,2593,361,12.2,0
"Trigg County, KY",KY,2021,6062,5755,307,5.1,97
"Trigg County, KY",KY,2020,5965,5562,403,6.8,-24
"Trigg County, KY",KY,2019,5989,5720,269,4.5,85
"Trigg County, KY",KY,2018,5904,5626,278,4.7,-41
"Trigg County, KY",KY,2017,5945,5613,332,5.6,126
"Trigg County, KY",KY,2016,5819,5497,322,5.5,95
"Trigg County, KY",KY,2015,5724,5401,323,5.6,6
"Trigg County, KY",KY,2014,5718,5316,402,7.0,-330
"Trigg County, KY",KY,2013,6048,5506,542,9.0,11
"Trigg County, KY",KY,2012,6037,5469,568,9.4,-167
"Trigg County, KY",KY,2011,6204,5502,702,11.3,-272
"Trigg County, KY",KY,2010,6476,5554,922,14.2,0
"Trimble County, KY",KY,2021,3834,3649,185,4.8,52
"Trimble County, KY",KY,2020,3782,3533,249,6.6,-92
"Trimble County, KY",KY,2019,3874,3713,161,4.2,8
"Trimble County, KY",KY,2018,3866,3706,160,4.1,-17
"Trimble County, KY",KY,2017,3883,3694,189,4.9,14
"Trimble County, KY",KY,2016,3869,3663,206,5.3,28
"Trimble County, KY",KY,2015,3841,3627,214,5.6,-37
"Trimble County, KY",KY,2014,3878,3597,281,7.2,-89
"Trimble County, KY",KY,2013,3967,3640,327,8.2,-23
"Trimble County, KY",KY,2012,3990,3628,362,9.1,-35
"Trimble County, KY",KY,2011,4025,3569,456,11.3,-85
"Trimble County, KY",KY,2010,4110,3576,534,13.0,0
"Trinity County, CA",CA,2021,4475,4193,282,6.3,-57
"Trinity County, CA",CA,2020,4532,4157,375,8.3,-120
"Trinity County, CA",CA,2019,4652,4393,259,5.6,-23
"Trinity County, CA",CA,2018,4675,4405,270,5.8,-129
"Trinity County, CA",CA,2017,4804,4504,300,6.2,-189
"Trinity County, CA",CA,2016,4993,4638,355,7.1,-148
"Trinity County, CA",CA,2015,5141,4739,402,7.8,-20
"Trinity County, CA",CA,2014,5161,4668,493,9.6,-14
"Trinity County, CA",CA,2013,5175,4550,625,12.1,-148
"Trinity County, CA",CA,2012,5323,4532,791,14.9,-59
"Trinity County, CA",CA,2011,5382,4469,913,17.0,-54
"Trinity County, CA",CA,2010,5436,4490,946,17.4,0
"Trinity County, TX",TX,2021,5355,4962,393,7.3,91
"Trinity County, TX",TX,2020,5264,4836,428,8.1,30
"Trinity County, TX",TX,2019,5234,4985,249,4.8,-30
"Trinity County, TX",TX,2018,5264,4991,273,5.2,-74
"Trinity County, TX",TX,2017,5338,5040,298,5.6,-147
"Trinity County, TX",TX,2016,5485,5151,334,6.1,0
"Trinity County, TX",TX,2015,5485,5159,326,5.9,-31
"Trinity County, TX",TX,2014,5516,5180,336,6.1,-43
"Trinity County, TX",TX,2013,5559,5140,419,7.5,-3
"Trinity County, TX",TX,2012,5562,5108,454,8.2,-161
"Trinity County, TX",TX,2011,5723,5157,566,9.9,-69
"Trinity County, TX",TX,2010,5792,5237,555,9.6,0
"Tripp County, SD",SD,2021,3004,2933,71,2.4,20
"Tripp County, SD",SD,2020,2984,2897,87,2.9,-67
"Tripp County, SD",SD,2019,3051,2976,75,2.5,-39
"Tripp County, SD",SD,2018,3090,3019,71,2.3,58
"Tripp County, SD",SD,2017,3032,2953,79,2.6,-46
"Tripp County, SD",SD,2016,3078,3009,69,2.2,-22
"Tripp County, SD",SD,2015,3100,3019,81,2.6,-50
"Tripp County, SD",SD,2014,3150,3052,98,3.1,32
"Tripp County, SD",SD,2013,3118,3012,106,3.4,-61
"Tripp County, SD",SD,2012,3179,3067,112,3.5,-104
"Tripp County, SD",SD,2011,3283,3163,120,3.7,-19
"Tripp County, SD",SD,2010,3302,3184,118,3.6,0
"Troup County, GA",GA,2021,37678,36030,1648,4.4,92
"Troup County, GA",GA,2020,37586,34897,2689,7.2,-473
"Troup County, GA",GA,2019,38059,36806,1253,3.3,1301
"Troup County, GA",GA,2018,36758,35381,1377,3.7,-970
"Troup County, GA",GA,2017,37728,36055,1673,4.4,893
"Troup County, GA",GA,2016,36835,34934,1901,5.2,1644
"Troup County, GA",GA,2015,35191,33016,2175,6.2,-850
"Troup County, GA",GA,2014,36041,33389,2652,7.4,-72
"Troup County, GA",GA,2013,36113,33025,3088,8.6,633
"Troup County, GA",GA,2012,35480,32046,3434,9.7,1053
"Troup County, GA",GA,2011,34427,30672,3755,10.9,1791
"Troup County, GA",GA,2010,32636,28823,3813,11.7,0
"Trousdale County, TN",TN,2021,5571,5367,204,3.7,145
"Trousdale County, TN",TN,2020,5426,5089,337,6.2,-118
"Trousdale County, TN",TN,2019,5544,5375,169,3.0,242
"Trousdale County, TN",TN,2018,5302,5131,171,3.2,547
"Trousdale County, TN",TN,2017,4755,4590,165,3.5,906
"Trousdale County, TN",TN,2016,3849,3662,187,4.9,158
"Trousdale County, TN",TN,2015,3691,3475,216,5.9,12
"Trousdale County, TN",TN,2014,3679,3418,261,7.1,17
"Trousdale County, TN",TN,2013,3662,3353,309,8.4,-17
"Trousdale County, TN",TN,2012,3679,3356,323,8.8,-74
"Trousdale County, TN",TN,2011,3753,3356,397,10.6,7
"Trousdale County, TN",TN,2010,3746,3332,414,11.1,0
"Trujillo Alto Municipio, PR",PR,2021,29106,27464,1642,5.6,
"Trujillo Alto Municipio, PR",PR,2020,N.A.,N.A.,N.A.,N.A.,
"Trujillo Alto Municipio, PR",PR,2019,26914,25604,1310,4.9,365
"Trujillo Alto Municipio, PR",PR,2018,26549,25168,1381,5.2,-74
"Trujillo Alto Municipio, PR",PR,2017,26623,25045,1578,5.9,-504
"Trujillo Alto Municipio, PR",PR,2016,27127,25174,1953,7.2,-85
"Trujillo Alto Municipio, PR",PR,2015,27212,25308,1904,7.0,83
"Trujillo Alto Municipio, PR",PR,2014,27129,25028,2101,7.7,-697
"Trujillo Alto Municipio, PR",PR,2013,27826,25725,2101,7.6,-800
"Trujillo Alto Municipio, PR",PR,2012,28626,26231,2395,8.4,-476
"Trujillo Alto Municipio, PR",PR,2011,29102,26226,2876,9.9,-1200
"Trujillo Alto Municipio, PR",PR,2010,30302,27126,3176,10.5,0
"Trumbull County, OH",OH,2021,83322,77977,5345,6.4,-1345
"Trumbull County, OH",OH,2020,84667,75860,8807,10.4,-3020
"Trumbull County, OH",OH,2019,87687,82276,5411,6.2,-378
"Trumbull County, OH",OH,2018,88065,82606,5459,6.2,-1557
"Trumbull County, OH",OH,2017,89622,83189,6433,7.2,-1176
"Trumbull County, OH",OH,2016,90798,84612,6186,6.8,-925
"Trumbull County, OH",OH,2015,91723,85743,5980,6.5,-1119
"Trumbull County, OH",OH,2014,92842,86109,6733,7.3,-1640
"Trumbull County, OH",OH,2013,94482,85671,8811,9.3,-862
"Trumbull County, OH",OH,2012,95344,86735,8609,9.0,-1811
"Trumbull County, OH",OH,2011,97155,86802,10353,10.7,-2825
"Trumbull County, OH",OH,2010,99980,86729,13251,13.3,0
"Tucker County, WV",WV,2021,3427,3243,184,5.4,121
"Tucker County, WV",WV,2020,3306,3036,270,8.2,-44
"Tucker County, WV",WV,2019,3350,3176,174,5.2,-11
"Tucker County, WV",WV,2018,3361,3179,182,5.4,-61
"Tucker County, WV",WV,2017,3422,3245,177,5.2,-65
"Tucker County, WV",WV,2016,3487,3299,188,5.4,22
"Tucker County, WV",WV,2015,3465,3258,207,6.0,73
"Tucker County, WV",WV,2014,3392,3180,212,6.3,116
"Tucker County, WV",WV,2013,3276,3055,221,6.7,84
"Tucker County, WV",WV,2012,3192,2943,249,7.8,-29
"Tucker County, WV",WV,2011,3221,2927,294,9.1,-76
"Tucker County, WV",WV,2010,3297,2933,364,11.0,0
"Tulare County, CA",CA,2021,200896,179461,21435,10.7,-1311
"Tulare County, CA",CA,2020,202207,174781,27426,13.6,-289
"Tulare County, CA",CA,2019,202496,182554,19942,9.8,-543
"Tulare County, CA",CA,2018,203039,183065,19974,9.8,-1418
"Tulare County, CA",CA,2017,204457,182958,21499,10.5,1165
"Tulare County, CA",CA,2016,203292,180503,22789,11.2,1166
"Tulare County, CA",CA,2015,202126,178491,23635,11.7,4213
"Tulare County, CA",CA,2014,197913,171630,26283,13.3,-2577
"Tulare County, CA",CA,2013,200490,171350,29140,14.5,-588
"Tulare County, CA",CA,2012,201078,168088,32990,16.4,-2300
"Tulare County, CA",CA,2011,203378,168022,35356,17.4,-120
"Tulare County, CA",CA,2010,203498,167682,35816,17.6,0
"Tulsa County, OK",OK,2021,323923,310848,13075,4.0,1492
"Tulsa County, OK",OK,2020,322431,301019,21412,6.6,-1197
"Tulsa County, OK",OK,2019,323628,313891,9737,3.0,2727
"Tulsa County, OK",OK,2018,320901,310559,10342,3.2,2485
"Tulsa County, OK",OK,2017,318416,305546,12870,4.0,516
"Tulsa County, OK",OK,2016,317900,303589,14311,4.5,260
"Tulsa County, OK",OK,2015,317640,304809,12831,4.0,6207
"Tulsa County, OK",OK,2014,311433,298511,12922,4.1,816
"Tulsa County, OK",OK,2013,310617,295245,15372,4.9,2145
"Tulsa County, OK",OK,2012,308472,293070,15402,5.0,5446
"Tulsa County, OK",OK,2011,303026,285623,17403,5.7,-3190
"Tulsa County, OK",OK,2010,306216,285527,20689,6.8,0
"Tunica County, MS",MS,2021,4275,3896,379,8.9,-157
"Tunica County, MS",MS,2020,4432,3775,657,14.8,107
"Tunica County, MS",MS,2019,4325,4051,274,6.3,-68
"Tunica County, MS",MS,2018,4393,4150,243,5.5,-51
"Tunica County, MS",MS,2017,4444,4173,271,6.1,-145
"Tunica County, MS",MS,2016,4589,4256,333,7.3,-54
"Tunica County, MS",MS,2015,4643,4207,436,9.4,-104
"Tunica County, MS",MS,2014,4747,4182,565,11.9,-46
"Tunica County, MS",MS,2013,4793,4200,593,12.4,-156
"Tunica County, MS",MS,2012,4949,4351,598,12.1,-197
"Tunica County, MS",MS,2011,5146,4418,728,14.1,115
"Tunica County, MS",MS,2010,5031,4362,669,13.3,0
"Tuolumne County, CA",CA,2021,20042,18586,1456,7.3,-111
"Tuolumne County, CA",CA,2020,20153,17998,2155,10.7,-815
"Tuolumne County, CA",CA,2019,20968,20003,965,4.6,-219
"Tuolumne County, CA",CA,2018,21187,20191,996,4.7,-181
"Tuolumne County, CA",CA,2017,21368,20208,1160,5.4,-199
"Tuolumne County, CA",CA,2016,21567,20221,1346,6.2,35
"Tuolumne County, CA",CA,2015,21532,20005,1527,7.1,-4
"Tuolumne County, CA",CA,2014,21536,19651,1885,8.8,-142
"Tuolumne County, CA",CA,2013,21678,19314,2364,10.9,-600
"Tuolumne County, CA",CA,2012,22278,19341,2937,13.2,-423
"Tuolumne County, CA",CA,2011,22701,19363,3338,14.7,44
"Tuolumne County, CA",CA,2010,22657,19124,3533,15.6,0
"Turner County, GA",GA,2021,3283,3073,210,6.4,21
"Turner County, GA",GA,2020,3262,3025,237,7.3,36
"Turner County, GA",GA,2019,3226,3100,126,3.9,43
"Turner County, GA",GA,2018,3183,3020,163,5.1,-125
"Turner County, GA",GA,2017,3308,3121,187,5.7,72
"Turner County, GA",GA,2016,3236,3024,212,6.6,79
"Turner County, GA",GA,2015,3157,2939,218,6.9,-96
"Turner County, GA",GA,2014,3253,2993,260,8.0,-78
"Turner County, GA",GA,2013,3331,3001,330,9.9,-115
"Turner County, GA",GA,2012,3446,3049,397,11.5,-143
"Turner County, GA",GA,2011,3589,3081,508,14.2,47
"Turner County, GA",GA,2010,3542,2947,595,16.8,0
"Turner County, SD",SD,2021,4643,4519,124,2.7,93
"Turner County, SD",SD,2020,4550,4380,170,3.7,-79
"Turner County, SD",SD,2019,4629,4507,122,2.6,-5
"Turner County, SD",SD,2018,4634,4517,117,2.5,-30
"Turner County, SD",SD,2017,4664,4525,139,3.0,-36
"Turner County, SD",SD,2016,4700,4568,132,2.8,35
"Turner County, SD",SD,2015,4665,4543,122,2.6,-37
"Turner County, SD",SD,2014,4702,4569,133,2.8,-52
"Turner County, SD",SD,2013,4754,4612,142,3.0,-28
"Turner County, SD",SD,2012,4782,4624,158,3.3,-84
"Turner County, SD",SD,2011,4866,4672,194,4.0,-9
"Turner County, SD",SD,2010,4875,4656,219,4.5,0
"Tuscaloosa County, AL",AL,2021,101104,97442,3662,3.6,-2672
"Tuscaloosa County, AL",AL,2020,103776,96225,7551,7.3,-2779
"Tuscaloosa County, AL",AL,2019,106555,103529,3026,2.8,2950
"Tuscaloosa County, AL",AL,2018,103605,99857,3748,3.6,2591
"Tuscaloosa County, AL",AL,2017,101014,96711,4303,4.3,2583
"Tuscaloosa County, AL",AL,2016,98431,92864,5567,5.7,-194
"Tuscaloosa County, AL",AL,2015,98625,93229,5396,5.5,1395
"Tuscaloosa County, AL",AL,2014,97230,91523,5707,5.9,1651
"Tuscaloosa County, AL",AL,2013,95579,89414,6165,6.5,161
"Tuscaloosa County, AL",AL,2012,95418,88575,6843,7.2,-71
"Tuscaloosa County, AL",AL,2011,95489,87574,7915,8.3,1461
"Tuscaloosa County, AL",AL,2010,94028,85458,8570,9.1,0
"Tuscarawas County, OH",OH,2021,44346,42291,2055,4.6,-106
"Tuscarawas County, OH",OH,2020,44452,41095,3357,7.6,-823
"Tuscarawas County, OH",OH,2019,45275,43306,1969,4.3,493
"Tuscarawas County, OH",OH,2018,44782,42747,2035,4.5,-875
"Tuscarawas County, OH",OH,2017,45657,43373,2284,5.0,457
"Tuscarawas County, OH",OH,2016,45200,42585,2615,5.8,-394
"Tuscarawas County, OH",OH,2015,45594,43118,2476,5.4,160
"Tuscarawas County, OH",OH,2014,45434,42918,2516,5.5,414
"Tuscarawas County, OH",OH,2013,45020,41749,3271,7.3,19
"Tuscarawas County, OH",OH,2012,45001,41691,3310,7.4,-280
"Tuscarawas County, OH",OH,2011,45281,41079,4202,9.3,-879
"Tuscarawas County, OH",OH,2010,46160,40939,5221,11.3,0
"Tuscola County, MI",MI,2021,22658,21236,1422,6.3,-939
"Tuscola County, MI",MI,2020,23597,21121,2476,10.5,-315
"Tuscola County, MI",MI,2019,23912,22674,1238,5.2,137
"Tuscola County, MI",MI,2018,23775,22465,1310,5.5,-159
"Tuscola County, MI",MI,2017,23934,22467,1467,6.1,-319
"Tuscola County, MI",MI,2016,24253,22711,1542,6.4,-353
"Tuscola County, MI",MI,2015,24606,22933,1673,6.8,-544
"Tuscola County, MI",MI,2014,25150,22988,2162,8.6,63
"Tuscola County, MI",MI,2013,25087,22467,2620,10.4,349
"Tuscola County, MI",MI,2012,24738,22154,2584,10.4,-316
"Tuscola County, MI",MI,2011,25054,22162,2892,11.5,-701
"Tuscola County, MI",MI,2010,25755,22061,3694,14.3,0
"Twiggs County, GA",GA,2021,2804,2661,143,5.1,18
"Twiggs County, GA",GA,2020,2786,2579,207,7.4,-77
"Twiggs County, GA",GA,2019,2863,2698,165,5.8,-67
"Twiggs County, GA",GA,2018,2930,2755,175,6.0,-68
"Twiggs County, GA",GA,2017,2998,2770,228,7.6,48
"Twiggs County, GA",GA,2016,2950,2690,260,8.8,17
"Twiggs County, GA",GA,2015,2933,2661,272,9.3,-60
"Twiggs County, GA",GA,2014,2993,2659,334,11.2,-124
"Twiggs County, GA",GA,2013,3117,2691,426,13.7,-43
"Twiggs County, GA",GA,2012,3160,2697,463,14.7,-86
"Twiggs County, GA",GA,2011,3246,2748,498,15.3,-30
"Twiggs County, GA",GA,2010,3276,2764,512,15.6,0
"Twin Falls County, ID",ID,2021,42103,40600,1503,3.6,559
"Twin Falls County, ID",ID,2020,41544,39322,2222,5.3,-88
"Twin Falls County, ID",ID,2019,41632,40449,1183,2.8,717
"Twin Falls County, ID",ID,2018,40915,39791,1124,2.7,516
"Twin Falls County, ID",ID,2017,40399,39174,1225,3.0,844
"Twin Falls County, ID",ID,2016,39555,38249,1306,3.3,495
"Twin Falls County, ID",ID,2015,39060,37719,1341,3.4,680
"Twin Falls County, ID",ID,2014,38380,36895,1485,3.9,20
"Twin Falls County, ID",ID,2013,38360,35908,2452,6.4,554
"Twin Falls County, ID",ID,2012,37806,35126,2680,7.1,724
"Twin Falls County, ID",ID,2011,37082,34201,2881,7.8,189
"Twin Falls County, ID",ID,2010,36893,33836,3057,8.3,0
"Tyler County, TX",TX,2021,7409,6779,630,8.5,113
"Tyler County, TX",TX,2020,7296,6575,721,9.9,225
"Tyler County, TX",TX,2019,7071,6666,405,5.7,155
"Tyler County, TX",TX,2018,6916,6455,461,6.7,-106
"Tyler County, TX",TX,2017,7022,6502,520,7.4,-195
"Tyler County, TX",TX,2016,7217,6689,528,7.3,-154
"Tyler County, TX",TX,2015,7371,6851,520,7.1,-197
"Tyler County, TX",TX,2014,7568,6956,612,8.1,-21
"Tyler County, TX",TX,2013,7589,6804,785,10.3,29
"Tyler County, TX",TX,2012,7560,6757,803,10.6,-290
"Tyler County, TX",TX,2011,7850,6876,974,12.4,-64
"Tyler County, TX",TX,2010,7914,6980,934,11.8,0
"Tyler County, WV",WV,2021,2980,2742,238,8.0,-32
"Tyler County, WV",WV,2020,3012,2697,315,10.5,-151
"Tyler County, WV",WV,2019,3163,2919,244,7.7,32
"Tyler County, WV",WV,2018,3131,2906,225,7.2,-104
"Tyler County, WV",WV,2017,3235,2986,249,7.7,-324
"Tyler County, WV",WV,2016,3559,3242,317,8.9,-138
"Tyler County, WV",WV,2015,3697,3359,338,9.1,62
"Tyler County, WV",WV,2014,3635,3311,324,8.9,1
"Tyler County, WV",WV,2013,3634,3321,313,8.6,-23
"Tyler County, WV",WV,2012,3657,3334,323,8.8,60
"Tyler County, WV",WV,2011,3597,3228,369,10.3,50
"Tyler County, WV",WV,2010,3547,3141,406,11.4,0
"Tyrrell County, NC",NC,2021,1283,1193,90,7.0,49
"Tyrrell County, NC",NC,2020,1234,1122,112,9.1,-177
"Tyrrell County, NC",NC,2019,1411,1328,83,5.9,-45
"Tyrrell County, NC",NC,2018,1456,1364,92,6.3,-18
"Tyrrell County, NC",NC,2017,1474,1361,113,7.7,-51
"Tyrrell County, NC",NC,2016,1525,1396,129,8.5,-20
"Tyrrell County, NC",NC,2015,1545,1400,145,9.4,-7
"Tyrrell County, NC",NC,2014,1552,1402,150,9.7,-11
"Tyrrell County, NC",NC,2013,1563,1366,197,12.6,-36
"Tyrrell County, NC",NC,2012,1599,1376,223,13.9,-43
"Tyrrell County, NC",NC,2011,1642,1397,245,14.9,-23
"Tyrrell County, NC",NC,2010,1665,1421,244,14.7,0
"Uinta County, WY",WY,2021,8832,8389,443,5.0,-270
"Uinta County, WY",WY,2020,9102,8532,570,6.3,-117
"Uinta County, WY",WY,2019,9219,8852,367,4.0,149
"Uinta County, WY",WY,2018,9070,8676,394,4.3,-62
"Uinta County, WY",WY,2017,9132,8703,429,4.7,-294
"Uinta County, WY",WY,2016,9426,8876,550,5.8,-167
"Uinta County, WY",WY,2015,9593,9120,473,4.9,-181
"Uinta County, WY",WY,2014,9774,9281,493,5.0,-43
"Uinta County, WY",WY,2013,9817,9295,522,5.3,-329
"Uinta County, WY",WY,2012,10146,9562,584,5.8,105
"Uinta County, WY",WY,2011,10041,9380,661,6.6,-471
"Uinta County, WY",WY,2010,10512,9718,794,7.6,0
"Uintah County, UT",UT,2021,13562,12806,756,5.6,100
"Uintah County, UT",UT,2020,13462,12212,1250,9.3,-279
"Uintah County, UT",UT,2019,13741,13167,574,4.2,47
"Uintah County, UT",UT,2018,13694,13089,605,4.4,-37
"Uintah County, UT",UT,2017,13731,12927,804,5.9,-326
"Uintah County, UT",UT,2016,14057,12782,1275,9.1,-1160
"Uintah County, UT",UT,2015,15217,14201,1016,6.7,-644
"Uintah County, UT",UT,2014,15861,15321,540,3.4,408
"Uintah County, UT",UT,2013,15453,14836,617,4.0,-262
"Uintah County, UT",UT,2012,15715,15099,616,3.9,306
"Uintah County, UT",UT,2011,15409,14439,970,6.3,290
"Uintah County, UT",UT,2010,15119,13819,1300,8.6,0
"Ulster County, NY",NY,2021,86356,82332,4024,4.7,-1065
"Ulster County, NY",NY,2020,87421,80700,6721,7.7,-2412
"Ulster County, NY",NY,2019,89833,86588,3245,3.6,-328
"Ulster County, NY",NY,2018,90161,86660,3501,3.9,482
"Ulster County, NY",NY,2017,89679,85621,4058,4.5,1490
"Ulster County, NY",NY,2016,88189,84222,3967,4.5,-4
"Ulster County, NY",NY,2015,88193,83923,4270,4.8,310
"Ulster County, NY",NY,2014,87883,82831,5052,5.7,-2366
"Ulster County, NY",NY,2013,90249,83635,6614,7.3,-665
"Ulster County, NY",NY,2012,90914,83282,7632,8.4,-503
"Ulster County, NY",NY,2011,91417,84188,7229,7.9,-2262
"Ulster County, NY",NY,2010,93679,86236,7443,7.9,0
"Umatilla County, OR",OR,2021,37687,35718,1969,5.2,701
"Umatilla County, OR",OR,2020,36986,34480,2506,6.8,394
"Umatilla County, OR",OR,2019,36592,34857,1735,4.7,352
"Umatilla County, OR",OR,2018,36240,34509,1731,4.8,-224
"Umatilla County, OR",OR,2017,36464,34736,1728,4.7,543
"Umatilla County, OR",OR,2016,35921,34040,1881,5.2,661
"Umatilla County, OR",OR,2015,35260,33075,2185,6.2,-228
"Umatilla County, OR",OR,2014,35488,32788,2700,7.6,20
"Umatilla County, OR",OR,2013,35468,32378,3090,8.7,-1421
"Umatilla County, OR",OR,2012,36889,33549,3340,9.1,-533
"Umatilla County, OR",OR,2011,37422,33817,3605,9.6,594
"Umatilla County, OR",OR,2010,36828,33008,3820,10.4,0
"Unicoi County, TN",TN,2021,7062,6715,347,4.9,42
"Unicoi County, TN",TN,2020,7020,6468,552,7.9,-174
"Unicoi County, TN",TN,2019,7194,6836,358,5.0,143
"Unicoi County, TN",TN,2018,7051,6705,346,4.9,-7
"Unicoi County, TN",TN,2017,7058,6679,379,5.4,41
"Unicoi County, TN",TN,2016,7017,6517,500,7.1,-28
"Unicoi County, TN",TN,2015,7045,6488,557,7.9,-95
"Unicoi County, TN",TN,2014,7140,6485,655,9.2,-292
"Unicoi County, TN",TN,2013,7432,6652,780,10.5,-271
"Unicoi County, TN",TN,2012,7703,6896,807,10.5,-184
"Unicoi County, TN",TN,2011,7887,7003,884,11.2,-42
"Unicoi County, TN",TN,2010,7929,6966,963,12.1,0
"Union County, AR",AR,2021,15025,14114,911,6.1,-590
"Union County, AR",AR,2020,15615,14310,1305,8.4,-181
"Union County, AR",AR,2019,15796,14989,807,5.1,-167
"Union County, AR",AR,2018,15963,15097,866,5.4,-130
"Union County, AR",AR,2017,16093,15239,854,5.3,-308
"Union County, AR",AR,2016,16401,15504,897,5.5,-598
"Union County, AR",AR,2015,16999,15973,1026,6.0,245
"Union County, AR",AR,2014,16754,15545,1209,7.2,14
"Union County, AR",AR,2013,16740,15338,1402,8.4,-139
"Union County, AR",AR,2012,16879,15383,1496,8.9,-73
"Union County, AR",AR,2011,16952,15234,1718,10.1,-261
"Union County, AR",AR,2010,17213,15321,1892,11.0,0
"Union County, FL",FL,2021,4546,4376,170,3.7,14
"Union County, FL",FL,2020,4532,4299,233,5.1,-37
"Union County, FL",FL,2019,4569,4429,140,3.1,-9
"Union County, FL",FL,2018,4578,4425,153,3.3,-197
"Union County, FL",FL,2017,4775,4593,182,3.8,-36
"Union County, FL",FL,2016,4811,4601,210,4.4,58
"Union County, FL",FL,2015,4753,4520,233,4.9,26
"Union County, FL",FL,2014,4727,4436,291,6.2,-241
"Union County, FL",FL,2013,4968,4641,327,6.6,-84
"Union County, FL",FL,2012,5052,4676,376,7.4,-96
"Union County, FL",FL,2011,5148,4727,421,8.2,-288
"Union County, FL",FL,2010,5436,4989,447,8.2,0
"Union County, GA",GA,2021,11094,10794,300,2.7,548
"Union County, GA",GA,2020,10546,10087,459,4.4,30
"Union County, GA",GA,2019,10516,10174,342,3.3,164
"Union County, GA",GA,2018,10352,9968,384,3.7,100
"Union County, GA",GA,2017,10252,9786,466,4.5,-199
"Union County, GA",GA,2016,10451,9949,502,4.8,732
"Union County, GA",GA,2015,9719,9190,529,5.4,218
"Union County, GA",GA,2014,9501,8872,629,6.6,184
"Union County, GA",GA,2013,9317,8587,730,7.8,-313
"Union County, GA",GA,2012,9630,8790,840,8.7,163
"Union County, GA",GA,2011,9467,8508,959,10.1,-67
"Union County, GA",GA,2010,9534,8466,1068,11.2,0
"Union County, IA",IA,2021,6088,5817,271,4.5,-116
"Union County, IA",IA,2020,6204,5850,354,5.7,-209
"Union County, IA",IA,2019,6413,6217,196,3.1,-49
"Union County, IA",IA,2018,6462,6233,229,3.5,-29
"Union County, IA",IA,2017,6491,6292,199,3.1,-58
"Union County, IA",IA,2016,6549,6302,247,3.8,-27
"Union County, IA",IA,2015,6576,6304,272,4.1,-239
"Union County, IA",IA,2014,6815,6495,320,4.7,-90
"Union County, IA",IA,2013,6905,6568,337,4.9,25
"Union County, IA",IA,2012,6880,6531,349,5.1,-108
"Union County, IA",IA,2011,6988,6614,374,5.4,-13
"Union County, IA",IA,2010,7001,6599,402,5.7,0
"Union County, IL",IL,2021,7169,6763,406,5.7,-6
"Union County, IL",IL,2020,7175,6585,590,8.2,-290
"Union County, IL",IL,2019,7465,7062,403,5.4,-1
"Union County, IL",IL,2018,7466,6990,476,6.4,95
"Union County, IL",IL,2017,7371,6896,475,6.4,-184
"Union County, IL",IL,2016,7555,6995,560,7.4,188
"Union County, IL",IL,2015,7367,6800,567,7.7,72
"Union County, IL",IL,2014,7295,6647,648,8.9,-111
"Union County, IL",IL,2013,7406,6578,828,11.2,-144
"Union County, IL",IL,2012,7550,6720,830,11.0,-206
"Union County, IL",IL,2011,7756,6851,905,11.7,-202
"Union County, IL",IL,2010,7958,6998,960,12.1,0
"Union County, IN",IN,2021,3471,3389,82,2.4,3
"Union County, IN",IN,2020,3468,3274,194,5.6,-127
"Union County, IN",IN,2019,3595,3480,115,3.2,27
"Union County, IN",IN,2018,3568,3457,111,3.1,-43
"Union County, IN",IN,2017,3611,3500,111,3.1,-30
"Union County, IN",IN,2016,3641,3496,145,4.0,81
"Union County, IN",IN,2015,3560,3402,158,4.4,15
"Union County, IN",IN,2014,3545,3346,199,5.6,20
"Union County, IN",IN,2013,3525,3276,249,7.1,-34
"Union County, IN",IN,2012,3559,3277,282,7.9,-115
"Union County, IN",IN,2011,3674,3358,316,8.6,-56
"Union County, IN",IN,2010,3730,3357,373,10.0,0
"Union County, KY",KY,2021,6021,5759,262,4.4,97
"Union County, KY",KY,2020,5924,5558,366,6.2,-166
"Union County, KY",KY,2019,6090,5830,260,4.3,84
"Union County, KY",KY,2018,6006,5716,290,4.8,-99
"Union County, KY",KY,2017,6105,5745,360,5.9,-58
"Union County, KY",KY,2016,6163,5749,414,6.7,37
"Union County, KY",KY,2015,6126,5716,410,6.7,-635
"Union County, KY",KY,2014,6761,6329,432,6.4,-97
"Union County, KY",KY,2013,6858,6334,524,7.6,-168
"Union County, KY",KY,2012,7026,6475,551,7.8,-591
"Union County, KY",KY,2011,7617,6933,684,9.0,-111
"Union County, KY",KY,2010,7728,6971,757,9.8,0
"Union County, MS",MS,2021,14078,13505,573,4.1,146
"Union County, MS",MS,2020,13932,12960,972,7.0,-433
"Union County, MS",MS,2019,14365,13763,602,4.2,358
"Union County, MS",MS,2018,14007,13498,509,3.6,60
"Union County, MS",MS,2017,13947,13430,517,3.7,354
"Union County, MS",MS,2016,13593,12979,614,4.5,425
"Union County, MS",MS,2015,13168,12488,680,5.2,362
"Union County, MS",MS,2014,12806,12010,796,6.2,-278
"Union County, MS",MS,2013,13084,12160,924,7.1,-609
"Union County, MS",MS,2012,13693,12616,1077,7.9,368
"Union County, MS",MS,2011,13325,12039,1286,9.7,1166
"Union County, MS",MS,2010,12159,10870,1289,10.6,0
"Union County, NC",NC,2021,122890,118088,4802,3.9,3507
"Union County, NC",NC,2020,119383,112507,6876,5.8,-3572
"Union County, NC",NC,2019,122955,118712,4243,3.5,3065
"Union County, NC",NC,2018,119890,115634,4256,3.5,2467
"Union County, NC",NC,2017,117423,112714,4709,4.0,2012
"Union County, NC",NC,2016,115411,110320,5091,4.4,3189
"Union County, NC",NC,2015,112222,106848,5374,4.8,3380
"Union County, NC",NC,2014,108842,103296,5546,5.1,2915
"Union County, NC",NC,2013,105927,99180,6747,6.4,846
"Union County, NC",NC,2012,105081,96627,8454,8.0,2134
"Union County, NC",NC,2011,102947,93573,9374,9.1,1416
"Union County, NC",NC,2010,101531,91462,10069,9.9,0
"Union County, NJ",NJ,2021,285486,266463,19023,6.7,248
"Union County, NJ",NJ,2020,285238,257873,27365,9.6,-3229
"Union County, NJ",NJ,2019,288467,278358,10109,3.5,4100
"Union County, NJ",NJ,2018,284367,272640,11727,4.1,-737
"Union County, NJ",NJ,2017,285104,271857,13247,4.6,8485
"Union County, NJ",NJ,2016,276619,262443,14176,5.1,-1302
"Union County, NJ",NJ,2015,277921,261341,16580,6.0,-359
"Union County, NJ",NJ,2014,278280,258991,19289,6.9,-2177
"Union County, NJ",NJ,2013,280457,256494,23963,8.5,-2162
"Union County, NJ",NJ,2012,282619,255811,26808,9.5,2086
"Union County, NJ",NJ,2011,280533,253809,26724,9.5,926
"Union County, NJ",NJ,2010,279607,252569,27038,9.7,0
"Union County, NM",NM,2021,1572,1506,66,4.2,-56
"Union County, NM",NM,2020,1628,1547,81,5.0,-246
"Union County, NM",NM,2019,1874,1809,65,3.5,74
"Union County, NM",NM,2018,1800,1741,59,3.3,-133
"Union County, NM",NM,2017,1933,1861,72,3.7,24
"Union County, NM",NM,2016,1909,1831,78,4.1,4
"Union County, NM",NM,2015,1905,1821,84,4.4,-9
"Union County, NM",NM,2014,1914,1827,87,4.5,38
"Union County, NM",NM,2013,1876,1790,86,4.6,1
"Union County, NM",NM,2012,1875,1795,80,4.3,-58
"Union County, NM",NM,2011,1933,1846,87,4.5,18
"Union County, NM",NM,2010,1915,1801,114,6.0,0
"Union County, OH",OH,2021,29989,28936,1053,3.5,476
"Union County, OH",OH,2020,29513,27803,1710,5.8,-129
"Union County, OH",OH,2019,29642,28680,962,3.2,868
"Union County, OH",OH,2018,28774,27777,997,3.5,228
"Union County, OH",OH,2017,28546,27482,1064,3.7,643
"Union County, OH",OH,2016,27903,26830,1073,3.8,792
"Union County, OH",OH,2015,27111,26059,1052,3.9,237
"Union County, OH",OH,2014,26874,25677,1197,4.5,263
"Union County, OH",OH,2013,26611,25064,1547,5.8,265
"Union County, OH",OH,2012,26346,24831,1515,5.8,-307
"Union County, OH",OH,2011,26653,24741,1912,7.2,-53
"Union County, OH",OH,2010,26706,24451,2255,8.4,0
"Union County, OR",OR,2021,12222,11542,680,5.6,208
"Union County, OR",OR,2020,12014,11072,942,7.8,62
"Union County, OR",OR,2019,11952,11384,568,4.8,97
"Union County, OR",OR,2018,11855,11238,617,5.2,-39
"Union County, OR",OR,2017,11894,11278,616,5.2,-50
"Union County, OR",OR,2016,11944,11252,692,5.8,236
"Union County, OR",OR,2015,11708,11005,703,6.0,49
"Union County, OR",OR,2014,11659,10829,830,7.1,-160
"Union County, OR",OR,2013,11819,10835,984,8.3,-462
"Union County, OR",OR,2012,12281,11125,1156,9.4,-190
"Union County, OR",OR,2011,12471,11215,1256,10.1,-63
"Union County, OR",OR,2010,12534,11228,1306,10.4,0
"Union County, PA",PA,2021,19470,18560,910,4.7,-82
"Union County, PA",PA,2020,19552,18234,1318,6.7,-581
"Union County, PA",PA,2019,20133,19306,827,4.1,316
"Union County, PA",PA,2018,19817,19044,773,3.9,-37
"Union County, PA",PA,2017,19854,18974,880,4.4,43
"Union County, PA",PA,2016,19811,18874,937,4.7,499
"Union County, PA",PA,2015,19312,18432,880,4.6,206
"Union County, PA",PA,2014,19106,18143,963,5.0,16
"Union County, PA",PA,2013,19090,17919,1171,6.1,-6
"Union County, PA",PA,2012,19096,17895,1201,6.3,70
"Union County, PA",PA,2011,19026,17768,1258,6.6,-112
"Union County, PA",PA,2010,19138,17704,1434,7.5,0
"Union County, SC",SC,2021,11454,10712,742,6.5,23
"Union County, SC",SC,2020,11431,10413,1018,8.9,149
"Union County, SC",SC,2019,11282,10897,385,3.4,135
"Union County, SC",SC,2018,11147,10688,459,4.1,-133
"Union County, SC",SC,2017,11280,10681,599,5.3,-151
"Union County, SC",SC,2016,11431,10736,695,6.1,-116
"Union County, SC",SC,2015,11547,10644,903,7.8,52
"Union County, SC",SC,2014,11495,10531,964,8.4,-263
"Union County, SC",SC,2013,11758,10462,1296,11.0,-210
"Union County, SC",SC,2012,11968,10370,1598,13.4,-309
"Union County, SC",SC,2011,12277,10333,1944,15.8,-237
"Union County, SC",SC,2010,12514,10273,2241,17.9,0
"Union County, SD",SD,2021,8619,8311,308,3.6,22
"Union County, SD",SD,2020,8597,8191,406,4.7,22
"Union County, SD",SD,2019,8575,8327,248,2.9,209
"Union County, SD",SD,2018,8366,8123,243,2.9,339
"Union County, SD",SD,2017,8027,7758,269,3.4,-63
"Union County, SD",SD,2016,8090,7836,254,3.1,10
"Union County, SD",SD,2015,8080,7811,269,3.3,10
"Union County, SD",SD,2014,8070,7779,291,3.6,132
"Union County, SD",SD,2013,7938,7614,324,4.1,55
"Union County, SD",SD,2012,7883,7528,355,4.5,155
"Union County, SD",SD,2011,7728,7338,390,5.0,-54
"Union County, SD",SD,2010,7782,7338,444,5.7,0
"Union County, TN",TN,2021,7751,7441,310,4.0,123
"Union County, TN",TN,2020,7628,7110,518,6.8,-98
"Union County, TN",TN,2019,7726,7413,313,4.1,194
"Union County, TN",TN,2018,7532,7226,306,4.1,147
"Union County, TN",TN,2017,7385,7061,324,4.4,100
"Union County, TN",TN,2016,7285,6862,423,5.8,51
"Union County, TN",TN,2015,7234,6746,488,6.7,-9
"Union County, TN",TN,2014,7243,6669,574,7.9,-196
"Union County, TN",TN,2013,7439,6725,714,9.6,-179
"Union County, TN",TN,2012,7618,6887,731,9.6,-210
"Union County, TN",TN,2011,7828,7020,808,10.3,58
"Union County, TN",TN,2010,7770,6920,850,10.9,0
"Union Parish, LA",LA,2021,8993,8557,436,4.8,5
"Union Parish, LA",LA,2020,8988,8300,688,7.7,-141
"Union Parish, LA",LA,2019,9129,8616,513,5.6,-100
"Union Parish, LA",LA,2018,9229,8716,513,5.6,14
"Union Parish, LA",LA,2017,9215,8703,512,5.6,-39
"Union Parish, LA",LA,2016,9254,8647,607,6.6,-63
"Union Parish, LA",LA,2015,9317,8655,662,7.1,-14
"Union Parish, LA",LA,2014,9331,8643,688,7.4,169
"Union Parish, LA",LA,2013,9162,8477,685,7.5,-97
"Union Parish, LA",LA,2012,9259,8525,734,7.9,-117
"Union Parish, LA",LA,2011,9376,8530,846,9.0,-278
"Union Parish, LA",LA,2010,9654,8702,952,9.9,0
"Upshur County, TX",TX,2021,17555,16456,1099,6.3,176
"Upshur County, TX",TX,2020,17379,16041,1338,7.7,-408
"Upshur County, TX",TX,2019,17787,17128,659,3.7,282
"Upshur County, TX",TX,2018,17505,16765,740,4.2,-84
"Upshur County, TX",TX,2017,17589,16659,930,5.3,-314
"Upshur County, TX",TX,2016,17903,16754,1149,6.4,-80
"Upshur County, TX",TX,2015,17983,17032,951,5.3,-568
"Upshur County, TX",TX,2014,18551,17585,966,5.2,49
"Upshur County, TX",TX,2013,18502,17309,1193,6.4,-179
"Upshur County, TX",TX,2012,18681,17430,1251,6.7,74
"Upshur County, TX",TX,2011,18607,17079,1528,8.2,298
"Upshur County, TX",TX,2010,18309,16691,1618,8.8,0
"Upshur County, WV",WV,2021,9681,9080,601,6.2,117
"Upshur County, WV",WV,2020,9564,8671,893,9.3,-90
"Upshur County, WV",WV,2019,9654,9078,576,6.0,164
"Upshur County, WV",WV,2018,9490,8955,535,5.6,23
"Upshur County, WV",WV,2017,9467,8884,583,6.2,-370
"Upshur County, WV",WV,2016,9837,9095,742,7.5,66
"Upshur County, WV",WV,2015,9771,9005,766,7.8,136
"Upshur County, WV",WV,2014,9635,8997,638,6.6,14
"Upshur County, WV",WV,2013,9621,8944,677,7.0,-366
"Upshur County, WV",WV,2012,9987,9233,754,7.5,-247
"Upshur County, WV",WV,2011,10234,9368,866,8.5,-122
"Upshur County, WV",WV,2010,10356,9396,960,9.3,0
"Upson County, GA",GA,2021,11628,11162,466,4.0,261
"Upson County, GA",GA,2020,11367,10625,742,6.5,-63
"Upson County, GA",GA,2019,11430,11008,422,3.7,32
"Upson County, GA",GA,2018,11398,10891,507,4.4,11
"Upson County, GA",GA,2017,11387,10759,628,5.5,244
"Upson County, GA",GA,2016,11143,10415,728,6.5,137
"Upson County, GA",GA,2015,11006,10195,811,7.4,-284
"Upson County, GA",GA,2014,11290,10281,1009,8.9,-617
"Upson County, GA",GA,2013,11907,10745,1162,9.8,-42
"Upson County, GA",GA,2012,11949,10692,1257,10.5,-37
"Upson County, GA",GA,2011,11986,10610,1376,11.5,19
"Upson County, GA",GA,2010,11967,10484,1483,12.4,0
"Upton County, TX",TX,2021,1762,1670,92,5.2,-37
"Upton County, TX",TX,2020,1799,1696,103,5.7,163
"Upton County, TX",TX,2019,1636,1587,49,3.0,71
"Upton County, TX",TX,2018,1565,1511,54,3.5,29
"Upton County, TX",TX,2017,1536,1478,58,3.8,-46
"Upton County, TX",TX,2016,1582,1498,84,5.3,-202
"Upton County, TX",TX,2015,1784,1714,70,3.9,-88
"Upton County, TX",TX,2014,1872,1811,61,3.3,165
"Upton County, TX",TX,2013,1707,1636,71,4.2,119
"Upton County, TX",TX,2012,1588,1524,64,4.0,19
"Upton County, TX",TX,2011,1569,1483,86,5.5,14
"Upton County, TX",TX,2010,1555,1459,96,6.2,0
"Utah County, UT",UT,2021,332018,324289,7729,2.3,15376
"Utah County, UT",UT,2020,316642,304605,12037,3.8,6776
"Utah County, UT",UT,2019,309866,302523,7343,2.4,8183
"Utah County, UT",UT,2018,301683,293624,8059,2.7,9624
"Utah County, UT",UT,2017,292059,283780,8279,2.8,14100
"Utah County, UT",UT,2016,277959,269619,8340,3.0,13246
"Utah County, UT",UT,2015,264713,256260,8453,3.2,11622
"Utah County, UT",UT,2014,253091,244673,8418,3.3,7761
"Utah County, UT",UT,2013,245330,235773,9557,3.9,10690
"Utah County, UT",UT,2012,234640,224333,10307,4.4,5028
"Utah County, UT",UT,2011,229612,214480,15132,6.6,805
"Utah County, UT",UT,2010,228807,211554,17253,7.5,0
"Utuado Municipio, PR",PR,2021,7016,6364,652,9.3,
"Utuado Municipio, PR",PR,2020,N.A.,N.A.,N.A.,N.A.,
"Utuado Municipio, PR",PR,2019,6655,5904,751,11.3,30
"Utuado Municipio, PR",PR,2018,6625,5858,767,11.6,-131
"Utuado Municipio, PR",PR,2017,6756,5813,943,14.0,-129
"Utuado Municipio, PR",PR,2016,6885,5817,1068,15.5,-40
"Utuado Municipio, PR",PR,2015,6925,5817,1108,16.0,-122
"Utuado Municipio, PR",PR,2014,7047,5740,1307,18.5,-277
"Utuado Municipio, PR",PR,2013,7324,5885,1439,19.6,-227
"Utuado Municipio, PR",PR,2012,7551,6088,1463,19.4,-169
"Utuado Municipio, PR",PR,2011,7720,6159,1561,20.2,-393
"Utuado Municipio, PR",PR,2010,8113,6422,1691,20.8,0
"Uvalde County, TX",TX,2021,11252,10631,621,5.5,44
"Uvalde County, TX",TX,2020,11208,10488,720,6.4,-139
"Uvalde County, TX",TX,2019,11347,10918,429,3.8,-11
"Uvalde County, TX",TX,2018,11358,10869,489,4.3,-259
"Uvalde County, TX",TX,2017,11617,11069,548,4.7,-196
"Uvalde County, TX",TX,2016,11813,11184,629,5.3,126
"Uvalde County, TX",TX,2015,11687,11093,594,5.1,16
"Uvalde County, TX",TX,2014,11671,10997,674,5.8,-256
"Uvalde County, TX",TX,2013,11927,11086,841,7.1,3
"Uvalde County, TX",TX,2012,11924,10982,942,7.9,-220
"Uvalde County, TX",TX,2011,12144,11031,1113,9.2,300
"Uvalde County, TX",TX,2010,11844,10779,1065,9.0,0
"Val Verde County, TX",TX,2021,22098,20785,1313,5.9,742
"Val Verde County, TX",TX,2020,21356,19576,1780,8.3,-1256
"Val Verde County, TX",TX,2019,22612,21857,755,3.3,405
"Val Verde County, TX",TX,2018,22207,21340,867,3.9,2264
"Val Verde County, TX",TX,2017,19943,18921,1022,5.1,-204
"Val Verde County, TX",TX,2016,20147,18887,1260,6.3,566
"Val Verde County, TX",TX,2015,19581,18398,1183,6.0,223
"Val Verde County, TX",TX,2014,19358,18231,1127,5.8,-236
"Val Verde County, TX",TX,2013,19594,18134,1460,7.5,-371
"Val Verde County, TX",TX,2012,19965,18452,1513,7.6,-501
"Val Verde County, TX",TX,2011,20466,18566,1900,9.3,-184
"Val Verde County, TX",TX,2010,20650,18722,1928,9.3,0
"Valdez-Cordova Census Area, AK",AK,2019,4865,4535,330,6.8,3
"Valdez-Cordova Census Area, AK",AK,2018,4862,4536,326,6.7,-8
"Valdez-Cordova Census Area, AK",AK,2017,4870,4518,352,7.2,68
"Valdez-Cordova Census Area, AK",AK,2016,4802,4406,396,8.2,-62
"Valdez-Cordova Census Area, AK",AK,2015,4864,4456,408,8.4,-1
"Valdez-Cordova Census Area, AK",AK,2014,4865,4404,461,9.5,-45
"Valdez-Cordova Census Area, AK",AK,2013,4910,4421,489,10.0,33
"Valdez-Cordova Census Area, AK",AK,2012,4877,4397,480,9.8,-44
"Valdez-Cordova Census Area, AK",AK,2011,4921,4423,498,10.1,45
"Valdez-Cordova Census Area, AK",AK,2010,4876,4403,473,9.7,0
"Valencia County, NM",NM,2021,30901,28782,2119,6.9,685
"Valencia County, NM",NM,2020,30216,27838,2378,7.9,-843
"Valencia County, NM",NM,2019,31059,29386,1673,5.4,438
"Valencia County, NM",NM,2018,30621,28970,1651,5.4,136
"Valencia County, NM",NM,2017,30485,28486,1999,6.6,329
"Valencia County, NM",NM,2016,30156,27958,2198,7.3,296
"Valencia County, NM",NM,2015,29860,27613,2247,7.5,139
"Valencia County, NM",NM,2014,29721,27417,2304,7.8,-325
"Valencia County, NM",NM,2013,30046,27560,2486,8.3,-181
"Valencia County, NM",NM,2012,30227,27669,2558,8.5,-245
"Valencia County, NM",NM,2011,30472,27840,2632,8.6,-438
"Valencia County, NM",NM,2010,30910,28071,2839,9.2,0
"Valley County, ID",ID,2021,5784,5480,304,5.3,93
"Valley County, ID",ID,2020,5691,5231,460,8.1,90
"Valley County, ID",ID,2019,5601,5379,222,4.0,221
"Valley County, ID",ID,2018,5380,5175,205,3.8,206
"Valley County, ID",ID,2017,5174,4946,228,4.4,215
"Valley County, ID",ID,2016,4959,4701,258,5.2,172
"Valley County, ID",ID,2015,4787,4514,273,5.7,257
"Valley County, ID",ID,2014,4530,4216,314,6.9,-73
"Valley County, ID",ID,2013,4603,4084,519,11.3,-91
"Valley County, ID",ID,2012,4694,4156,538,11.5,50
"Valley County, ID",ID,2011,4644,3999,645,13.9,-52
"Valley County, ID",ID,2010,4696,3970,726,15.5,0
"Valley County, MT",MT,2021,4044,3918,126,3.1,-40
"Valley County, MT",MT,2020,4084,3911,173,4.2,-71
"Valley County, MT",MT,2019,4155,4021,134,3.2,-1
"Valley County, MT",MT,2018,4156,4029,127,3.1,-29
"Valley County, MT",MT,2017,4185,4046,139,3.3,-215
"Valley County, MT",MT,2016,4400,4246,154,3.5,8
"Valley County, MT",MT,2015,4392,4250,142,3.2,28
"Valley County, MT",MT,2014,4364,4232,132,3.0,116
"Valley County, MT",MT,2013,4248,4089,159,3.7,223
"Valley County, MT",MT,2012,4025,3864,161,4.0,85
"Valley County, MT",MT,2011,3940,3763,177,4.5,26
"Valley County, MT",MT,2010,3914,3726,188,4.8,0
"Valley County, NE",NE,2021,2119,2075,44,2.1,-23
"Valley County, NE",NE,2020,2142,2082,60,2.8,-12
"Valley County, NE",NE,2019,2154,2085,69,3.2,52
"Valley County, NE",NE,2018,2102,2040,62,2.9,-28
"Valley County, NE",NE,2017,2130,2073,57,2.7,26
"Valley County, NE",NE,2016,2104,2045,59,2.8,33
"Valley County, NE",NE,2015,2071,2013,58,2.8,-48
"Valley County, NE",NE,2014,2119,2056,63,3.0,-17
"Valley County, NE",NE,2013,2136,2067,69,3.2,-12
"Valley County, NE",NE,2012,2148,2075,73,3.4,-1
"Valley County, NE",NE,2011,2149,2063,86,4.0,10
"Valley County, NE",NE,2010,2139,2043,96,4.5,0
"Van Buren County, AR",AR,2021,5803,5521,282,4.9,36
"Van Buren County, AR",AR,2020,5767,5354,413,7.2,-14
"Van Buren County, AR",AR,2019,5781,5500,281,4.9,-102
"Van Buren County, AR",AR,2018,5883,5577,306,5.2,-157
"Van Buren County, AR",AR,2017,6040,5708,332,5.5,-73
"Van Buren County, AR",AR,2016,6113,5692,421,6.9,-340
"Van Buren County, AR",AR,2015,6453,6026,427,6.6,-50
"Van Buren County, AR",AR,2014,6503,5988,515,7.9,-27
"Van Buren County, AR",AR,2013,6530,5910,620,9.5,-99
"Van Buren County, AR",AR,2012,6629,5980,649,9.8,-106
"Van Buren County, AR",AR,2011,6735,6021,714,10.6,266
"Van Buren County, AR",AR,2010,6469,5768,701,10.8,0
"Van Buren County, IA",IA,2021,3626,3489,137,3.8,-68
"Van Buren County, IA",IA,2020,3694,3529,165,4.5,-46
"Van Buren County, IA",IA,2019,3740,3644,96,2.6,-26
"Van Buren County, IA",IA,2018,3766,3666,100,2.7,9
"Van Buren County, IA",IA,2017,3757,3644,113,3.0,-123
"Van Buren County, IA",IA,2016,3880,3739,141,3.6,39
"Van Buren County, IA",IA,2015,3841,3687,154,4.0,-74
"Van Buren County, IA",IA,2014,3915,3738,177,4.5,77
"Van Buren County, IA",IA,2013,3838,3627,211,5.5,24
"Van Buren County, IA",IA,2012,3814,3593,221,5.8,-53
"Van Buren County, IA",IA,2011,3867,3618,249,6.4,-97
"Van Buren County, IA",IA,2010,3964,3669,295,7.4,0
"Van Buren County, MI",MI,2021,33843,31794,2049,6.1,-832
"Van Buren County, MI",MI,2020,34675,31642,3033,8.7,-678
"Van Buren County, MI",MI,2019,35353,33716,1637,4.6,217
"Van Buren County, MI",MI,2018,35136,33401,1735,4.9,-162
"Van Buren County, MI",MI,2017,35298,33319,1979,5.6,-268
"Van Buren County, MI",MI,2016,35566,33502,2064,5.8,157
"Van Buren County, MI",MI,2015,35409,33157,2252,6.4,-27
"Van Buren County, MI",MI,2014,35436,32578,2858,8.1,322
"Van Buren County, MI",MI,2013,35114,31607,3507,10.0,-224
"Van Buren County, MI",MI,2012,35338,31658,3680,10.4,-1002
"Van Buren County, MI",MI,2011,36340,32314,4026,11.1,-1061
"Van Buren County, MI",MI,2010,37401,32504,4897,13.1,0
"Van Buren County, TN",TN,2021,2014,1914,100,5.0,0
"Van Buren County, TN",TN,2020,2014,1843,171,8.5,-51
"Van Buren County, TN",TN,2019,2065,1971,94,4.6,-1
"Van Buren County, TN",TN,2018,2066,1968,98,4.7,-25
"Van Buren County, TN",TN,2017,2091,2002,89,4.3,53
"Van Buren County, TN",TN,2016,2038,1912,126,6.2,-19
"Van Buren County, TN",TN,2015,2057,1894,163,7.9,-57
"Van Buren County, TN",TN,2014,2114,1910,204,9.6,-85
"Van Buren County, TN",TN,2013,2199,1947,252,11.5,-44
"Van Buren County, TN",TN,2012,2243,1981,262,11.7,-50
"Van Buren County, TN",TN,2011,2293,2020,273,11.9,-52
"Van Buren County, TN",TN,2010,2345,2031,314,13.4,0
"Van Wert County, OH",OH,2021,14591,14016,575,3.9,-143
"Van Wert County, OH",OH,2020,14734,13699,1035,7.0,-406
"Van Wert County, OH",OH,2019,15140,14643,497,3.3,661
"Van Wert County, OH",OH,2018,14479,13971,508,3.5,-104
"Van Wert County, OH",OH,2017,14583,14013,570,3.9,222
"Van Wert County, OH",OH,2016,14361,13777,584,4.1,-12
"Van Wert County, OH",OH,2015,14373,13769,604,4.2,-70
"Van Wert County, OH",OH,2014,14443,13738,705,4.9,241
"Van Wert County, OH",OH,2013,14202,13217,985,6.9,45
"Van Wert County, OH",OH,2012,14157,13090,1067,7.5,-341
"Van Wert County, OH",OH,2011,14498,13153,1345,9.3,-476
"Van Wert County, OH",OH,2010,14974,13162,1812,12.1,0
"Van Zandt County, TX",TX,2021,26780,25515,1265,4.7,906
"Van Zandt County, TX",TX,2020,25874,24284,1590,6.1,57
"Van Zandt County, TX",TX,2019,25817,24975,842,3.3,309
"Van Zandt County, TX",TX,2018,25508,24606,902,3.5,312
"Van Zandt County, TX",TX,2017,25196,24242,954,3.8,334
"Van Zandt County, TX",TX,2016,24862,23791,1071,4.3,641
"Van Zandt County, TX",TX,2015,24221,23124,1097,4.5,352
"Van Zandt County, TX",TX,2014,23869,22589,1280,5.4,65
"Van Zandt County, TX",TX,2013,23804,22239,1565,6.6,242
"Van Zandt County, TX",TX,2012,23562,21938,1624,6.9,-172
"Van Zandt County, TX",TX,2011,23734,21779,1955,8.2,100
"Van Zandt County, TX",TX,2010,23634,21641,1993,8.4,0
"Vance County, NC",NC,2021,16724,15401,1323,7.9,182
"Vance County, NC",NC,2020,16542,14921,1621,9.8,-695
"Vance County, NC",NC,2019,17237,16259,978,5.7,62
"Vance County, NC",NC,2018,17175,16165,1010,5.9,-463
"Vance County, NC",NC,2017,17638,16542,1096,6.2,-311
"Vance County, NC",NC,2016,17949,16663,1286,7.2,-73
"Vance County, NC",NC,2015,18022,16496,1526,8.5,-21
"Vance County, NC",NC,2014,18043,16405,1638,9.1,-97
"Vance County, NC",NC,2013,18140,16114,2026,11.2,-525
"Vance County, NC",NC,2012,18665,16081,2584,13.8,-77
"Vance County, NC",NC,2011,18742,15952,2790,14.9,-338
"Vance County, NC",NC,2010,19080,16412,2668,14.0,0
"Vanderburgh County, IN",IN,2021,91401,88095,3306,3.6,-760
"Vanderburgh County, IN",IN,2020,92161,85529,6632,7.2,-2267
"Vanderburgh County, IN",IN,2019,94428,91550,2878,3.0,-723
"Vanderburgh County, IN",IN,2018,95151,92165,2986,3.1,1435
"Vanderburgh County, IN",IN,2017,93716,90702,3014,3.2,388
"Vanderburgh County, IN",IN,2016,93328,89539,3789,4.1,1099
"Vanderburgh County, IN",IN,2015,92229,88320,3909,4.2,90
"Vanderburgh County, IN",IN,2014,92139,87183,4956,5.4,1083
"Vanderburgh County, IN",IN,2013,91056,84680,6376,7.0,-853
"Vanderburgh County, IN",IN,2012,91909,84972,6937,7.5,-1059
"Vanderburgh County, IN",IN,2011,92968,85708,7260,7.8,799
"Vanderburgh County, IN",IN,2010,92169,84166,8003,8.7,0
"Vega Alta Municipio, PR",PR,2021,10567,9596,971,9.2,
"Vega Alta Municipio, PR",PR,2020,N.A.,N.A.,N.A.,N.A.,
"Vega Alta Municipio, PR",PR,2019,9752,8960,792,8.1,160
"Vega Alta Municipio, PR",PR,2018,9592,8747,845,8.8,-193
"Vega Alta Municipio, PR",PR,2017,9785,8738,1047,10.7,-93
"Vega Alta Municipio, PR",PR,2016,9878,8740,1138,11.5,6
"Vega Alta Municipio, PR",PR,2015,9872,8719,1153,11.7,-93
"Vega Alta Municipio, PR",PR,2014,9965,8591,1374,13.8,-223
"Vega Alta Municipio, PR",PR,2013,10188,8751,1437,14.1,-113
"Vega Alta Municipio, PR",PR,2012,10301,8845,1456,14.1,-204
"Vega Alta Municipio, PR",PR,2011,10505,8752,1753,16.7,-317
"Vega Alta Municipio, PR",PR,2010,10822,8963,1859,17.2,0
"Vega Baja Municipio, PR",PR,2021,14185,12742,1443,10.2,
"Vega Baja Municipio, PR",PR,2020,N.A.,N.A.,N.A.,N.A.,
"Vega Baja Municipio, PR",PR,2019,13174,11912,1262,9.6,15
"Vega Baja Municipio, PR",PR,2018,13159,11787,1372,10.4,-255
"Vega Baja Municipio, PR",PR,2017,13414,11746,1668,12.4,-319
"Vega Baja Municipio, PR",PR,2016,13733,11829,1904,13.9,-87
"Vega Baja Municipio, PR",PR,2015,13820,11921,1899,13.7,-337
"Vega Baja Municipio, PR",PR,2014,14157,11869,2288,16.2,-444
"Vega Baja Municipio, PR",PR,2013,14601,12198,2403,16.5,-195
"Vega Baja Municipio, PR",PR,2012,14796,12435,2361,16.0,-497
"Vega Baja Municipio, PR",PR,2011,15293,12430,2863,18.7,-935
"Vega Baja Municipio, PR",PR,2010,16228,12856,3372,20.8,0
"Venango County, PA",PA,2021,21865,20370,1495,6.8,-545
"Venango County, PA",PA,2020,22410,20410,2000,8.9,-247
"Venango County, PA",PA,2019,22657,21537,1120,4.9,-26
"Venango County, PA",PA,2018,22683,21528,1155,5.1,-492
"Venango County, PA",PA,2017,23175,21738,1437,6.2,-567
"Venango County, PA",PA,2016,23742,22040,1702,7.2,-730
"Venango County, PA",PA,2015,24472,22991,1481,6.1,-197
"Venango County, PA",PA,2014,24669,23190,1479,6.0,-511
"Venango County, PA",PA,2013,25180,23285,1895,7.5,-1065
"Venango County, PA",PA,2012,26245,24276,1969,7.5,-99
"Venango County, PA",PA,2011,26344,24439,1905,7.2,3
"Venango County, PA",PA,2010,26341,24172,2169,8.2,0
"Ventura County, CA",CA,2021,404923,379995,24928,6.2,-4485
"Ventura County, CA",CA,2020,409408,373303,36105,8.8,-12702
"Ventura County, CA",CA,2019,422110,406610,15500,3.7,-934
"Ventura County, CA",CA,2018,423044,406752,16292,3.9,-632
"Ventura County, CA",CA,2017,423676,404462,19214,4.5,-1670
"Ventura County, CA",CA,2016,425346,403087,22259,5.2,-1889
"Ventura County, CA",CA,2015,427235,402977,24258,5.7,-1944
"Ventura County, CA",CA,2014,429179,400313,28866,6.7,-3166
"Ventura County, CA",CA,2013,432345,397865,34480,8.0,-1323
"Ventura County, CA",CA,2012,433668,393575,40093,9.2,2751
"Ventura County, CA",CA,2011,430917,385967,44950,10.4,682
"Ventura County, CA",CA,2010,430235,382449,47786,11.1,0
"Vermilion County, IL",IL,2021,31753,29689,2064,6.5,-549
"Vermilion County, IL",IL,2020,32302,29399,2903,9.0,-843
"Vermilion County, IL",IL,2019,33145,31518,1627,4.9,-495
"Vermilion County, IL",IL,2018,33640,31584,2056,6.1,-384
"Vermilion County, IL",IL,2017,34024,31813,2211,6.5,-1019
"Vermilion County, IL",IL,2016,35043,32499,2544,7.3,-356
"Vermilion County, IL",IL,2015,35399,32881,2518,7.1,-79
"Vermilion County, IL",IL,2014,35478,32441,3037,8.6,-359
"Vermilion County, IL",IL,2013,35837,32046,3791,10.6,-960
"Vermilion County, IL",IL,2012,36797,33364,3433,9.3,-608
"Vermilion County, IL",IL,2011,37405,33669,3736,10.0,-320
"Vermilion County, IL",IL,2010,37725,33348,4377,11.6,0
"Vermilion Parish, LA",LA,2021,23846,22645,1201,5.0,265
"Vermilion Parish, LA",LA,2020,23581,21719,1862,7.9,-569
"Vermilion Parish, LA",LA,2019,24150,22976,1174,4.9,-121
"Vermilion Parish, LA",LA,2018,24271,22997,1274,5.2,10
"Vermilion Parish, LA",LA,2017,24261,22808,1453,6.0,-471
"Vermilion Parish, LA",LA,2016,24732,22848,1884,7.6,-1001
"Vermilion Parish, LA",LA,2015,25733,23959,1774,6.9,-682
"Vermilion Parish, LA",LA,2014,26415,24968,1447,5.5,282
"Vermilion Parish, LA",LA,2013,26133,24730,1403,5.4,192
"Vermilion Parish, LA",LA,2012,25941,24521,1420,5.5,477
"Vermilion Parish, LA",LA,2011,25464,23870,1594,6.3,-164
"Vermilion Parish, LA",LA,2010,25628,23867,1761,6.9,0
"Vermillion County, IN",IN,2021,6480,6222,258,4.0,-118
"Vermillion County, IN",IN,2020,6598,6098,500,7.6,-265
"Vermillion County, IN",IN,2019,6863,6502,361,5.3,-302
"Vermillion County, IN",IN,2018,7165,6776,389,5.4,20
"Vermillion County, IN",IN,2017,7145,6763,382,5.3,-131
"Vermillion County, IN",IN,2016,7276,6803,473,6.5,52
"Vermillion County, IN",IN,2015,7224,6713,511,7.1,-6
"Vermillion County, IN",IN,2014,7230,6610,620,8.6,-102
"Vermillion County, IN",IN,2013,7332,6558,774,10.6,-139
"Vermillion County, IN",IN,2012,7471,6632,839,11.2,-188
"Vermillion County, IN",IN,2011,7659,6778,881,11.5,-147
"Vermillion County, IN",IN,2010,7806,6821,985,12.6,0
"Vernon County, MO",MO,2021,9422,9101,321,3.4,32
"Vernon County, MO",MO,2020,9390,8980,410,4.4,-8
"Vernon County, MO",MO,2019,9398,9085,313,3.3,-153
"Vernon County, MO",MO,2018,9551,9255,296,3.1,-92
"Vernon County, MO",MO,2017,9643,9278,365,3.8,45
"Vernon County, MO",MO,2016,9598,9133,465,4.8,-163
"Vernon County, MO",MO,2015,9761,9255,506,5.2,-38
"Vernon County, MO",MO,2014,9799,9245,554,5.7,49
"Vernon County, MO",MO,2013,9750,9168,582,6.0,199
"Vernon County, MO",MO,2012,9551,8974,577,6.0,3
"Vernon County, MO",MO,2011,9548,8844,704,7.4,16
"Vernon County, MO",MO,2010,9532,8750,782,8.2,0
"Vernon County, WI",WI,2021,15531,15029,502,3.2,435
"Vernon County, WI",WI,2020,15096,14305,791,5.2,-360
"Vernon County, WI",WI,2019,15456,14975,481,3.1,-57
"Vernon County, WI",WI,2018,15513,15071,442,2.8,-264
"Vernon County, WI",WI,2017,15777,15294,483,3.1,61
"Vernon County, WI",WI,2016,15716,15158,558,3.6,260
"Vernon County, WI",WI,2015,15456,14836,620,4.0,430
"Vernon County, WI",WI,2014,15026,14310,716,4.8,-105
"Vernon County, WI",WI,2013,15131,14235,896,5.9,105
"Vernon County, WI",WI,2012,15026,14083,943,6.3,-120
"Vernon County, WI",WI,2011,15146,14117,1029,6.8,-27
"Vernon County, WI",WI,2010,15173,13997,1176,7.8,0
"Vernon Parish, LA",LA,2021,16011,15282,729,4.6,220
"Vernon Parish, LA",LA,2020,15791,14576,1215,7.7,-76
"Vernon Parish, LA",LA,2019,15867,14947,920,5.8,-110
"Vernon Parish, LA",LA,2018,15977,14952,1025,6.4,-419
"Vernon Parish, LA",LA,2017,16396,15329,1067,6.5,-553
"Vernon Parish, LA",LA,2016,16949,15720,1229,7.3,-410
"Vernon Parish, LA",LA,2015,17359,16019,1340,7.7,10
"Vernon Parish, LA",LA,2014,17349,15897,1452,8.4,-517
"Vernon Parish, LA",LA,2013,17866,16353,1513,8.5,-1090
"Vernon Parish, LA",LA,2012,18956,17460,1496,7.9,-335
"Vernon Parish, LA",LA,2011,19291,17638,1653,8.6,761
"Vernon Parish, LA",LA,2010,18530,17027,1503,8.1,0
"Victoria County, TX",TX,2021,40785,38175,2610,6.4,190
"Victoria County, TX",TX,2020,40595,37217,3378,8.3,-1322
"Victoria County, TX",TX,2019,41917,40461,1456,3.5,-629
"Victoria County, TX",TX,2018,42546,40900,1646,3.9,-86
"Victoria County, TX",TX,2017,42632,40554,2078,4.9,-1100
"Victoria County, TX",TX,2016,43732,41357,2375,5.4,-1618
"Victoria County, TX",TX,2015,45350,43437,1913,4.2,-838
"Victoria County, TX",TX,2014,46188,44240,1948,4.2,445
"Victoria County, TX",TX,2013,45743,43283,2460,5.4,598
"Victoria County, TX",TX,2012,45145,42637,2508,5.6,1434
"Victoria County, TX",TX,2011,43711,40664,3047,7.0,564
"Victoria County, TX",TX,2010,43147,39816,3331,7.7,0
"Vieques Municipio, PR",PR,2021,2775,2435,340,12.3,
"Vieques Municipio, PR",PR,2020,N.A.,N.A.,N.A.,N.A.,
"Vieques Municipio, PR",PR,2019,2551,2368,183,7.2,-175
"Vieques Municipio, PR",PR,2018,2726,2276,450,16.5,-301
"Vieques Municipio, PR",PR,2017,3027,2589,438,14.5,-233
"Vieques Municipio, PR",PR,2016,3260,2914,346,10.6,66
"Vieques Municipio, PR",PR,2015,3194,2832,362,11.3,42
"Vieques Municipio, PR",PR,2014,3152,2710,442,14.0,72
"Vieques Municipio, PR",PR,2013,3080,2589,491,15.9,37
"Vieques Municipio, PR",PR,2012,3043,2651,392,12.9,-131
"Vieques Municipio, PR",PR,2011,3174,2671,503,15.8,-227
"Vieques Municipio, PR",PR,2010,3401,2767,634,18.6,0
"Vigo County, IN",IN,2021,45481,43523,1958,4.3,-728
"Vigo County, IN",IN,2020,46209,42549,3660,7.9,-782
"Vigo County, IN",IN,2019,46991,44941,2050,4.4,-2181
"Vigo County, IN",IN,2018,49172,47041,2131,4.3,216
"Vigo County, IN",IN,2017,48956,46914,2042,4.2,-463
"Vigo County, IN",IN,2016,49419,46792,2627,5.3,442
"Vigo County, IN",IN,2015,48977,45990,2987,6.1,-528
"Vigo County, IN",IN,2014,49505,45748,3757,7.6,-83
"Vigo County, IN",IN,2013,49588,45021,4567,9.2,-581
"Vigo County, IN",IN,2012,50169,45259,4910,9.8,-460
"Vigo County, IN",IN,2011,50629,45505,5124,10.1,-506
"Vigo County, IN",IN,2010,51135,45548,5587,10.9,0
"Vilas County, WI",WI,2021,10564,10064,500,4.7,145
"Vilas County, WI",WI,2020,10419,9667,752,7.2,164
"Vilas County, WI",WI,2019,10255,9844,411,4.0,72
"Vilas County, WI",WI,2018,10183,9785,398,3.9,-8
"Vilas County, WI",WI,2017,10191,9753,438,4.3,248
"Vilas County, WI",WI,2016,9943,9394,549,5.5,-27
"Vilas County, WI",WI,2015,9970,9287,683,6.9,-96
"Vilas County, WI",WI,2014,10066,9228,838,8.3,-109
"Vilas County, WI",WI,2013,10175,9152,1023,10.1,95
"Vilas County, WI",WI,2012,10080,9087,993,9.9,-46
"Vilas County, WI",WI,2011,10126,9045,1081,10.7,-217
"Vilas County, WI",WI,2010,10343,9197,1146,11.1,0
"Villalba Municipio, PR",PR,2021,7700,6807,893,11.6,
"Villalba Municipio, PR",PR,2020,N.A.,N.A.,N.A.,N.A.,
"Villalba Municipio, PR",PR,2019,7494,6309,1185,15.8,159
"Villalba Municipio, PR",PR,2018,7335,6174,1161,15.8,-222
"Villalba Municipio, PR",PR,2017,7557,6090,1467,19.4,-258
"Villalba Municipio, PR",PR,2016,7815,6235,1580,20.2,13
"Villalba Municipio, PR",PR,2015,7802,6262,1540,19.7,-118
"Villalba Municipio, PR",PR,2014,7920,6196,1724,21.8,-264
"Villalba Municipio, PR",PR,2013,8184,6416,1768,21.6,-124
"Villalba Municipio, PR",PR,2012,8308,6584,1724,20.8,-177
"Villalba Municipio, PR",PR,2011,8485,6681,1804,21.3,-356
"Villalba Municipio, PR",PR,2010,8841,6892,1949,22.0,0
"Vinton County, OH",OH,2021,5513,5172,341,6.2,-86
"Vinton County, OH",OH,2020,5599,5083,516,9.2,-16
"Vinton County, OH",OH,2019,5615,5297,318,5.7,89
"Vinton County, OH",OH,2018,5526,5184,342,6.2,35
"Vinton County, OH",OH,2017,5491,5115,376,6.8,15
"Vinton County, OH",OH,2016,5476,5088,388,7.1,-3
"Vinton County, OH",OH,2015,5479,5116,363,6.6,-50
"Vinton County, OH",OH,2014,5529,5086,443,8.0,-44
"Vinton County, OH",OH,2013,5573,4981,592,10.6,23
"Vinton County, OH",OH,2012,5550,4951,599,10.8,-167
"Vinton County, OH",OH,2011,5717,5037,680,11.9,-88
"Vinton County, OH",OH,2010,5805,5021,784,13.5,0
"Virginia Beach city, VA",VA,2021,224179,215879,8300,3.7,-6700
"Virginia Beach city, VA",VA,2020,230879,216547,14332,6.2,-5863
"Virginia Beach city, VA",VA,2019,236742,230437,6305,2.7,2098
"Virginia Beach city, VA",VA,2018,234644,228003,6641,2.8,857
"Virginia Beach city, VA",VA,2017,233787,225590,8197,3.5,4270
"Virginia Beach city, VA",VA,2016,229517,220574,8943,3.9,-179
"Virginia Beach city, VA",VA,2015,229696,219985,9711,4.2,-2885
"Virginia Beach city, VA",VA,2014,232581,221324,11257,4.8,1492
"Virginia Beach city, VA",VA,2013,231089,218890,12199,5.3,2381
"Virginia Beach city, VA",VA,2012,228708,215847,12861,5.6,-145
"Virginia Beach city, VA",VA,2011,228853,214828,14025,6.1,1674
"Virginia Beach city, VA",VA,2010,227179,212040,15139,6.7,0
"Volusia County, FL",FL,2021,255093,243303,11790,4.6,6370
"Volusia County, FL",FL,2020,248723,228265,20458,8.2,-3138
"Volusia County, FL",FL,2019,251861,242915,8946,3.6,1053
"Volusia County, FL",FL,2018,250808,241060,9748,3.9,3029
"Volusia County, FL",FL,2017,247779,236589,11190,4.5,1493
"Volusia County, FL",FL,2016,246286,233701,12585,5.1,6682
"Volusia County, FL",FL,2015,239604,225449,14155,5.9,2100
"Volusia County, FL",FL,2014,237504,220799,16705,7.0,2355
"Volusia County, FL",FL,2013,235149,215040,20109,8.6,-807
"Volusia County, FL",FL,2012,235956,212873,23083,9.8,-570
"Volusia County, FL",FL,2011,236526,209938,26588,11.2,452
"Volusia County, FL",FL,2010,236074,207981,28093,11.9,0
"Wabash County, IL",IL,2021,5409,5165,244,4.5,-264
"Wabash County, IL",IL,2020,5673,5193,480,8.5,-181
"Wabash County, IL",IL,2019,5854,5619,235,4.0,28
"Wabash County, IL",IL,2018,5826,5538,288,4.9,172
"Wabash County, IL",IL,2017,5654,5358,296,5.2,-124
"Wabash County, IL",IL,2016,5778,5415,363,6.3,145
"Wabash County, IL",IL,2015,5633,5314,319,5.7,68
"Wabash County, IL",IL,2014,5565,5230,335,6.0,-70
"Wabash County, IL",IL,2013,5635,5215,420,7.5,-113
"Wabash County, IL",IL,2012,5748,5289,459,8.0,-61
"Wabash County, IL",IL,2011,5809,5292,517,8.9,-42
"Wabash County, IL",IL,2010,5851,5275,576,9.8,0
"Wabash County, IN",IN,2021,14406,13986,420,2.9,-65
"Wabash County, IN",IN,2020,14471,13578,893,6.2,-601
"Wabash County, IN",IN,2019,15072,14611,461,3.1,63
"Wabash County, IN",IN,2018,15009,14498,511,3.4,-121
"Wabash County, IN",IN,2017,15130,14608,522,3.5,-363
"Wabash County, IN",IN,2016,15493,14842,651,4.2,108
"Wabash County, IN",IN,2015,15385,14653,732,4.8,-94
"Wabash County, IN",IN,2014,15479,14620,859,5.5,1
"Wabash County, IN",IN,2013,15478,14320,1158,7.5,-229
"Wabash County, IN",IN,2012,15707,14393,1314,8.4,-32
"Wabash County, IN",IN,2011,15739,14266,1473,9.4,-215
"Wabash County, IN",IN,2010,15954,14179,1775,11.1,0
"Wabasha County, MN",MN,2021,12017,11656,361,3.0,-489
"Wabasha County, MN",MN,2020,12506,11820,686,5.5,107
"Wabasha County, MN",MN,2019,12399,11958,441,3.6,130
"Wabasha County, MN",MN,2018,12269,11880,389,3.2,51
"Wabasha County, MN",MN,2017,12218,11806,412,3.4,211
"Wabasha County, MN",MN,2016,12007,11564,443,3.7,-14
"Wabasha County, MN",MN,2015,12021,11557,464,3.9,268
"Wabasha County, MN",MN,2014,11753,11268,485,4.1,-88
"Wabasha County, MN",MN,2013,11841,11287,554,4.7,-131
"Wabasha County, MN",MN,2012,11972,11348,624,5.2,-8
"Wabasha County, MN",MN,2011,11980,11238,742,6.2,-137
"Wabasha County, MN",MN,2010,12117,11249,868,7.2,0
"Wabaunsee County, KS",KS,2021,3711,3620,91,2.5,35
"Wabaunsee County, KS",KS,2020,3676,3529,147,4.0,-20
"Wabaunsee County, KS",KS,2019,3696,3579,117,3.2,19
"Wabaunsee County, KS",KS,2018,3677,3564,113,3.1,18
"Wabaunsee County, KS",KS,2017,3659,3543,116,3.2,-64
"Wabaunsee County, KS",KS,2016,3723,3590,133,3.6,-19
"Wabaunsee County, KS",KS,2015,3742,3598,144,3.8,-23
"Wabaunsee County, KS",KS,2014,3765,3611,154,4.1,-12
"Wabaunsee County, KS",KS,2013,3777,3587,190,5.0,-25
"Wabaunsee County, KS",KS,2012,3802,3596,206,5.4,-52
"Wabaunsee County, KS",KS,2011,3854,3617,237,6.1,-33
"Wabaunsee County, KS",KS,2010,3887,3636,251,6.5,0
"Wadena County, MN",MN,2021,5854,5593,261,4.5,-200
"Wadena County, MN",MN,2020,6054,5571,483,8.0,44
"Wadena County, MN",MN,2019,6010,5616,394,6.6,66
"Wadena County, MN",MN,2018,5944,5612,332,5.6,85
"Wadena County, MN",MN,2017,5859,5530,329,5.6,-387
"Wadena County, MN",MN,2016,6246,5875,371,5.9,-100
"Wadena County, MN",MN,2015,6346,5963,383,6.0,188
"Wadena County, MN",MN,2014,6158,5767,391,6.3,-16
"Wadena County, MN",MN,2013,6174,5737,437,7.1,-64
"Wadena County, MN",MN,2012,6238,5748,490,7.9,-94
"Wadena County, MN",MN,2011,6332,5760,572,9.0,-154
"Wadena County, MN",MN,2010,6486,5825,661,10.2,0
"Wagoner County, OK",OK,2021,38649,37279,1370,3.5,286
"Wagoner County, OK",OK,2020,38363,36111,2252,5.9,2
"Wagoner County, OK",OK,2019,38361,37224,1137,3.0,689
"Wagoner County, OK",OK,2018,37672,36472,1200,3.2,768
"Wagoner County, OK",OK,2017,36904,35378,1526,4.1,328
"Wagoner County, OK",OK,2016,36576,34892,1684,4.6,353
"Wagoner County, OK",OK,2015,36223,34737,1486,4.1,656
"Wagoner County, OK",OK,2014,35567,34107,1460,4.1,-313
"Wagoner County, OK",OK,2013,35880,34115,1765,4.9,45
"Wagoner County, OK",OK,2012,35835,34035,1800,5.0,813
"Wagoner County, OK",OK,2011,35022,33066,1956,5.6,-195
"Wagoner County, OK",OK,2010,35217,32924,2293,6.5,0
"Wahkiakum County, WA",WA,2021,1357,1267,90,6.6,-37
"Wahkiakum County, WA",WA,2020,1394,1273,121,8.7,5
"Wahkiakum County, WA",WA,2019,1389,1296,93,6.7,49
"Wahkiakum County, WA",WA,2018,1340,1251,89,6.6,30
"Wahkiakum County, WA",WA,2017,1310,1217,93,7.1,21
"Wahkiakum County, WA",WA,2016,1289,1179,110,8.5,-2
"Wahkiakum County, WA",WA,2015,1291,1179,112,8.7,17
"Wahkiakum County, WA",WA,2014,1274,1154,120,9.4,-18
"Wahkiakum County, WA",WA,2013,1292,1140,152,11.8,-74
"Wahkiakum County, WA",WA,2012,1366,1206,160,11.7,-41
"Wahkiakum County, WA",WA,2011,1407,1225,182,12.9,-27
"Wahkiakum County, WA",WA,2010,1434,1235,199,13.9,0
"Wake County, NC",NC,2021,594675,571029,23646,4.0,22245
"Wake County, NC",NC,2020,572430,536715,35715,6.2,-14755
"Wake County, NC",NC,2019,587185,567415,19770,3.4,9935
"Wake County, NC",NC,2018,577250,557244,20006,3.5,12033
"Wake County, NC",NC,2017,565217,543121,22096,3.9,10254
"Wake County, NC",NC,2016,554963,531092,23871,4.3,15954
"Wake County, NC",NC,2015,539009,513915,25094,4.7,15273
"Wake County, NC",NC,2014,523736,498730,25006,4.8,11255
"Wake County, NC",NC,2013,512481,482605,29876,5.8,6015
"Wake County, NC",NC,2012,506466,469451,37015,7.3,16020
"Wake County, NC",NC,2011,490446,451953,38493,7.8,8000
"Wake County, NC",NC,2010,482446,442867,39579,8.2,0
"Wakulla County, FL",FL,2021,15429,14941,488,3.2,435
"Wakulla County, FL",FL,2020,14994,14272,722,4.8,-277
"Wakulla County, FL",FL,2019,15271,14817,454,3.0,645
"Wakulla County, FL",FL,2018,14626,14151,475,3.2,253
"Wakulla County, FL",FL,2017,14373,13848,525,3.7,31
"Wakulla County, FL",FL,2016,14342,13743,599,4.2,329
"Wakulla County, FL",FL,2015,14013,13353,660,4.7,-269
"Wakulla County, FL",FL,2014,14282,13520,762,5.3,246
"Wakulla County, FL",FL,2013,14036,13160,876,6.2,11
"Wakulla County, FL",FL,2012,14025,12970,1055,7.5,-493
"Wakulla County, FL",FL,2011,14518,13322,1196,8.2,43
"Wakulla County, FL",FL,2010,14475,13304,1171,8.1,0
"Waldo County, ME",ME,2021,20249,19298,951,4.7,268
"Waldo County, ME",ME,2020,19981,19035,946,4.7,-917
"Waldo County, ME",ME,2019,20898,20291,607,2.9,-449
"Waldo County, ME",ME,2018,21347,20654,693,3.2,14
"Waldo County, ME",ME,2017,21333,20550,783,3.7,419
"Waldo County, ME",ME,2016,20914,20041,873,4.2,162
"Waldo County, ME",ME,2015,20752,19669,1083,5.2,-136
"Waldo County, ME",ME,2014,20888,19634,1254,6.0,-87
"Waldo County, ME",ME,2013,20975,19459,1516,7.2,353
"Waldo County, ME",ME,2012,20622,18983,1639,7.9,236
"Waldo County, ME",ME,2011,20386,18734,1652,8.1,-103
"Waldo County, ME",ME,2010,20489,18686,1803,8.8,0
"Walker County, AL",AL,2021,25085,24174,911,3.6,-125
"Walker County, AL",AL,2020,25210,23583,1627,6.5,-332
"Walker County, AL",AL,2019,25542,24653,889,3.5,141
"Walker County, AL",AL,2018,25401,24330,1071,4.2,212
"Walker County, AL",AL,2017,25189,23891,1298,5.2,-167
"Walker County, AL",AL,2016,25356,23465,1891,7.5,-147
"Walker County, AL",AL,2015,25503,23650,1853,7.3,-293
"Walker County, AL",AL,2014,25796,23766,2030,7.9,-551
"Walker County, AL",AL,2013,26347,24086,2261,8.6,-261
"Walker County, AL",AL,2012,26608,24107,2501,9.4,-468
"Walker County, AL",AL,2011,27076,24045,3031,11.2,-198
"Walker County, AL",AL,2010,27274,23867,3407,12.5,0
"Walker County, GA",GA,2021,31304,30327,977,3.1,742
"Walker County, GA",GA,2020,30562,29065,1497,4.9,-900
"Walker County, GA",GA,2019,31462,30288,1174,3.7,100
"Walker County, GA",GA,2018,31362,30136,1226,3.9,192
"Walker County, GA",GA,2017,31170,29750,1420,4.6,1232
"Walker County, GA",GA,2016,29938,28247,1691,5.6,874
"Walker County, GA",GA,2015,29064,27298,1766,6.1,-292
"Walker County, GA",GA,2014,29356,27230,2126,7.2,-764
"Walker County, GA",GA,2013,30120,27705,2415,8.0,-700
"Walker County, GA",GA,2012,30820,28089,2731,8.9,-196
"Walker County, GA",GA,2011,31016,27996,3020,9.7,-52
"Walker County, GA",GA,2010,31068,27822,3246,10.4,0
"Walker County, TX",TX,2021,23951,22451,1500,6.3,90
"Walker County, TX",TX,2020,23861,22148,1713,7.2,35
"Walker County, TX",TX,2019,23826,22888,938,3.9,177
"Walker County, TX",TX,2018,23649,22649,1000,4.2,137
"Walker County, TX",TX,2017,23512,22414,1098,4.7,-285
"Walker County, TX",TX,2016,23797,22547,1250,5.3,809
"Walker County, TX",TX,2015,22988,21817,1171,5.1,-136
"Walker County, TX",TX,2014,23124,21851,1273,5.5,47
"Walker County, TX",TX,2013,23077,21539,1538,6.7,-21
"Walker County, TX",TX,2012,23098,21501,1597,6.9,-66
"Walker County, TX",TX,2011,23164,21285,1879,8.1,-109
"Walker County, TX",TX,2010,23273,21456,1817,7.8,0
"Walla Walla County, WA",WA,2021,31593,30137,1456,4.6,549
"Walla Walla County, WA",WA,2020,31044,28997,2047,6.6,538
"Walla Walla County, WA",WA,2019,30506,28984,1522,5.0,986
"Walla Walla County, WA",WA,2018,29520,28136,1384,4.7,530
"Walla Walla County, WA",WA,2017,28990,27577,1413,4.9,256
"Walla Walla County, WA",WA,2016,28734,27206,1528,5.3,678
"Walla Walla County, WA",WA,2015,28056,26459,1597,5.7,-364
"Walla Walla County, WA",WA,2014,28420,26722,1698,6.0,16
"Walla Walla County, WA",WA,2013,28404,26425,1979,7.0,-1079
"Walla Walla County, WA",WA,2012,29483,27472,2011,6.8,101
"Walla Walla County, WA",WA,2011,29382,27274,2108,7.2,-593
"Walla Walla County, WA",WA,2010,29975,27811,2164,7.2,0
"Wallace County, KS",KS,2021,887,872,15,1.7,51
"Wallace County, KS",KS,2020,836,820,16,1.9,16
"Wallace County, KS",KS,2019,820,799,21,2.6,-4
"Wallace County, KS",KS,2018,824,804,20,2.4,-30
"Wallace County, KS",KS,2017,854,832,22,2.6,-9
"Wallace County, KS",KS,2016,863,840,23,2.7,-16
"Wallace County, KS",KS,2015,879,855,24,2.7,2
"Wallace County, KS",KS,2014,877,855,22,2.5,23
"Wallace County, KS",KS,2013,854,827,27,3.2,-22
"Wallace County, KS",KS,2012,876,839,37,4.2,-10
"Wallace County, KS",KS,2011,886,838,48,5.4,-8
"Wallace County, KS",KS,2010,894,841,53,5.9,0
"Waller County, TX",TX,2021,24799,23216,1583,6.4,547
"Waller County, TX",TX,2020,24252,22406,1846,7.6,372
"Waller County, TX",TX,2019,23880,22983,897,3.8,958
"Waller County, TX",TX,2018,22922,21937,985,4.3,703
"Waller County, TX",TX,2017,22219,21122,1097,4.9,39
"Waller County, TX",TX,2016,22180,20939,1241,5.6,510
"Waller County, TX",TX,2015,21670,20622,1048,4.8,381
"Waller County, TX",TX,2014,21289,20186,1103,5.2,491
"Waller County, TX",TX,2013,20798,19443,1355,6.5,348
"Waller County, TX",TX,2012,20450,19026,1424,7.0,111
"Waller County, TX",TX,2011,20339,18619,1720,8.5,350
"Waller County, TX",TX,2010,19989,18252,1737,8.7,0
"Wallowa County, OR",OR,2021,3622,3426,196,5.4,160
"Wallowa County, OR",OR,2020,3462,3216,246,7.1,43
"Wallowa County, OR",OR,2019,3419,3224,195,5.7,44
"Wallowa County, OR",OR,2018,3375,3179,196,5.8,81
"Wallowa County, OR",OR,2017,3294,3112,182,5.5,-11
"Wallowa County, OR",OR,2016,3305,3087,218,6.6,63
"Wallowa County, OR",OR,2015,3242,2996,246,7.6,17
"Wallowa County, OR",OR,2014,3225,2909,316,9.8,-18
"Wallowa County, OR",OR,2013,3243,2887,356,11.0,-126
"Wallowa County, OR",OR,2012,3369,2983,386,11.5,-123
"Wallowa County, OR",OR,2011,3492,3061,431,12.3,-26
"Wallowa County, OR",OR,2010,3518,3062,456,13.0,0
"Walsh County, ND",ND,2021,5274,5032,242,4.6,87
"Walsh County, ND",ND,2020,5187,4953,234,4.5,-52
"Walsh County, ND",ND,2019,5239,5086,153,2.9,-142
"Walsh County, ND",ND,2018,5381,5227,154,2.9,-271
"Walsh County, ND",ND,2017,5652,5463,189,3.3,3
"Walsh County, ND",ND,2016,5649,5435,214,3.8,115
"Walsh County, ND",ND,2015,5534,5302,232,4.2,26
"Walsh County, ND",ND,2014,5508,5258,250,4.5,-53
"Walsh County, ND",ND,2013,5561,5287,274,4.9,-67
"Walsh County, ND",ND,2012,5628,5364,264,4.7,-317
"Walsh County, ND",ND,2011,5945,5657,288,4.8,-287
"Walsh County, ND",ND,2010,6232,5921,311,5.0,0
"Walthall County, MS",MS,2021,4937,4597,340,6.9,21
"Walthall County, MS",MS,2020,4916,4510,406,8.3,-43
"Walthall County, MS",MS,2019,4959,4599,360,7.3,-89
"Walthall County, MS",MS,2018,5048,4715,333,6.6,-5
"Walthall County, MS",MS,2017,5053,4702,351,6.9,37
"Walthall County, MS",MS,2016,5016,4621,395,7.9,-119
"Walthall County, MS",MS,2015,5135,4714,421,8.2,-6
"Walthall County, MS",MS,2014,5141,4650,491,9.6,-156
"Walthall County, MS",MS,2013,5297,4734,563,10.6,-334
"Walthall County, MS",MS,2012,5631,5010,621,11.0,-208
"Walthall County, MS",MS,2011,5839,5149,690,11.8,16
"Walthall County, MS",MS,2010,5823,5087,736,12.6,0
"Walton County, FL",FL,2021,33792,32597,1195,3.5,1444
"Walton County, FL",FL,2020,32348,30321,2027,6.3,500
"Walton County, FL",FL,2019,31848,30914,934,2.9,1079
"Walton County, FL",FL,2018,30769,29768,1001,3.3,964
"Walton County, FL",FL,2017,29805,28692,1113,3.7,770
"Walton County, FL",FL,2016,29035,27776,1259,4.3,1086
"Walton County, FL",FL,2015,27949,26623,1326,4.7,648
"Walton County, FL",FL,2014,27301,25811,1490,5.5,411
"Walton County, FL",FL,2013,26890,25178,1712,6.4,798
"Walton County, FL",FL,2012,26092,24133,1959,7.5,-44
"Walton County, FL",FL,2011,26136,23914,2222,8.5,362
"Walton County, FL",FL,2010,25774,23433,2341,9.1,0
"Walton County, GA",GA,2021,46945,45448,1497,3.2,1393
"Walton County, GA",GA,2020,45552,43123,2429,5.3,-705
"Walton County, GA",GA,2019,46257,44765,1492,3.2,416
"Walton County, GA",GA,2018,45841,44183,1658,3.6,675
"Walton County, GA",GA,2017,45166,43196,1970,4.4,1784
"Walton County, GA",GA,2016,43382,41222,2160,5.0,2187
"Walton County, GA",GA,2015,41195,38928,2267,5.5,-151
"Walton County, GA",GA,2014,41346,38673,2673,6.5,347
"Walton County, GA",GA,2013,40999,37833,3166,7.7,1
"Walton County, GA",GA,2012,40998,37325,3673,9.0,-137
"Walton County, GA",GA,2011,41135,36890,4245,10.3,-17
"Walton County, GA",GA,2010,41152,36712,4440,10.8,0
"Walworth County, SD",SD,2021,2159,2041,118,5.5,43
"Walworth County, SD",SD,2020,2116,1995,121,5.7,22
"Walworth County, SD",SD,2019,2094,1996,98,4.7,-108
"Walworth County, SD",SD,2018,2202,2102,100,4.5,-28
"Walworth County, SD",SD,2017,2230,2126,104,4.7,-24
"Walworth County, SD",SD,2016,2254,2137,117,5.2,-27
"Walworth County, SD",SD,2015,2281,2160,121,5.3,-99
"Walworth County, SD",SD,2014,2380,2256,124,5.2,7
"Walworth County, SD",SD,2013,2373,2246,127,5.4,26
"Walworth County, SD",SD,2012,2347,2210,137,5.8,-38
"Walworth County, SD",SD,2011,2385,2222,163,6.8,-19
"Walworth County, SD",SD,2010,2404,2242,162,6.7,0
"Walworth County, WI",WI,2021,58402,56288,2114,3.6,1341
"Walworth County, WI",WI,2020,57061,53583,3478,6.1,-968
"Walworth County, WI",WI,2019,58029,56215,1814,3.1,-420
"Walworth County, WI",WI,2018,58449,56744,1705,2.9,339
"Walworth County, WI",WI,2017,58110,56223,1887,3.2,560
"Walworth County, WI",WI,2016,57550,55307,2243,3.9,707
"Walworth County, WI",WI,2015,56843,54266,2577,4.5,-89
"Walworth County, WI",WI,2014,56932,53825,3107,5.5,157
"Walworth County, WI",WI,2013,56775,52919,3856,6.8,810
"Walworth County, WI",WI,2012,55965,51974,3991,7.1,-159
"Walworth County, WI",WI,2011,56124,51754,4370,7.8,-267
"Walworth County, WI",WI,2010,56391,51392,4999,8.9,0
"Wapello County, IA",IA,2021,16957,16117,840,5.0,-504
"Wapello County, IA",IA,2020,17461,16440,1021,5.8,-637
"Wapello County, IA",IA,2019,18098,17469,629,3.5,174
"Wapello County, IA",IA,2018,17924,17312,612,3.4,124
"Wapello County, IA",IA,2017,17800,17007,793,4.5,-181
"Wapello County, IA",IA,2016,17981,16949,1032,5.7,-27
"Wapello County, IA",IA,2015,18008,17090,918,5.1,-134
"Wapello County, IA",IA,2014,18142,17147,995,5.5,-16
"Wapello County, IA",IA,2013,18158,17009,1149,6.3,191
"Wapello County, IA",IA,2012,17967,16712,1255,7.0,-242
"Wapello County, IA",IA,2011,18209,16877,1332,7.3,-271
"Wapello County, IA",IA,2010,18480,16990,1490,8.1,0
"Ward County, ND",ND,2021,31812,30452,1360,4.3,-351
"Ward County, ND",ND,2020,32163,30237,1926,6.0,-209
"Ward County, ND",ND,2019,32372,31649,723,2.2,-83
"Ward County, ND",ND,2018,32455,31611,844,2.6,-480
"Ward County, ND",ND,2017,32935,31874,1061,3.2,-531
"Ward County, ND",ND,2016,33466,32086,1380,4.1,-546
"Ward County, ND",ND,2015,34012,32926,1086,3.2,-132
"Ward County, ND",ND,2014,34144,33265,879,2.6,48
"Ward County, ND",ND,2013,34096,33178,918,2.7,338
"Ward County, ND",ND,2012,33758,32902,856,2.5,1368
"Ward County, ND",ND,2011,32390,31394,996,3.1,802
"Ward County, ND",ND,2010,31588,30518,1070,3.4,0
"Ward County, TX",TX,2021,5884,5463,421,7.2,-227
"Ward County, TX",TX,2020,6111,5532,579,9.5,-1159
"Ward County, TX",TX,2019,7270,7097,173,2.4,563
"Ward County, TX",TX,2018,6707,6534,173,2.6,1163
"Ward County, TX",TX,2017,5544,5318,226,4.1,147
"Ward County, TX",TX,2016,5397,5089,308,5.7,-518
"Ward County, TX",TX,2015,5915,5660,255,4.3,3
"Ward County, TX",TX,2014,5912,5697,215,3.6,404
"Ward County, TX",TX,2013,5508,5247,261,4.7,165
"Ward County, TX",TX,2012,5343,5087,256,4.8,407
"Ward County, TX",TX,2011,4936,4604,332,6.7,299
"Ward County, TX",TX,2010,4637,4243,394,8.5,0
"Ware County, GA",GA,2021,15404,14837,567,3.7,102
"Ware County, GA",GA,2020,15302,14456,846,5.5,-222
"Ware County, GA",GA,2019,15524,14927,597,3.8,-88
"Ware County, GA",GA,2018,15612,14991,621,4.0,-367
"Ware County, GA",GA,2017,15979,15248,731,4.6,495
"Ware County, GA",GA,2016,15484,14637,847,5.5,1160
"Ware County, GA",GA,2015,14324,13375,949,6.6,-413
"Ware County, GA",GA,2014,14737,13567,1170,7.9,-341
"Ware County, GA",GA,2013,15078,13675,1403,9.3,-348
"Ware County, GA",GA,2012,15426,13887,1539,10.0,182
"Ware County, GA",GA,2011,15244,13542,1702,11.2,-360
"Ware County, GA",GA,2010,15604,13865,1739,11.1,0
"Warren County, GA",GA,2021,2684,2558,126,4.7,45
"Warren County, GA",GA,2020,2639,2461,178,6.7,-127
"Warren County, GA",GA,2019,2766,2630,136,4.9,6
"Warren County, GA",GA,2018,2760,2622,138,5.0,10
"Warren County, GA",GA,2017,2750,2588,162,5.9,50
"Warren County, GA",GA,2016,2700,2510,190,7.0,90
"Warren County, GA",GA,2015,2610,2403,207,7.9,-101
"Warren County, GA",GA,2014,2711,2447,264,9.7,-12
"Warren County, GA",GA,2013,2723,2398,325,11.9,82
"Warren County, GA",GA,2012,2641,2252,389,14.7,1
"Warren County, GA",GA,2011,2640,2206,434,16.4,-26
"Warren County, GA",GA,2010,2666,2203,463,17.4,0
"Warren County, IA",IA,2021,28292,27235,1057,3.7,366
"Warren County, IA",IA,2020,27926,26685,1241,4.4,-1056
"Warren County, IA",IA,2019,28982,28284,698,2.4,793
"Warren County, IA",IA,2018,28189,27545,644,2.3,735
"Warren County, IA",IA,2017,27454,26710,744,2.7,202
"Warren County, IA",IA,2016,27252,26388,864,3.2,541
"Warren County, IA",IA,2015,26711,25805,906,3.4,-61
"Warren County, IA",IA,2014,26772,25714,1058,4.0,398
"Warren County, IA",IA,2013,26374,25189,1185,4.5,385
"Warren County, IA",IA,2012,25989,24744,1245,4.8,-75
"Warren County, IA",IA,2011,26064,24689,1375,5.3,-222
"Warren County, IA",IA,2010,26286,24778,1508,5.7,0
"Warren County, IL",IL,2021,7782,7425,357,4.6,-267
"Warren County, IL",IL,2020,8049,7541,508,6.3,-466
"Warren County, IL",IL,2019,8515,8184,331,3.9,-214
"Warren County, IL",IL,2018,8729,8367,362,4.1,59
"Warren County, IL",IL,2017,8670,8308,362,4.2,-64
"Warren County, IL",IL,2016,8734,8273,461,5.3,154
"Warren County, IL",IL,2015,8580,8132,448,5.2,-152
"Warren County, IL",IL,2014,8732,8219,513,5.9,-81
"Warren County, IL",IL,2013,8813,8169,644,7.3,-79
"Warren County, IL",IL,2012,8892,8258,634,7.1,-231
"Warren County, IL",IL,2011,9123,8464,659,7.2,-152
"Warren County, IL",IL,2010,9275,8552,723,7.8,0
"Warren County, IN",IN,2021,3973,3870,103,2.6,9
"Warren County, IN",IN,2020,3964,3745,219,5.5,-248
"Warren County, IN",IN,2019,4212,4088,124,2.9,-1
"Warren County, IN",IN,2018,4213,4079,134,3.2,121
"Warren County, IN",IN,2017,4092,3955,137,3.3,-24
"Warren County, IN",IN,2016,4116,3919,197,4.8,19
"Warren County, IN",IN,2015,4097,3895,202,4.9,-1
"Warren County, IN",IN,2014,4098,3849,249,6.1,-60
"Warren County, IN",IN,2013,4158,3799,359,8.6,-44
"Warren County, IN",IN,2012,4202,3896,306,7.3,-84
"Warren County, IN",IN,2011,4286,3941,345,8.0,83
"Warren County, IN",IN,2010,4203,3770,433,10.3,0
"Warren County, KY",KY,2021,64517,61768,2749,4.3,1073
"Warren County, KY",KY,2020,63444,59408,4036,6.4,-2310
"Warren County, KY",KY,2019,65754,63314,2440,3.7,1208
"Warren County, KY",KY,2018,64546,62227,2319,3.6,511
"Warren County, KY",KY,2017,64035,61488,2547,4.0,2043
"Warren County, KY",KY,2016,61992,59600,2392,3.9,2528
"Warren County, KY",KY,2015,59464,56834,2630,4.4,69
"Warren County, KY",KY,2014,59395,56106,3289,5.5,-1098
"Warren County, KY",KY,2013,60493,56378,4115,6.8,511
"Warren County, KY",KY,2012,59982,55793,4189,7.0,873
"Warren County, KY",KY,2011,59109,54246,4863,8.2,599
"Warren County, KY",KY,2010,58510,53080,5430,9.3,0
"Warren County, MO",MO,2021,18722,17946,776,4.1,183
"Warren County, MO",MO,2020,18539,17492,1047,5.6,80
"Warren County, MO",MO,2019,18459,17958,501,2.7,723
"Warren County, MO",MO,2018,17736,17248,488,2.8,175
"Warren County, MO",MO,2017,17561,17002,559,3.2,81
"Warren County, MO",MO,2016,17480,16750,730,4.2,242
"Warren County, MO",MO,2015,17238,16398,840,4.9,186
"Warren County, MO",MO,2014,17052,15997,1055,6.2,235
"Warren County, MO",MO,2013,16817,15656,1161,6.9,-14
"Warren County, MO",MO,2012,16831,15532,1299,7.7,-200
"Warren County, MO",MO,2011,17031,15456,1575,9.2,-148
"Warren County, MO",MO,2010,17179,15311,1868,10.9,0
"Warren County, MS",MS,2021,19416,18221,1195,6.2,-488
"Warren County, MS",MS,2020,19904,18206,1698,8.5,-572
"Warren County, MS",MS,2019,20476,19249,1227,6.0,29
"Warren County, MS",MS,2018,20447,19305,1142,5.6,-356
"Warren County, MS",MS,2017,20803,19599,1204,5.8,88
"Warren County, MS",MS,2016,20715,19377,1338,6.5,-106
"Warren County, MS",MS,2015,20821,19417,1404,6.7,-53
"Warren County, MS",MS,2014,20874,19263,1611,7.7,-769
"Warren County, MS",MS,2013,21643,19707,1936,8.9,-1850
"Warren County, MS",MS,2012,23493,21421,2072,8.8,-93
"Warren County, MS",MS,2011,23586,21251,2335,9.9,213
"Warren County, MS",MS,2010,23373,20997,2376,10.2,0
"Warren County, NC",NC,2021,6437,5941,496,7.7,115
"Warren County, NC",NC,2020,6322,5721,601,9.5,-197
"Warren County, NC",NC,2019,6519,6154,365,5.6,51
"Warren County, NC",NC,2018,6468,6076,392,6.1,-261
"Warren County, NC",NC,2017,6729,6268,461,6.9,-391
"Warren County, NC",NC,2016,7120,6600,520,7.3,-82
"Warren County, NC",NC,2015,7202,6612,590,8.2,-13
"Warren County, NC",NC,2014,7215,6591,624,8.6,-92
"Warren County, NC",NC,2013,7307,6529,778,10.6,-343
"Warren County, NC",NC,2012,7650,6675,975,12.7,-30
"Warren County, NC",NC,2011,7680,6610,1070,13.9,105
"Warren County, NC",NC,2010,7575,6546,1029,13.6,0
"Warren County, NJ",NJ,2021,58523,55292,3231,5.5,967
"Warren County, NJ",NJ,2020,57556,52839,4717,8.2,-509
"Warren County, NJ",NJ,2019,58065,56211,1854,3.2,975
"Warren County, NJ",NJ,2018,57090,54966,2124,3.7,-464
"Warren County, NJ",NJ,2017,57554,55197,2357,4.1,1045
"Warren County, NJ",NJ,2016,56509,53937,2572,4.6,-167
"Warren County, NJ",NJ,2015,56676,53677,2999,5.3,-176
"Warren County, NJ",NJ,2014,56852,53267,3585,6.3,-717
"Warren County, NJ",NJ,2013,57569,53077,4492,7.8,-954
"Warren County, NJ",NJ,2012,58523,53376,5147,8.8,-160
"Warren County, NJ",NJ,2011,58683,53348,5335,9.1,47
"Warren County, NJ",NJ,2010,58636,52774,5862,10.0,0
"Warren County, NY",NY,2021,31045,29531,1514,4.9,-327
"Warren County, NY",NY,2020,31372,28821,2551,8.1,-535
"Warren County, NY",NY,2019,31907,30502,1405,4.4,-295
"Warren County, NY",NY,2018,32202,30712,1490,4.6,-232
"Warren County, NY",NY,2017,32434,30733,1701,5.2,431
"Warren County, NY",NY,2016,32003,30292,1711,5.3,-199
"Warren County, NY",NY,2015,32202,30407,1795,5.6,-58
"Warren County, NY",NY,2014,32260,30116,2144,6.6,-855
"Warren County, NY",NY,2013,33115,30340,2775,8.4,-601
"Warren County, NY",NY,2012,33716,30577,3139,9.3,44
"Warren County, NY",NY,2011,33672,30644,3028,9.0,-520
"Warren County, NY",NY,2010,34192,31054,3138,9.2,0
"Warren County, OH",OH,2021,121173,116335,4838,4.0,1593
"Warren County, OH",OH,2020,119580,111968,7612,6.4,-1809
"Warren County, OH",OH,2019,121389,117089,4300,3.5,2587
"Warren County, OH",OH,2018,118802,114238,4564,3.8,1745
"Warren County, OH",OH,2017,117057,112253,4804,4.1,2006
"Warren County, OH",OH,2016,115051,110242,4809,4.2,2274
"Warren County, OH",OH,2015,112777,108041,4736,4.2,1525
"Warren County, OH",OH,2014,111252,105721,5531,5.0,1464
"Warren County, OH",OH,2013,109788,102723,7065,6.4,702
"Warren County, OH",OH,2012,109086,101993,7093,6.5,-244
"Warren County, OH",OH,2011,109330,100699,8631,7.9,-966
"Warren County, OH",OH,2010,110296,100309,9987,9.1,0
"Warren County, PA",PA,2021,18026,16814,1212,6.7,-836
"Warren County, PA",PA,2020,18862,17332,1530,8.1,-288
"Warren County, PA",PA,2019,19150,18262,888,4.6,-112
"Warren County, PA",PA,2018,19262,18373,889,4.6,-219
"Warren County, PA",PA,2017,19481,18437,1044,5.4,-323
"Warren County, PA",PA,2016,19804,18732,1072,5.4,-158
"Warren County, PA",PA,2015,19962,18948,1014,5.1,-189
"Warren County, PA",PA,2014,20151,19075,1076,5.3,-210
"Warren County, PA",PA,2013,20361,19107,1254,6.2,-187
"Warren County, PA",PA,2012,20548,19173,1375,6.7,145
"Warren County, PA",PA,2011,20403,18904,1499,7.3,-427
"Warren County, PA",PA,2010,20830,19162,1668,8.0,0
"Warren County, TN",TN,2021,16806,16019,787,4.7,-426
"Warren County, TN",TN,2020,17232,15712,1520,8.8,238
"Warren County, TN",TN,2019,16994,16299,695,4.1,211
"Warren County, TN",TN,2018,16783,16116,667,4.0,-390
"Warren County, TN",TN,2017,17173,16494,679,4.0,-512
"Warren County, TN",TN,2016,17685,16832,853,4.8,-159
"Warren County, TN",TN,2015,17844,16846,998,5.6,387
"Warren County, TN",TN,2014,17457,16268,1189,6.8,-129
"Warren County, TN",TN,2013,17586,16088,1498,8.5,108
"Warren County, TN",TN,2012,17478,15918,1560,8.9,-415
"Warren County, TN",TN,2011,17893,16038,1855,10.4,124
"Warren County, TN",TN,2010,17769,15798,1971,11.1,0
"Warren County, VA",VA,2021,19936,19231,705,3.5,-410
"Warren County, VA",VA,2020,20346,19165,1181,5.8,-470
"Warren County, VA",VA,2019,20816,20236,580,2.8,444
"Warren County, VA",VA,2018,20372,19752,620,3.0,320
"Warren County, VA",VA,2017,20052,19315,737,3.7,327
"Warren County, VA",VA,2016,19725,18940,785,4.0,28
"Warren County, VA",VA,2015,19697,18773,924,4.7,-286
"Warren County, VA",VA,2014,19983,18878,1105,5.5,-108
"Warren County, VA",VA,2013,20091,18887,1204,6.0,63
"Warren County, VA",VA,2012,20028,18712,1316,6.6,-59
"Warren County, VA",VA,2011,20087,18604,1483,7.4,-50
"Warren County, VA",VA,2010,20137,18471,1666,8.3,0
"Warrick County, IN",IN,2021,31859,31028,831,2.6,41
"Warrick County, IN",IN,2020,31818,30074,1744,5.5,-1341
"Warrick County, IN",IN,2019,33159,32206,953,2.9,-97
"Warrick County, IN",IN,2018,33256,32290,966,2.9,590
"Warrick County, IN",IN,2017,32666,31650,1016,3.1,150
"Warrick County, IN",IN,2016,32516,31221,1295,4.0,765
"Warrick County, IN",IN,2015,31751,30469,1282,4.0,549
"Warrick County, IN",IN,2014,31202,29676,1526,4.9,433
"Warrick County, IN",IN,2013,30769,28869,1900,6.2,-77
"Warrick County, IN",IN,2012,30846,28781,2065,6.7,-355
"Warrick County, IN",IN,2011,31201,29035,2166,6.9,355
"Warrick County, IN",IN,2010,30846,28437,2409,7.8,0
"Wasatch County, UT",UT,2021,16903,16421,482,2.9,443
"Wasatch County, UT",UT,2020,16460,15398,1062,6.5,297
"Wasatch County, UT",UT,2019,16163,15726,437,2.7,904
"Wasatch County, UT",UT,2018,15259,14805,454,3.0,587
"Wasatch County, UT",UT,2017,14672,14201,471,3.2,819
"Wasatch County, UT",UT,2016,13853,13398,455,3.3,663
"Wasatch County, UT",UT,2015,13190,12736,454,3.4,581
"Wasatch County, UT",UT,2014,12609,12155,454,3.6,586
"Wasatch County, UT",UT,2013,12023,11508,515,4.3,585
"Wasatch County, UT",UT,2012,11438,10858,580,5.1,135
"Wasatch County, UT",UT,2011,11303,10479,824,7.3,-7
"Wasatch County, UT",UT,2010,11310,10348,962,8.5,0
"Wasco County, OR",OR,2021,13684,12968,716,5.2,232
"Wasco County, OR",OR,2020,13452,12498,954,7.1,97
"Wasco County, OR",OR,2019,13355,12815,540,4.0,103
"Wasco County, OR",OR,2018,13252,12704,548,4.1,-464
"Wasco County, OR",OR,2017,13716,13155,561,4.1,61
"Wasco County, OR",OR,2016,13655,13011,644,4.7,623
"Wasco County, OR",OR,2015,13032,12320,712,5.5,-623
"Wasco County, OR",OR,2014,13655,12775,880,6.4,-134
"Wasco County, OR",OR,2013,13789,12760,1029,7.5,-91
"Wasco County, OR",OR,2012,13880,12711,1169,8.4,-36
"Wasco County, OR",OR,2011,13916,12677,1239,8.9,182
"Wasco County, OR",OR,2010,13734,12410,1324,9.6,0
"Waseca County, MN",MN,2021,8665,8323,342,3.9,-524
"Waseca County, MN",MN,2020,9189,8599,590,6.4,54
"Waseca County, MN",MN,2019,9135,8760,375,4.1,115
"Waseca County, MN",MN,2018,9020,8628,392,4.3,-318
"Waseca County, MN",MN,2017,9338,8972,366,3.9,-123
"Waseca County, MN",MN,2016,9461,9055,406,4.3,-315
"Waseca County, MN",MN,2015,9776,9363,413,4.2,81
"Waseca County, MN",MN,2014,9695,9217,478,4.9,-242
"Waseca County, MN",MN,2013,9937,9382,555,5.6,-288
"Waseca County, MN",MN,2012,10225,9632,593,5.8,-380
"Waseca County, MN",MN,2011,10605,9935,670,6.3,21
"Waseca County, MN",MN,2010,10584,9791,793,7.5,0
"Washakie County, WY",WY,2021,3978,3819,159,4.0,33
"Washakie County, WY",WY,2020,3945,3739,206,5.2,67
"Washakie County, WY",WY,2019,3878,3717,161,4.2,-199
"Washakie County, WY",WY,2018,4077,3904,173,4.2,-48
"Washakie County, WY",WY,2017,4125,3954,171,4.1,-89
"Washakie County, WY",WY,2016,4214,4013,201,4.8,-19
"Washakie County, WY",WY,2015,4233,4058,175,4.1,5
"Washakie County, WY",WY,2014,4228,4036,192,4.5,-72
"Washakie County, WY",WY,2013,4300,4085,215,5.0,-135
"Washakie County, WY",WY,2012,4435,4198,237,5.3,-95
"Washakie County, WY",WY,2011,4530,4263,267,5.9,-36
"Washakie County, WY",WY,2010,4566,4276,290,6.4,0
"Washburn County, WI",WI,2021,7983,7621,362,4.5,105
"Washburn County, WI",WI,2020,7878,7334,544,6.9,28
"Washburn County, WI",WI,2019,7850,7546,304,3.9,-91
"Washburn County, WI",WI,2018,7941,7635,306,3.9,3
"Washburn County, WI",WI,2017,7938,7629,309,3.9,-14
"Washburn County, WI",WI,2016,7952,7566,386,4.9,17
"Washburn County, WI",WI,2015,7935,7519,416,5.2,14
"Washburn County, WI",WI,2014,7921,7435,486,6.1,-74
"Washburn County, WI",WI,2013,7995,7406,589,7.4,-82
"Washburn County, WI",WI,2012,8077,7449,628,7.8,114
"Washburn County, WI",WI,2011,7963,7271,692,8.7,-83
"Washburn County, WI",WI,2010,8046,7278,768,9.5,0
"Washington County, AL",AL,2021,6538,6233,305,4.7,-285
"Washington County, AL",AL,2020,6823,6219,604,8.9,15
"Washington County, AL",AL,2019,6808,6474,334,4.9,25
"Washington County, AL",AL,2018,6783,6392,391,5.8,11
"Washington County, AL",AL,2017,6772,6304,468,6.9,86
"Washington County, AL",AL,2016,6686,6109,577,8.6,1
"Washington County, AL",AL,2015,6685,6086,599,9.0,21
"Washington County, AL",AL,2014,6664,6028,636,9.5,-47
"Washington County, AL",AL,2013,6711,5972,739,11.0,-176
"Washington County, AL",AL,2012,6887,6046,841,12.2,-210
"Washington County, AL",AL,2011,7097,6073,1024,14.4,-280
"Washington County, AL",AL,2010,7377,6348,1029,13.9,0
"Washington County, AR",AR,2021,125728,122052,3676,2.9,349
"Washington County, AR",AR,2020,125379,119532,5847,4.7,379
"Washington County, AR",AR,2019,125000,121989,3011,2.4,2516
"Washington County, AR",AR,2018,122484,119317,3167,2.6,1816
"Washington County, AR",AR,2017,120668,117523,3145,2.6,2094
"Washington County, AR",AR,2016,118574,115300,3274,2.8,2841
"Washington County, AR",AR,2015,115733,111702,4031,3.5,4689
"Washington County, AR",AR,2014,111044,106301,4743,4.3,3523
"Washington County, AR",AR,2013,107521,101904,5617,5.2,1608
"Washington County, AR",AR,2012,105913,100201,5712,5.4,1508
"Washington County, AR",AR,2011,104405,98139,6266,6.0,1600
"Washington County, AR",AR,2010,102805,96374,6431,6.3,0
"Washington County, CO",CO,2021,2828,2738,90,3.2,-16
"Washington County, CO",CO,2020,2844,2759,85,3.0,-109
"Washington County, CO",CO,2019,2953,2898,55,1.9,-74
"Washington County, CO",CO,2018,3027,2957,70,2.3,25
"Washington County, CO",CO,2017,3002,2948,54,1.8,81
"Washington County, CO",CO,2016,2921,2861,60,2.1,135
"Washington County, CO",CO,2015,2786,2717,69,2.5,141
"Washington County, CO",CO,2014,2645,2562,83,3.1,96
"Washington County, CO",CO,2013,2549,2434,115,4.5,-78
"Washington County, CO",CO,2012,2627,2497,130,4.9,47
"Washington County, CO",CO,2011,2580,2434,146,5.7,1
"Washington County, CO",CO,2010,2579,2418,161,6.2,0
"Washington County, FL",FL,2021,9507,9079,428,4.5,69
"Washington County, FL",FL,2020,9438,8843,595,6.3,-187
"Washington County, FL",FL,2019,9625,9282,343,3.6,-56
"Washington County, FL",FL,2018,9681,9295,386,4.0,-28
"Washington County, FL",FL,2017,9709,9277,432,4.4,-23
"Washington County, FL",FL,2016,9732,9228,504,5.2,84
"Washington County, FL",FL,2015,9648,9068,580,6.0,-33
"Washington County, FL",FL,2014,9681,9010,671,6.9,-149
"Washington County, FL",FL,2013,9830,9040,790,8.0,-169
"Washington County, FL",FL,2012,9999,9090,909,9.1,-349
"Washington County, FL",FL,2011,10348,9316,1032,10.0,142
"Washington County, FL",FL,2010,10206,9166,1040,10.2,0
"Washington County, GA",GA,2021,6875,6532,343,5.0,-49
"Washington County, GA",GA,2020,6924,6483,441,6.4,-146
"Washington County, GA",GA,2019,7070,6765,305,4.3,-94
"Washington County, GA",GA,2018,7164,6801,363,5.1,-276
"Washington County, GA",GA,2017,7440,6998,442,5.9,256
"Washington County, GA",GA,2016,7184,6723,461,6.4,67
"Washington County, GA",GA,2015,7117,6611,506,7.1,-425
"Washington County, GA",GA,2014,7542,6929,613,8.1,-135
"Washington County, GA",GA,2013,7677,6942,735,9.6,-377
"Washington County, GA",GA,2012,8054,7233,821,10.2,-43
"Washington County, GA",GA,2011,8097,7075,1022,12.6,-53
"Washington County, GA",GA,2010,8150,6951,1199,14.7,0
"Washington County, IA",IA,2021,11446,11016,430,3.8,-38
"Washington County, IA",IA,2020,11484,11023,461,4.0,-756
"Washington County, IA",IA,2019,12240,11952,288,2.4,98
"Washington County, IA",IA,2018,12142,11855,287,2.4,-206
"Washington County, IA",IA,2017,12348,11992,356,2.9,-73
"Washington County, IA",IA,2016,12421,12060,361,2.9,29
"Washington County, IA",IA,2015,12392,12009,383,3.1,69
"Washington County, IA",IA,2014,12323,11881,442,3.6,34
"Washington County, IA",IA,2013,12289,11826,463,3.8,90
"Washington County, IA",IA,2012,12199,11684,515,4.2,-166
"Washington County, IA",IA,2011,12365,11775,590,4.8,-22
"Washington County, IA",IA,2010,12387,11745,642,5.2,0
"Washington County, ID",ID,2021,4838,4627,211,4.4,69
"Washington County, ID",ID,2020,4769,4505,264,5.5,122
"Washington County, ID",ID,2019,4647,4452,195,4.2,-9
"Washington County, ID",ID,2018,4656,4461,195,4.2,23
"Washington County, ID",ID,2017,4633,4416,217,4.7,38
"Washington County, ID",ID,2016,4595,4350,245,5.3,32
"Washington County, ID",ID,2015,4563,4316,247,5.4,7
"Washington County, ID",ID,2014,4556,4281,275,6.0,-257
"Washington County, ID",ID,2013,4813,4419,394,8.2,6
"Washington County, ID",ID,2012,4807,4391,416,8.7,78
"Washington County, ID",ID,2011,4729,4275,454,9.6,-6
"Washington County, ID",ID,2010,4735,4253,482,10.2,0
"Washington County, IL",IL,2021,9551,9264,287,3.0,23
"Washington County, IL",IL,2020,9528,9019,509,5.3,-495
"Washington County, IL",IL,2019,10023,9778,245,2.4,133
"Washington County, IL",IL,2018,9890,9601,289,2.9,319
"Washington County, IL",IL,2017,9571,9284,287,3.0,-115
"Washington County, IL",IL,2016,9686,9321,365,3.8,315
"Washington County, IL",IL,2015,9371,9016,355,3.8,352
"Washington County, IL",IL,2014,9019,8587,432,4.8,107
"Washington County, IL",IL,2013,8912,8361,551,6.2,-197
"Washington County, IL",IL,2012,9109,8528,581,6.4,395
"Washington County, IL",IL,2011,8714,8137,577,6.6,232
"Washington County, IL",IL,2010,8482,7861,621,7.3,0
"Washington County, IN",IN,2021,13510,13088,422,3.1,-48
"Washington County, IN",IN,2020,13558,12609,949,7.0,-285
"Washington County, IN",IN,2019,13843,13393,450,3.3,-3
"Washington County, IN",IN,2018,13846,13364,482,3.5,215
"Washington County, IN",IN,2017,13631,13129,502,3.7,-65
"Washington County, IN",IN,2016,13696,13078,618,4.5,195
"Washington County, IN",IN,2015,13501,12804,697,5.2,175
"Washington County, IN",IN,2014,13326,12441,885,6.6,165
"Washington County, IN",IN,2013,13161,12032,1129,8.6,-23
"Washington County, IN",IN,2012,13184,11956,1228,9.3,-356
"Washington County, IN",IN,2011,13540,12133,1407,10.4,-262
"Washington County, IN",IN,2010,13802,12157,1645,11.9,0
"Washington County, KS",KS,2021,3063,3010,53,1.7,-1
"Washington County, KS",KS,2020,3064,2993,71,2.3,122
"Washington County, KS",KS,2019,2942,2865,77,2.6,-4
"Washington County, KS",KS,2018,2946,2869,77,2.6,-20
"Washington County, KS",KS,2017,2966,2878,88,3.0,-131
"Washington County, KS",KS,2016,3097,2996,101,3.3,-40
"Washington County, KS",KS,2015,3137,3039,98,3.1,28
"Washington County, KS",KS,2014,3109,3010,99,3.2,-25
"Washington County, KS",KS,2013,3134,3017,117,3.7,-126
"Washington County, KS",KS,2012,3260,3125,135,4.1,-65
"Washington County, KS",KS,2011,3325,3176,149,4.5,-22
"Washington County, KS",KS,2010,3347,3187,160,4.8,0
"Washington County, KY",KY,2021,6177,5937,240,3.9,96
"Washington County, KY",KY,2020,6081,5710,371,6.1,-171
"Washington County, KY",KY,2019,6252,6020,232,3.7,116
"Washington County, KY",KY,2018,6136,5917,219,3.6,-44
"Washington County, KY",KY,2017,6180,5927,253,4.1,97
"Washington County, KY",KY,2016,6083,5825,258,4.2,129
"Washington County, KY",KY,2015,5954,5691,263,4.4,-172
"Washington County, KY",KY,2014,6126,5795,331,5.4,-15
"Washington County, KY",KY,2013,6141,5722,419,6.8,-73
"Washington County, KY",KY,2012,6214,5746,468,7.5,76
"Washington County, KY",KY,2011,6138,5572,566,9.2,18
"Washington County, KY",KY,2010,6120,5494,626,10.2,0
"Washington County, MD",MD,2021,72458,68574,3884,5.4,-562
"Washington County, MD",MD,2020,73020,68031,4989,6.8,-3133
"Washington County, MD",MD,2019,76153,73303,2850,3.7,390
"Washington County, MD",MD,2018,75763,72678,3085,4.1,-492
"Washington County, MD",MD,2017,76255,72847,3408,4.5,955
"Washington County, MD",MD,2016,75300,71575,3725,4.9,-1334
"Washington County, MD",MD,2015,76634,72415,4219,5.5,267
"Washington County, MD",MD,2014,76367,71498,4869,6.4,-842
"Washington County, MD",MD,2013,77209,71601,5608,7.3,26
"Washington County, MD",MD,2012,77183,71224,5959,7.7,684
"Washington County, MD",MD,2011,76499,69745,6754,8.8,569
"Washington County, MD",MD,2010,75930,68493,7437,9.8,0
"Washington County, ME",ME,2021,13452,12583,869,6.5,112
"Washington County, ME",ME,2020,13340,12574,766,5.7,-470
"Washington County, ME",ME,2019,13810,13228,582,4.2,-178
"Washington County, ME",ME,2018,13988,13351,637,4.6,-175
"Washington County, ME",ME,2017,14163,13450,713,5.0,121
"Washington County, ME",ME,2016,14042,13268,774,5.5,-43
"Washington County, ME",ME,2015,14085,13184,901,6.4,-327
"Washington County, ME",ME,2014,14412,13248,1164,8.1,-197
"Washington County, ME",ME,2013,14609,13250,1359,9.3,-77
"Washington County, ME",ME,2012,14686,13230,1456,9.9,-181
"Washington County, ME",ME,2011,14867,13330,1537,10.3,-150
"Washington County, ME",ME,2010,15017,13339,1678,11.2,0
"Washington County, MN",MN,2021,141988,137850,4138,2.9,-3954
"Washington County, MN",MN,2020,145942,137581,8361,5.7,-423
"Washington County, MN",MN,2019,146365,141973,4392,3.0,3118
"Washington County, MN",MN,2018,143247,139391,3856,2.7,1690
"Washington County, MN",MN,2017,141557,137267,4290,3.0,2824
"Washington County, MN",MN,2016,138733,134104,4629,3.3,1268
"Washington County, MN",MN,2015,137465,133023,4442,3.2,1119
"Washington County, MN",MN,2014,136346,131262,5084,3.7,1332
"Washington County, MN",MN,2013,135014,128944,6070,4.5,1176
"Washington County, MN",MN,2012,133838,126905,6933,5.2,492
"Washington County, MN",MN,2011,133346,125454,7892,5.9,1202
"Washington County, MN",MN,2010,132144,123252,8892,6.7,0
"Washington County, MO",MO,2021,10094,9578,516,5.1,17
"Washington County, MO",MO,2020,10077,9359,718,7.1,-92
"Washington County, MO",MO,2019,10169,9737,432,4.2,-20
"Washington County, MO",MO,2018,10189,9744,445,4.4,-107
"Washington County, MO",MO,2017,10296,9743,553,5.4,-35
"Washington County, MO",MO,2016,10331,9677,654,6.3,-132
"Washington County, MO",MO,2015,10463,9747,716,6.8,33
"Washington County, MO",MO,2014,10430,9534,896,8.6,-15
"Washington County, MO",MO,2013,10445,9420,1025,9.8,521
"Washington County, MO",MO,2012,9924,8841,1083,10.9,-174
"Washington County, MO",MO,2011,10098,8842,1256,12.4,-110
"Washington County, MO",MO,2010,10208,8756,1452,14.2,0
"Washington County, MS",MS,2021,15920,14613,1307,8.2,-272
"Washington County, MS",MS,2020,16192,14481,1711,10.6,-10
"Washington County, MS",MS,2019,16202,14927,1275,7.9,-1025
"Washington County, MS",MS,2018,17227,16030,1197,6.9,-495
"Washington County, MS",MS,2017,17722,16421,1301,7.3,31
"Washington County, MS",MS,2016,17691,16068,1623,9.2,-307
"Washington County, MS",MS,2015,17998,16125,1873,10.4,-317
"Washington County, MS",MS,2014,18315,15998,2317,12.7,-807
"Washington County, MS",MS,2013,19122,16358,2764,14.5,-1093
"Washington County, MS",MS,2012,20215,17333,2882,14.3,-988
"Washington County, MS",MS,2011,21203,17981,3222,15.2,246
"Washington County, MS",MS,2010,20957,17729,3228,15.4,0
"Washington County, NC",NC,2021,4273,3977,296,6.9,24
"Washington County, NC",NC,2020,4249,3914,335,7.9,-183
"Washington County, NC",NC,2019,4432,4181,251,5.7,-122
"Washington County, NC",NC,2018,4554,4280,274,6.0,-148
"Washington County, NC",NC,2017,4702,4392,310,6.6,-148
"Washington County, NC",NC,2016,4850,4490,360,7.4,-110
"Washington County, NC",NC,2015,4960,4534,426,8.6,-75
"Washington County, NC",NC,2014,5035,4564,471,9.4,-268
"Washington County, NC",NC,2013,5303,4660,643,12.1,381
"Washington County, NC",NC,2012,4922,4149,773,15.7,-95
"Washington County, NC",NC,2011,5017,4169,848,16.9,-694
"Washington County, NC",NC,2010,5711,4904,807,14.1,0
"Washington County, NE",NE,2021,11364,11102,262,2.3,96
"Washington County, NE",NE,2020,11268,10865,403,3.6,-102
"Washington County, NE",NE,2019,11370,11040,330,2.9,151
"Washington County, NE",NE,2018,11219,10895,324,2.9,-29
"Washington County, NE",NE,2017,11248,10895,353,3.1,79
"Washington County, NE",NE,2016,11169,10813,356,3.2,189
"Washington County, NE",NE,2015,10980,10651,329,3.0,-70
"Washington County, NE",NE,2014,11050,10696,354,3.2,-53
"Washington County, NE",NE,2013,11103,10704,399,3.6,-103
"Washington County, NE",NE,2012,11206,10795,411,3.7,-39
"Washington County, NE",NE,2011,11245,10755,490,4.4,28
"Washington County, NE",NE,2010,11217,10692,525,4.7,0
"Washington County, NY",NY,2021,27402,26147,1255,4.6,-176
"Washington County, NY",NY,2020,27578,25668,1910,6.9,-947
"Washington County, NY",NY,2019,28525,27411,1114,3.9,-11
"Washington County, NY",NY,2018,28536,27356,1180,4.1,-110
"Washington County, NY",NY,2017,28646,27325,1321,4.6,294
"Washington County, NY",NY,2016,28352,27012,1340,4.7,-253
"Washington County, NY",NY,2015,28605,27159,1446,5.1,75
"Washington County, NY",NY,2014,28530,26779,1751,6.1,-853
"Washington County, NY",NY,2013,29383,27135,2248,7.7,-474
"Washington County, NY",NY,2012,29857,27351,2506,8.4,85
"Washington County, NY",NY,2011,29772,27340,2432,8.2,-493
"Washington County, NY",NY,2010,30265,27716,2549,8.4,0
"Washington County, OH",OH,2021,26727,25250,1477,5.5,-81
"Washington County, OH",OH,2020,26808,24503,2305,8.6,-845
"Washington County, OH",OH,2019,27653,26159,1494,5.4,360
"Washington County, OH",OH,2018,27293,25764,1529,5.6,-160
"Washington County, OH",OH,2017,27453,25742,1711,6.2,-437
"Washington County, OH",OH,2016,27890,25931,1959,7.0,-262
"Washington County, OH",OH,2015,28152,26442,1710,6.1,-150
"Washington County, OH",OH,2014,28302,26493,1809,6.4,-45
"Washington County, OH",OH,2013,28347,25915,2432,8.6,-82
"Washington County, OH",OH,2012,28429,25970,2459,8.6,-537
"Washington County, OH",OH,2011,28966,26053,2913,10.1,-879
"Washington County, OH",OH,2010,29845,26429,3416,11.4,0
"Washington County, OK",OK,2021,22455,21609,846,3.8,296
"Washington County, OK",OK,2020,22159,20841,1318,5.9,-116
"Washington County, OK",OK,2019,22275,21552,723,3.2,-569
"Washington County, OK",OK,2018,22844,21988,856,3.7,-296
"Washington County, OK",OK,2017,23140,22152,988,4.3,-766
"Washington County, OK",OK,2016,23906,22779,1127,4.7,-530
"Washington County, OK",OK,2015,24436,23410,1026,4.2,-14
"Washington County, OK",OK,2014,24450,23447,1003,4.1,-148
"Washington County, OK",OK,2013,24598,23447,1151,4.7,114
"Washington County, OK",OK,2012,24484,23339,1145,4.7,354
"Washington County, OK",OK,2011,24130,22812,1318,5.5,21
"Washington County, OK",OK,2010,24109,22554,1555,6.4,0
"Washington County, OR",OR,2021,327487,313135,14352,4.4,6880
"Washington County, OR",OR,2020,320607,299729,20878,6.5,-3328
"Washington County, OR",OR,2019,323935,314045,9890,3.1,3788
"Washington County, OR",OR,2018,320147,309361,10786,3.4,1677
"Washington County, OR",OR,2017,318470,307517,10953,3.4,5759
"Washington County, OR",OR,2016,312711,300084,12627,4.0,10801
"Washington County, OR",OR,2015,301910,288084,13826,4.6,6876
"Washington County, OR",OR,2014,295034,278821,16213,5.5,5752
"Washington County, OR",OR,2013,289282,271317,17965,6.2,-3385
"Washington County, OR",OR,2012,292667,271984,20683,7.1,-1867
"Washington County, OR",OR,2011,294534,271637,22897,7.8,3843
"Washington County, OR",OR,2010,290691,264444,26247,9.0,0
"Washington County, PA",PA,2021,104785,97826,6959,6.6,-2020
"Washington County, PA",PA,2020,106805,96787,10018,9.4,-1554
"Washington County, PA",PA,2019,108359,103372,4987,4.6,871
"Washington County, PA",PA,2018,107488,102663,4825,4.5,147
"Washington County, PA",PA,2017,107341,101631,5710,5.3,-70
"Washington County, PA",PA,2016,107411,100914,6497,6.0,741
"Washington County, PA",PA,2015,106670,100616,6054,5.7,611
"Washington County, PA",PA,2014,106059,99879,6180,5.8,-583
"Washington County, PA",PA,2013,106642,99487,7155,6.7,-583
"Washington County, PA",PA,2012,107225,99685,7540,7.0,1541
"Washington County, PA",PA,2011,105684,98073,7611,7.2,720
"Washington County, PA",PA,2010,104964,96722,8242,7.9,0
"Washington County, RI",RI,2021,70167,66749,3418,4.9,1079
"Washington County, RI",RI,2020,69088,63803,5285,7.6,-1731
"Washington County, RI",RI,2019,70819,68609,2210,3.1,-318
"Washington County, RI",RI,2018,71137,68601,2536,3.6,499
"Washington County, RI",RI,2017,70638,67778,2860,4.0,1684
"Washington County, RI",RI,2016,68954,65674,3280,4.8,-441
"Washington County, RI",RI,2015,69395,65478,3917,5.6,-318
"Washington County, RI",RI,2014,69713,64662,5051,7.2,-385
"Washington County, RI",RI,2013,70098,63914,6184,8.8,-212
"Washington County, RI",RI,2012,70310,63628,6682,9.5,-405
"Washington County, RI",RI,2011,70715,63618,7097,10.0,-1398
"Washington County, RI",RI,2010,72113,64563,7550,10.5,0
"Washington County, TN",TN,2021,61172,59000,2172,3.6,859
"Washington County, TN",TN,2020,60313,56528,3785,6.3,-780
"Washington County, TN",TN,2019,61093,58994,2099,3.4,976
"Washington County, TN",TN,2018,60117,57993,2124,3.5,547
"Washington County, TN",TN,2017,59570,57321,2249,3.8,788
"Washington County, TN",TN,2016,58782,55964,2818,4.8,817
"Washington County, TN",TN,2015,57965,54767,3198,5.5,132
"Washington County, TN",TN,2014,57833,54177,3656,6.3,-1166
"Washington County, TN",TN,2013,58999,54756,4243,7.2,-1213
"Washington County, TN",TN,2012,60212,55872,4340,7.2,-927
"Washington County, TN",TN,2011,61139,56140,4999,8.2,423
"Washington County, TN",TN,2010,60716,55334,5382,8.9,0
"Washington County, TX",TX,2021,15187,14391,796,5.2,85
"Washington County, TX",TX,2020,15102,14249,853,5.6,104
"Washington County, TX",TX,2019,14998,14488,510,3.4,269
"Washington County, TX",TX,2018,14729,14190,539,3.7,-33
"Washington County, TX",TX,2017,14762,14134,628,4.3,-327
"Washington County, TX",TX,2016,15089,14320,769,5.1,-276
"Washington County, TX",TX,2015,15365,14628,737,4.8,-311
"Washington County, TX",TX,2014,15676,14946,730,4.7,-19
"Washington County, TX",TX,2013,15695,14829,866,5.5,87
"Washington County, TX",TX,2012,15608,14736,872,5.6,-63
"Washington County, TX",TX,2011,15671,14600,1071,6.8,90
"Washington County, TX",TX,2010,15581,14453,1128,7.2,0
"Washington County, UT",UT,2021,83600,81174,2426,2.9,3547
"Washington County, UT",UT,2020,80053,75746,4307,5.4,3267
"Washington County, UT",UT,2019,76786,74521,2265,2.9,2115
"Washington County, UT",UT,2018,74671,72265,2406,3.2,3628
"Washington County, UT",UT,2017,71043,68646,2397,3.4,4036
"Washington County, UT",UT,2016,67007,64578,2429,3.6,3679
"Washington County, UT",UT,2015,63328,60796,2532,4.0,2360
"Washington County, UT",UT,2014,60968,58414,2554,4.2,2503
"Washington County, UT",UT,2013,58465,55503,2962,5.1,2367
"Washington County, UT",UT,2012,56098,52679,3419,6.1,421
"Washington County, UT",UT,2011,55677,50517,5160,9.3,-874
"Washington County, UT",UT,2010,56551,50540,6011,10.6,0
"Washington County, VA",VA,2021,25246,24344,902,3.6,-728
"Washington County, VA",VA,2020,25974,24474,1500,5.8,-685
"Washington County, VA",VA,2019,26659,25776,883,3.3,-269
"Washington County, VA",VA,2018,26928,26027,901,3.3,-153
"Washington County, VA",VA,2017,27081,25980,1101,4.1,200
"Washington County, VA",VA,2016,26881,25687,1194,4.4,-202
"Washington County, VA",VA,2015,27083,25804,1279,4.7,-629
"Washington County, VA",VA,2014,27712,26146,1566,5.7,-130
"Washington County, VA",VA,2013,27842,26111,1731,6.2,116
"Washington County, VA",VA,2012,27726,25896,1830,6.6,-126
"Washington County, VA",VA,2011,27852,25878,1974,7.1,397
"Washington County, VA",VA,2010,27455,25226,2229,8.1,0
"Washington County, VT",VT,2021,32392,31416,976,3.0,-1625
"Washington County, VT",VT,2020,34017,32354,1663,4.9,-1731
"Washington County, VT",VT,2019,35748,34948,800,2.2,118
"Washington County, VT",VT,2018,35630,34721,909,2.6,415
"Washington County, VT",VT,2017,35215,34178,1037,2.9,1201
"Washington County, VT",VT,2016,34014,32965,1049,3.1,-222
"Washington County, VT",VT,2015,34236,33055,1181,3.4,-176
"Washington County, VT",VT,2014,34412,33067,1345,3.9,-143
"Washington County, VT",VT,2013,34555,33064,1491,4.3,11
"Washington County, VT",VT,2012,34544,32961,1583,4.6,-275
"Washington County, VT",VT,2011,34819,32962,1857,5.3,-324
"Washington County, VT",VT,2010,35143,32995,2148,6.1,0
"Washington County, WI",WI,2021,77152,74781,2371,3.1,330
"Washington County, WI",WI,2020,76822,72478,4344,5.7,-870
"Washington County, WI",WI,2019,77692,75579,2113,2.7,-143
"Washington County, WI",WI,2018,77835,75867,1968,2.5,-130
"Washington County, WI",WI,2017,77965,75813,2152,2.8,953
"Washington County, WI",WI,2016,77012,74493,2519,3.3,1122
"Washington County, WI",WI,2015,75890,73109,2781,3.7,202
"Washington County, WI",WI,2014,75688,72299,3389,4.5,444
"Washington County, WI",WI,2013,75244,70976,4268,5.7,263
"Washington County, WI",WI,2012,74981,70463,4518,6.0,-134
"Washington County, WI",WI,2011,75115,70108,5007,6.7,-537
"Washington County, WI",WI,2010,75652,69648,6004,7.9,0
"Washington Parish, LA",LA,2021,16870,15882,988,5.9,258
"Washington Parish, LA",LA,2020,16612,15165,1447,8.7,-231
"Washington Parish, LA",LA,2019,16843,15888,955,5.7,-36
"Washington Parish, LA",LA,2018,16879,15918,961,5.7,-74
"Washington Parish, LA",LA,2017,16953,15975,978,5.8,-13
"Washington Parish, LA",LA,2016,16966,15773,1193,7.0,-8
"Washington Parish, LA",LA,2015,16974,15687,1287,7.6,90
"Washington Parish, LA",LA,2014,16884,15582,1302,7.7,469
"Washington Parish, LA",LA,2013,16415,15098,1317,8.0,-124
"Washington Parish, LA",LA,2012,16539,15147,1392,8.4,-121
"Washington Parish, LA",LA,2011,16660,15158,1502,9.0,-426
"Washington Parish, LA",LA,2010,17086,15533,1553,9.1,0
"Washita County, OK",OK,2021,4963,4749,214,4.3,-119
"Washita County, OK",OK,2020,5082,4735,347,6.8,-62
"Washita County, OK",OK,2019,5144,4980,164,3.2,-112
"Washita County, OK",OK,2018,5256,5103,153,2.9,-94
"Washita County, OK",OK,2017,5350,5126,224,4.2,39
"Washita County, OK",OK,2016,5311,4956,355,6.7,-290
"Washita County, OK",OK,2015,5601,5297,304,5.4,0
"Washita County, OK",OK,2014,5601,5416,185,3.3,32
"Washita County, OK",OK,2013,5569,5343,226,4.1,-57
"Washita County, OK",OK,2012,5626,5409,217,3.9,127
"Washita County, OK",OK,2011,5499,5264,235,4.3,46
"Washita County, OK",OK,2010,5453,5134,319,5.8,0
"Washoe County, NV",NV,2021,252682,241797,10885,4.3,4830
"Washoe County, NV",NV,2020,247852,227627,20225,8.2,-7363
"Washoe County, NV",NV,2019,255215,246719,8496,3.3,7310
"Washoe County, NV",NV,2018,247905,239242,8663,3.5,11444
"Washoe County, NV",NV,2017,236461,226656,9805,4.1,8470
"Washoe County, NV",NV,2016,227991,216417,11574,5.1,4599
"Washoe County, NV",NV,2015,223392,209279,14113,6.3,2822
"Washoe County, NV",NV,2014,220570,203367,17203,7.8,646
"Washoe County, NV",NV,2013,219924,198371,21553,9.8,461
"Washoe County, NV",NV,2012,219463,194330,25133,11.5,-156
"Washoe County, NV",NV,2011,219619,191407,28212,12.8,-1221
"Washoe County, NV",NV,2010,220840,191887,28953,13.1,0
"Washtenaw County, MI",MI,2021,189511,181350,8161,4.3,-3610
"Washtenaw County, MI",MI,2020,193121,180109,13012,6.7,-5794
"Washtenaw County, MI",MI,2019,198915,193127,5788,2.9,2638
"Washtenaw County, MI",MI,2018,196277,190241,6036,3.1,1961
"Washtenaw County, MI",MI,2017,194316,187585,6731,3.5,2316
"Washtenaw County, MI",MI,2016,192000,184914,7086,3.7,2699
"Washtenaw County, MI",MI,2015,189301,182177,7124,3.8,1685
"Washtenaw County, MI",MI,2014,187616,178470,9146,4.9,3110
"Washtenaw County, MI",MI,2013,184506,173862,10644,5.8,2128
"Washtenaw County, MI",MI,2012,182378,171675,10703,5.9,1731
"Washtenaw County, MI",MI,2011,180647,168847,11800,6.5,-657
"Washtenaw County, MI",MI,2010,181304,167031,14273,7.9,0
"Watauga County, NC",NC,2021,28395,27356,1039,3.7,1308
"Watauga County, NC",NC,2020,27087,25442,1645,6.1,-2157
"Watauga County, NC",NC,2019,29244,28244,1000,3.4,746
"Watauga County, NC",NC,2018,28498,27484,1014,3.6,335
"Watauga County, NC",NC,2017,28163,27018,1145,4.1,302
"Watauga County, NC",NC,2016,27861,26608,1253,4.5,496
"Watauga County, NC",NC,2015,27365,26056,1309,4.8,322
"Watauga County, NC",NC,2014,27043,25683,1360,5.0,24
"Watauga County, NC",NC,2013,27019,25339,1680,6.2,-257
"Watauga County, NC",NC,2012,27276,25213,2063,7.6,129
"Watauga County, NC",NC,2011,27147,25010,2137,7.9,157
"Watauga County, NC",NC,2010,26990,24894,2096,7.8,0
"Watonwan County, MN",MN,2021,6396,6204,192,3.0,-301
"Watonwan County, MN",MN,2020,6697,6376,321,4.8,113
"Watonwan County, MN",MN,2019,6584,6301,283,4.3,31
"Watonwan County, MN",MN,2018,6553,6311,242,3.7,23
"Watonwan County, MN",MN,2017,6530,6245,285,4.4,-43
"Watonwan County, MN",MN,2016,6573,6253,320,4.9,305
"Watonwan County, MN",MN,2015,6268,5968,300,4.8,93
"Watonwan County, MN",MN,2014,6175,5864,311,5.0,-11
"Watonwan County, MN",MN,2013,6186,5855,331,5.4,-106
"Watonwan County, MN",MN,2012,6292,5936,356,5.7,11
"Watonwan County, MN",MN,2011,6281,5882,399,6.4,-35
"Watonwan County, MN",MN,2010,6316,5853,463,7.3,0
"Waukesha County, WI",WI,2021,225548,218557,6991,3.1,1372
"Waukesha County, WI",WI,2020,224176,211634,12542,5.6,-2160
"Waukesha County, WI",WI,2019,226336,220051,6285,2.8,-160
"Waukesha County, WI",WI,2018,226496,220529,5967,2.6,-291
"Waukesha County, WI",WI,2017,226787,220266,6521,2.9,2507
"Waukesha County, WI",WI,2016,224280,216710,7570,3.4,3389
"Waukesha County, WI",WI,2015,220891,212689,8202,3.7,547
"Waukesha County, WI",WI,2014,220344,210721,9623,4.4,1357
"Waukesha County, WI",WI,2013,218987,207001,11986,5.5,1602
"Waukesha County, WI",WI,2012,217385,205067,12318,5.7,45
"Waukesha County, WI",WI,2011,217340,203655,13685,6.3,-857
"Waukesha County, WI",WI,2010,218197,202455,15742,7.2,0
"Waupaca County, WI",WI,2021,26182,25262,920,3.5,382
"Waupaca County, WI",WI,2020,25800,24368,1432,5.6,-215
"Waupaca County, WI",WI,2019,26015,25207,808,3.1,-330
"Waupaca County, WI",WI,2018,26345,25575,770,2.9,-330
"Waupaca County, WI",WI,2017,26675,25833,842,3.2,-227
"Waupaca County, WI",WI,2016,26902,25864,1038,3.9,-68
"Waupaca County, WI",WI,2015,26970,25748,1222,4.5,-317
"Waupaca County, WI",WI,2014,27287,25765,1522,5.6,-58
"Waupaca County, WI",WI,2013,27345,25362,1983,7.3,-6
"Waupaca County, WI",WI,2012,27351,25310,2041,7.5,-284
"Waupaca County, WI",WI,2011,27635,25392,2243,8.1,-113
"Waupaca County, WI",WI,2010,27748,25180,2568,9.3,0
"Waushara County, WI",WI,2021,11394,10913,481,4.2,278
"Waushara County, WI",WI,2020,11116,10404,712,6.4,-354
"Waushara County, WI",WI,2019,11470,11026,444,3.9,-171
"Waushara County, WI",WI,2018,11641,11240,401,3.4,196
"Waushara County, WI",WI,2017,11445,10994,451,3.9,-2
"Waushara County, WI",WI,2016,11447,10886,561,4.9,-7
"Waushara County, WI",WI,2015,11454,10751,703,6.1,-146
"Waushara County, WI",WI,2014,11600,10782,818,7.1,-222
"Waushara County, WI",WI,2013,11822,10816,1006,8.5,-178
"Waushara County, WI",WI,2012,12000,10968,1032,8.6,116
"Waushara County, WI",WI,2011,11884,10749,1135,9.6,-144
"Waushara County, WI",WI,2010,12028,10755,1273,10.6,0
"Wayne County, GA",GA,2021,11919,11473,446,3.7,362
"Wayne County, GA",GA,2020,11557,10916,641,5.5,22
"Wayne County, GA",GA,2019,11535,11054,481,4.2,110
"Wayne County, GA",GA,2018,11425,10886,539,4.7,-42
"Wayne County, GA",GA,2017,11467,10808,659,5.7,171
"Wayne County, GA",GA,2016,11296,10512,784,6.9,-143
"Wayne County, GA",GA,2015,11439,10596,843,7.4,-375
"Wayne County, GA",GA,2014,11814,10777,1037,8.8,-459
"Wayne County, GA",GA,2013,12273,11083,1190,9.7,-288
"Wayne County, GA",GA,2012,12561,11239,1322,10.5,91
"Wayne County, GA",GA,2011,12470,10973,1497,12.0,58
"Wayne County, GA",GA,2010,12412,10900,1512,12.2,0
"Wayne County, IA",IA,2021,2817,2714,103,3.7,9
"Wayne County, IA",IA,2020,2808,2686,122,4.3,-67
"Wayne County, IA",IA,2019,2875,2803,72,2.5,67
"Wayne County, IA",IA,2018,2808,2731,77,2.7,5
"Wayne County, IA",IA,2017,2803,2718,85,3.0,-53
"Wayne County, IA",IA,2016,2856,2749,107,3.7,6
"Wayne County, IA",IA,2015,2850,2739,111,3.9,-22
"Wayne County, IA",IA,2014,2872,2728,144,5.0,18
"Wayne County, IA",IA,2013,2854,2706,148,5.2,50
"Wayne County, IA",IA,2012,2804,2651,153,5.5,-32
"Wayne County, IA",IA,2011,2836,2676,160,5.6,-33
"Wayne County, IA",IA,2010,2869,2689,180,6.3,0
"Wayne County, IL",IL,2021,6766,6449,317,4.7,6
"Wayne County, IL",IL,2020,6760,6190,570,8.4,-242
"Wayne County, IL",IL,2019,7002,6683,319,4.6,77
"Wayne County, IL",IL,2018,6925,6544,381,5.5,-35
"Wayne County, IL",IL,2017,6960,6531,429,6.2,-372
"Wayne County, IL",IL,2016,7332,6707,625,8.5,-183
"Wayne County, IL",IL,2015,7515,6996,519,6.9,-155
"Wayne County, IL",IL,2014,7670,7159,511,6.7,-205
"Wayne County, IL",IL,2013,7875,7266,609,7.7,-121
"Wayne County, IL",IL,2012,7996,7379,617,7.7,-209
"Wayne County, IL",IL,2011,8205,7546,659,8.0,-176
"Wayne County, IL",IL,2010,8381,7629,752,9.0,0
"Wayne County, IN",IN,2021,29433,28379,1054,3.6,-692
"Wayne County, IN",IN,2020,30125,28071,2054,6.8,-919
"Wayne County, IN",IN,2019,31044,29957,1087,3.5,-254
"Wayne County, IN",IN,2018,31298,30188,1110,3.5,452
"Wayne County, IN",IN,2017,30846,29701,1145,3.7,-134
"Wayne County, IN",IN,2016,30980,29514,1466,4.7,339
"Wayne County, IN",IN,2015,30641,29022,1619,5.3,-292
"Wayne County, IN",IN,2014,30933,28924,2009,6.5,355
"Wayne County, IN",IN,2013,30578,27976,2602,8.5,-133
"Wayne County, IN",IN,2012,30711,27716,2995,9.8,-335
"Wayne County, IN",IN,2011,31046,27666,3380,10.9,-269
"Wayne County, IN",IN,2010,31315,27398,3917,12.5,0
"Wayne County, KY",KY,2021,7410,7035,375,5.1,66
"Wayne County, KY",KY,2020,7344,6883,461,6.3,-107
"Wayne County, KY",KY,2019,7451,7044,407,5.5,-120
"Wayne County, KY",KY,2018,7571,7058,513,6.8,164
"Wayne County, KY",KY,2017,7407,6842,565,7.6,148
"Wayne County, KY",KY,2016,7259,6708,551,7.6,231
"Wayne County, KY",KY,2015,7028,6461,567,8.1,-231
"Wayne County, KY",KY,2014,7259,6559,700,9.6,-201
"Wayne County, KY",KY,2013,7460,6579,881,11.8,-279
"Wayne County, KY",KY,2012,7739,6730,1009,13.0,-166
"Wayne County, KY",KY,2011,7905,6782,1123,14.2,-352
"Wayne County, KY",KY,2010,8257,7088,1169,14.2,0
"Wayne County, MI",MI,2021,797703,734140,63563,8.0,-3679
"Wayne County, MI",MI,2020,801382,693025,108357,13.5,-15763
"Wayne County, MI",MI,2019,817145,776312,40833,5.0,8757
"Wayne County, MI",MI,2018,808388,766155,42233,5.2,7448
"Wayne County, MI",MI,2017,800940,756569,44371,5.5,22001
"Wayne County, MI",MI,2016,778939,730549,48390,6.2,22631
"Wayne County, MI",MI,2015,756308,704576,51732,6.8,-11332
"Wayne County, MI",MI,2014,767640,694103,73537,9.6,-10687
"Wayne County, MI",MI,2013,778327,689531,88796,11.4,4740
"Wayne County, MI",MI,2012,773587,683411,90176,11.7,2900
"Wayne County, MI",MI,2011,770687,674201,96486,12.5,-25057
"Wayne County, MI",MI,2010,795744,676615,119129,15.0,0
"Wayne County, MO",MO,2021,4838,4595,243,5.0,-179
"Wayne County, MO",MO,2020,5017,4711,306,6.1,-205
"Wayne County, MO",MO,2019,5222,4983,239,4.6,-106
"Wayne County, MO",MO,2018,5328,5076,252,4.7,-206
"Wayne County, MO",MO,2017,5534,5255,279,5.0,-119
"Wayne County, MO",MO,2016,5653,5351,302,5.3,-32
"Wayne County, MO",MO,2015,5685,5344,341,6.0,50
"Wayne County, MO",MO,2014,5635,5213,422,7.5,11
"Wayne County, MO",MO,2013,5624,5155,469,8.3,328
"Wayne County, MO",MO,2012,5296,4803,493,9.3,-179
"Wayne County, MO",MO,2011,5475,4909,566,10.3,-66
"Wayne County, MO",MO,2010,5541,4948,593,10.7,0
"Wayne County, MS",MS,2021,7335,6842,493,6.7,-46
"Wayne County, MS",MS,2020,7381,6752,629,8.5,-148
"Wayne County, MS",MS,2019,7529,7069,460,6.1,218
"Wayne County, MS",MS,2018,7311,6900,411,5.6,-62
"Wayne County, MS",MS,2017,7373,6893,480,6.5,-130
"Wayne County, MS",MS,2016,7503,6943,560,7.5,-96
"Wayne County, MS",MS,2015,7599,6990,609,8.0,-113
"Wayne County, MS",MS,2014,7712,7022,690,8.9,-184
"Wayne County, MS",MS,2013,7896,7055,841,10.7,-632
"Wayne County, MS",MS,2012,8528,7597,931,10.9,-233
"Wayne County, MS",MS,2011,8761,7783,978,11.2,117
"Wayne County, MS",MS,2010,8644,7628,1016,11.8,0
"Wayne County, NC",NC,2021,50451,47916,2535,5.0,744
"Wayne County, NC",NC,2020,49707,46620,3087,6.2,-1771
"Wayne County, NC",NC,2019,51478,49392,2086,4.1,-357
"Wayne County, NC",NC,2018,51835,49569,2266,4.4,-809
"Wayne County, NC",NC,2017,52644,49994,2650,5.0,-746
"Wayne County, NC",NC,2016,53390,50274,3116,5.8,-282
"Wayne County, NC",NC,2015,53672,50458,3214,6.0,-189
"Wayne County, NC",NC,2014,53861,50510,3351,6.2,-1015
"Wayne County, NC",NC,2013,54876,50734,4142,7.5,-966
"Wayne County, NC",NC,2012,55842,50996,4846,8.7,661
"Wayne County, NC",NC,2011,55181,50194,4987,9.0,151
"Wayne County, NC",NC,2010,55030,50031,4999,9.1,0
"Wayne County, NE",NE,2021,5737,5627,110,1.9,22
"Wayne County, NE",NE,2020,5715,5557,158,2.8,-117
"Wayne County, NE",NE,2019,5832,5680,152,2.6,85
"Wayne County, NE",NE,2018,5747,5603,144,2.5,41
"Wayne County, NE",NE,2017,5706,5568,138,2.4,50
"Wayne County, NE",NE,2016,5656,5506,150,2.7,93
"Wayne County, NE",NE,2015,5563,5421,142,2.6,-8
"Wayne County, NE",NE,2014,5571,5416,155,2.8,-100
"Wayne County, NE",NE,2013,5671,5495,176,3.1,-46
"Wayne County, NE",NE,2012,5717,5538,179,3.1,107
"Wayne County, NE",NE,2011,5610,5416,194,3.5,-52
"Wayne County, NE",NE,2010,5662,5443,219,3.9,0
"Wayne County, NY",NY,2021,42847,40936,1911,4.5,-715
"Wayne County, NY",NY,2020,43562,40462,3100,7.1,-1375
"Wayne County, NY",NY,2019,44937,43203,1734,3.9,226
"Wayne County, NY",NY,2018,44711,42870,1841,4.1,241
"Wayne County, NY",NY,2017,44470,42273,2197,4.9,460
"Wayne County, NY",NY,2016,44010,41779,2231,5.1,-207
"Wayne County, NY",NY,2015,44217,41844,2373,5.4,-136
"Wayne County, NY",NY,2014,44353,41591,2762,6.2,-1563
"Wayne County, NY",NY,2013,45916,42348,3568,7.8,-544
"Wayne County, NY",NY,2012,46460,42421,4039,8.7,-37
"Wayne County, NY",NY,2011,46497,42565,3932,8.5,-955
"Wayne County, NY",NY,2010,47452,43191,4261,9.0,0
"Wayne County, OH",OH,2021,60229,58061,2168,3.6,-70
"Wayne County, OH",OH,2020,60299,56754,3545,5.9,-2309
"Wayne County, OH",OH,2019,62608,60558,2050,3.3,1203
"Wayne County, OH",OH,2018,61405,59201,2204,3.6,-609
"Wayne County, OH",OH,2017,62014,59600,2414,3.9,554
"Wayne County, OH",OH,2016,61460,58995,2465,4.0,1271
"Wayne County, OH",OH,2015,60189,57793,2396,4.0,506
"Wayne County, OH",OH,2014,59683,56913,2770,4.6,399
"Wayne County, OH",OH,2013,59284,55600,3684,6.2,206
"Wayne County, OH",OH,2012,59078,55467,3611,6.1,50
"Wayne County, OH",OH,2011,59028,54508,4520,7.7,-1204
"Wayne County, OH",OH,2010,60232,54612,5620,9.3,0
"Wayne County, PA",PA,2021,22379,20898,1481,6.6,-12
"Wayne County, PA",PA,2020,22391,20338,2053,9.2,-342
"Wayne County, PA",PA,2019,22733,21628,1105,4.9,94
"Wayne County, PA",PA,2018,22639,21527,1112,4.9,16
"Wayne County, PA",PA,2017,22623,21448,1175,5.2,59
"Wayne County, PA",PA,2016,22564,21282,1282,5.7,282
"Wayne County, PA",PA,2015,22282,20960,1322,5.9,-44
"Wayne County, PA",PA,2014,22326,20876,1450,6.5,-309
"Wayne County, PA",PA,2013,22635,20911,1724,7.6,-438
"Wayne County, PA",PA,2012,23073,21254,1819,7.9,-154
"Wayne County, PA",PA,2011,23227,21384,1843,7.9,-314
"Wayne County, PA",PA,2010,23541,21690,1851,7.9,0
"Wayne County, TN",TN,2021,6286,6031,255,4.1,-70
"Wayne County, TN",TN,2020,6356,5924,432,6.8,36
"Wayne County, TN",TN,2019,6320,6028,292,4.6,162
"Wayne County, TN",TN,2018,6158,5861,297,4.8,29
"Wayne County, TN",TN,2017,6129,5807,322,5.3,36
"Wayne County, TN",TN,2016,6093,5691,402,6.6,-105
"Wayne County, TN",TN,2015,6198,5743,455,7.3,-271
"Wayne County, TN",TN,2014,6469,5904,565,8.7,-86
"Wayne County, TN",TN,2013,6555,5924,631,9.6,-98
"Wayne County, TN",TN,2012,6653,6013,640,9.6,-144
"Wayne County, TN",TN,2011,6797,6056,741,10.9,-145
"Wayne County, TN",TN,2010,6942,6137,805,11.6,0
"Wayne County, UT",UT,2021,1506,1435,71,4.7,57
"Wayne County, UT",UT,2020,1449,1338,111,7.7,13
"Wayne County, UT",UT,2019,1436,1359,77,5.4,-3
"Wayne County, UT",UT,2018,1439,1357,82,5.7,-26
"Wayne County, UT",UT,2017,1465,1361,104,7.1,46
"Wayne County, UT",UT,2016,1419,1312,107,7.5,14
"Wayne County, UT",UT,2015,1405,1280,125,8.9,36
"Wayne County, UT",UT,2014,1369,1246,123,9.0,17
"Wayne County, UT",UT,2013,1352,1216,136,10.1,31
"Wayne County, UT",UT,2012,1321,1195,126,9.5,-100
"Wayne County, UT",UT,2011,1421,1273,148,10.4,-149
"Wayne County, UT",UT,2010,1570,1433,137,8.7,0
"Wayne County, WV",WV,2021,15573,14771,802,5.1,3
"Wayne County, WV",WV,2020,15570,14287,1283,8.2,-206
"Wayne County, WV",WV,2019,15776,14920,856,5.4,22
"Wayne County, WV",WV,2018,15754,14829,925,5.9,73
"Wayne County, WV",WV,2017,15681,14768,913,5.8,99
"Wayne County, WV",WV,2016,15582,14552,1030,6.6,-169
"Wayne County, WV",WV,2015,15751,14657,1094,6.9,-255
"Wayne County, WV",WV,2014,16006,14927,1079,6.7,-55
"Wayne County, WV",WV,2013,16061,14960,1101,6.9,-329
"Wayne County, WV",WV,2012,16390,15187,1203,7.3,-102
"Wayne County, WV",WV,2011,16492,15185,1307,7.9,-424
"Wayne County, WV",WV,2010,16916,15472,1444,8.5,0
"Waynesboro city, VA",VA,2021,10298,9873,425,4.1,-352
"Waynesboro city, VA",VA,2020,10650,9949,701,6.6,-176
"Waynesboro city, VA",VA,2019,10826,10517,309,2.9,201
"Waynesboro city, VA",VA,2018,10625,10285,340,3.2,105
"Waynesboro city, VA",VA,2017,10520,10103,417,4.0,315
"Waynesboro city, VA",VA,2016,10205,9788,417,4.1,155
"Waynesboro city, VA",VA,2015,10050,9576,474,4.7,-54
"Waynesboro city, VA",VA,2014,10104,9574,530,5.2,74
"Waynesboro city, VA",VA,2013,10030,9437,593,5.9,6
"Waynesboro city, VA",VA,2012,10024,9333,691,6.9,-137
"Waynesboro city, VA",VA,2011,10161,9342,819,8.1,-28
"Waynesboro city, VA",VA,2010,10189,9250,939,9.2,0
"Weakley County, TN",TN,2021,15461,14878,583,3.8,-6
"Weakley County, TN",TN,2020,15467,14587,880,5.7,-670
"Weakley County, TN",TN,2019,16137,15487,650,4.0,145
"Weakley County, TN",TN,2018,15992,15317,675,4.2,211
"Weakley County, TN",TN,2017,15781,15014,767,4.9,-94
"Weakley County, TN",TN,2016,15875,14944,931,5.9,251
"Weakley County, TN",TN,2015,15624,14570,1054,6.7,-291
"Weakley County, TN",TN,2014,15915,14548,1367,8.6,-658
"Weakley County, TN",TN,2013,16573,14861,1712,10.3,-355
"Weakley County, TN",TN,2012,16928,15051,1877,11.1,254
"Weakley County, TN",TN,2011,16674,14747,1927,11.6,-276
"Weakley County, TN",TN,2010,16950,15056,1894,11.2,0
"Webb County, TX",TX,2021,116373,109033,7340,6.3,1187
"Webb County, TX",TX,2020,115186,105441,9745,8.5,-1877
"Webb County, TX",TX,2019,117063,112721,4342,3.7,1889
"Webb County, TX",TX,2018,115174,110797,4377,3.8,913
"Webb County, TX",TX,2017,114261,109410,4851,4.2,364
"Webb County, TX",TX,2016,113897,108314,5583,4.9,2060
"Webb County, TX",TX,2015,111837,106503,5334,4.8,804
"Webb County, TX",TX,2014,111033,105313,5720,5.2,888
"Webb County, TX",TX,2013,110145,103340,6805,6.2,1266
"Webb County, TX",TX,2012,108879,101867,7012,6.4,1035
"Webb County, TX",TX,2011,107844,99571,8273,7.7,2655
"Webb County, TX",TX,2010,105189,96457,8732,8.3,0
"Weber County, UT",UT,2021,131718,127926,3792,2.9,1711
"Weber County, UT",UT,2020,130007,123701,6306,4.9,1443
"Weber County, UT",UT,2019,128564,124818,3746,2.9,2590
"Weber County, UT",UT,2018,125974,121848,4126,3.3,2181
"Weber County, UT",UT,2017,123793,119400,4393,3.5,4122
"Weber County, UT",UT,2016,119671,115214,4457,3.7,3061
"Weber County, UT",UT,2015,116610,111928,4682,4.0,2732
"Weber County, UT",UT,2014,113878,109106,4772,4.2,1028
"Weber County, UT",UT,2013,112850,107237,5613,5.0,1689
"Weber County, UT",UT,2012,111161,104929,6232,5.6,-531
"Weber County, UT",UT,2011,111692,102575,9117,8.2,-1035
"Weber County, UT",UT,2010,112727,102717,10010,8.9,0
"Webster County, GA",GA,2021,992,948,44,4.4,-23
"Webster County, GA",GA,2020,1015,958,57,5.6,-14
"Webster County, GA",GA,2019,1029,977,52,5.1,28
"Webster County, GA",GA,2018,1001,938,63,6.3,-3
"Webster County, GA",GA,2017,1004,928,76,7.6,37
"Webster County, GA",GA,2016,967,883,84,8.7,10
"Webster County, GA",GA,2015,957,866,91,9.5,-56
"Webster County, GA",GA,2014,1013,926,87,8.6,-21
"Webster County, GA",GA,2013,1034,939,95,9.2,-24
"Webster County, GA",GA,2012,1058,954,104,9.8,-8
"Webster County, GA",GA,2011,1066,944,122,11.4,19
"Webster County, GA",GA,2010,1047,910,137,13.1,0
"Webster County, IA",IA,2021,18473,17617,856,4.6,-306
"Webster County, IA",IA,2020,18779,17815,964,5.1,-1034
"Webster County, IA",IA,2019,19813,19228,585,3.0,380
"Webster County, IA",IA,2018,19433,18802,631,3.2,-118
"Webster County, IA",IA,2017,19551,18833,718,3.7,-987
"Webster County, IA",IA,2016,20538,19725,813,4.0,185
"Webster County, IA",IA,2015,20353,19483,870,4.3,526
"Webster County, IA",IA,2014,19827,18870,957,4.8,43
"Webster County, IA",IA,2013,19784,18730,1054,5.3,424
"Webster County, IA",IA,2012,19360,18129,1231,6.4,-511
"Webster County, IA",IA,2011,19871,18458,1413,7.1,-229
"Webster County, IA",IA,2010,20100,18678,1422,7.1,0
"Webster County, KY",KY,2021,5344,5103,241,4.5,-66
"Webster County, KY",KY,2020,5410,5073,337,6.2,-341
"Webster County, KY",KY,2019,5751,5532,219,3.8,-23
"Webster County, KY",KY,2018,5774,5537,237,4.1,-35
"Webster County, KY",KY,2017,5809,5512,297,5.1,-25
"Webster County, KY",KY,2016,5834,5487,347,5.9,-124
"Webster County, KY",KY,2015,5958,5650,308,5.2,-333
"Webster County, KY",KY,2014,6291,5950,341,5.4,106
"Webster County, KY",KY,2013,6185,5748,437,7.1,-70
"Webster County, KY",KY,2012,6255,5808,447,7.1,28
"Webster County, KY",KY,2011,6227,5728,499,8.0,75
"Webster County, KY",KY,2010,6152,5565,587,9.5,0
"Webster County, MO",MO,2021,17409,16811,598,3.4,211
"Webster County, MO",MO,2020,17198,16286,912,5.3,-121
"Webster County, MO",MO,2019,17319,16734,585,3.4,371
"Webster County, MO",MO,2018,16948,16430,518,3.1,136
"Webster County, MO",MO,2017,16812,16163,649,3.9,-71
"Webster County, MO",MO,2016,16883,16054,829,4.9,330
"Webster County, MO",MO,2015,16553,15694,859,5.2,310
"Webster County, MO",MO,2014,16243,15257,986,6.1,377
"Webster County, MO",MO,2013,15866,14784,1082,6.8,30
"Webster County, MO",MO,2012,15836,14674,1162,7.3,-268
"Webster County, MO",MO,2011,16104,14638,1466,9.1,-210
"Webster County, MO",MO,2010,16314,14608,1706,10.5,0
"Webster County, MS",MS,2021,3941,3729,212,5.4,104
"Webster County, MS",MS,2020,3837,3559,278,7.2,-126
"Webster County, MS",MS,2019,3963,3736,227,5.7,66
"Webster County, MS",MS,2018,3897,3698,199,5.1,31
"Webster County, MS",MS,2017,3866,3657,209,5.4,-23
"Webster County, MS",MS,2016,3889,3640,249,6.4,-39
"Webster County, MS",MS,2015,3928,3642,286,7.3,-23
"Webster County, MS",MS,2014,3951,3610,341,8.6,-119
"Webster County, MS",MS,2013,4070,3685,385,9.5,-207
"Webster County, MS",MS,2012,4277,3894,383,9.0,-132
"Webster County, MS",MS,2011,4409,3960,449,10.2,30
"Webster County, MS",MS,2010,4379,3889,490,11.2,0
"Webster County, NE",NE,2021,1660,1626,34,2.0,-3
"Webster County, NE",NE,2020,1663,1602,61,3.7,-28
"Webster County, NE",NE,2019,1691,1633,58,3.4,29
"Webster County, NE",NE,2018,1662,1614,48,2.9,-16
"Webster County, NE",NE,2017,1678,1628,50,3.0,-44
"Webster County, NE",NE,2016,1722,1668,54,3.1,-10
"Webster County, NE",NE,2015,1732,1671,61,3.5,2
"Webster County, NE",NE,2014,1730,1672,58,3.4,-11
"Webster County, NE",NE,2013,1741,1675,66,3.8,-2
"Webster County, NE",NE,2012,1743,1681,62,3.6,7
"Webster County, NE",NE,2011,1736,1656,80,4.6,32
"Webster County, NE",NE,2010,1704,1620,84,4.9,0
"Webster County, WV",WV,2021,3241,3041,200,6.2,-24
"Webster County, WV",WV,2020,3265,2965,300,9.2,-51
"Webster County, WV",WV,2019,3316,3107,209,6.3,114
"Webster County, WV",WV,2018,3202,3001,201,6.3,-117
"Webster County, WV",WV,2017,3319,3109,210,6.3,-183
"Webster County, WV",WV,2016,3502,3209,293,8.4,-10
"Webster County, WV",WV,2015,3512,3253,259,7.4,41
"Webster County, WV",WV,2014,3471,3178,293,8.4,-46
"Webster County, WV",WV,2013,3517,3159,358,10.2,-81
"Webster County, WV",WV,2012,3598,3227,371,10.3,-29
"Webster County, WV",WV,2011,3627,3295,332,9.2,-109
"Webster County, WV",WV,2010,3736,3356,380,10.2,0
"Webster Parish, LA",LA,2021,14001,13235,766,5.5,53
"Webster Parish, LA",LA,2020,13948,12771,1177,8.4,-523
"Webster Parish, LA",LA,2019,14471,13620,851,5.9,-170
"Webster Parish, LA",LA,2018,14641,13758,883,6.0,-143
"Webster Parish, LA",LA,2017,14784,13771,1013,6.9,-434
"Webster Parish, LA",LA,2016,15218,13919,1299,8.5,-299
"Webster Parish, LA",LA,2015,15517,14157,1360,8.8,-88
"Webster Parish, LA",LA,2014,15605,14268,1337,8.6,-95
"Webster Parish, LA",LA,2013,15700,14255,1445,9.2,-437
"Webster Parish, LA",LA,2012,16137,14653,1484,9.2,-474
"Webster Parish, LA",LA,2011,16611,15017,1594,9.6,-183
"Webster Parish, LA",LA,2010,16794,15145,1649,9.8,0
"Weld County, CO",CO,2021,165660,156182,9478,5.7,820
"Weld County, CO",CO,2020,164840,153943,10897,6.6,-3042
"Weld County, CO",CO,2019,167882,163792,4090,2.4,4473
"Weld County, CO",CO,2018,163409,158866,4543,2.8,7042
"Weld County, CO",CO,2017,156367,152480,3887,2.5,6426
"Weld County, CO",CO,2016,149941,145047,4894,3.3,2163
"Weld County, CO",CO,2015,147778,142298,5480,3.7,2435
"Weld County, CO",CO,2014,145343,138877,6466,4.4,6348
"Weld County, CO",CO,2013,138995,130021,8974,6.5,2515
"Weld County, CO",CO,2012,136480,125752,10728,7.9,2520
"Weld County, CO",CO,2011,133960,122063,11897,8.9,2465
"Weld County, CO",CO,2010,131495,118861,12634,9.6,0
"Wells County, IN",IN,2021,13851,13496,355,2.6,-20
"Wells County, IN",IN,2020,13871,13059,812,5.9,-617
"Wells County, IN",IN,2019,14488,14099,389,2.7,72
"Wells County, IN",IN,2018,14416,14015,401,2.8,298
"Wells County, IN",IN,2017,14118,13705,413,2.9,-65
"Wells County, IN",IN,2016,14183,13685,498,3.5,148
"Wells County, IN",IN,2015,14035,13489,546,3.9,270
"Wells County, IN",IN,2014,13765,13107,658,4.8,89
"Wells County, IN",IN,2013,13676,12825,851,6.2,-49
"Wells County, IN",IN,2012,13725,12755,970,7.1,-359
"Wells County, IN",IN,2011,14084,12948,1136,8.1,-60
"Wells County, IN",IN,2010,14144,12798,1346,9.5,0
"Wells County, ND",ND,2021,1896,1816,80,4.2,-22
"Wells County, ND",ND,2020,1918,1835,83,4.3,-1
"Wells County, ND",ND,2019,1919,1866,53,2.8,-103
"Wells County, ND",ND,2018,2022,1965,57,2.8,-147
"Wells County, ND",ND,2017,2169,2099,70,3.2,-16
"Wells County, ND",ND,2016,2185,2101,84,3.8,30
"Wells County, ND",ND,2015,2155,2069,86,4.0,-13
"Wells County, ND",ND,2014,2168,2075,93,4.3,-20
"Wells County, ND",ND,2013,2188,2094,94,4.3,-25
"Wells County, ND",ND,2012,2213,2129,84,3.8,-90
"Wells County, ND",ND,2011,2303,2206,97,4.2,-30
"Wells County, ND",ND,2010,2333,2241,92,3.9,0
"West Baton Rouge Parish, LA",LA,2021,13611,12949,662,4.9,122
"West Baton Rouge Parish, LA",LA,2020,13489,12461,1028,7.6,-231
"West Baton Rouge Parish, LA",LA,2019,13720,13120,600,4.4,-17
"West Baton Rouge Parish, LA",LA,2018,13737,13138,599,4.4,229
"West Baton Rouge Parish, LA",LA,2017,13508,12889,619,4.6,252
"West Baton Rouge Parish, LA",LA,2016,13256,12549,707,5.3,50
"West Baton Rouge Parish, LA",LA,2015,13206,12472,734,5.6,377
"West Baton Rouge Parish, LA",LA,2014,12829,12098,731,5.7,529
"West Baton Rouge Parish, LA",LA,2013,12300,11576,724,5.9,337
"West Baton Rouge Parish, LA",LA,2012,11963,11177,786,6.6,-6
"West Baton Rouge Parish, LA",LA,2011,11969,11086,883,7.4,52
"West Baton Rouge Parish, LA",LA,2010,11917,11032,885,7.4,0
"West Carroll Parish, LA",LA,2021,3508,3286,222,6.3,-148
"West Carroll Parish, LA",LA,2020,3656,3262,394,10.8,11
"West Carroll Parish, LA",LA,2019,3645,3271,374,10.3,-368
"West Carroll Parish, LA",LA,2018,4013,3657,356,8.9,8
"West Carroll Parish, LA",LA,2017,4005,3613,392,9.8,-103
"West Carroll Parish, LA",LA,2016,4108,3617,491,12.0,4
"West Carroll Parish, LA",LA,2015,4104,3556,548,13.4,-116
"West Carroll Parish, LA",LA,2014,4220,3679,541,12.8,-18
"West Carroll Parish, LA",LA,2013,4238,3719,519,12.2,72
"West Carroll Parish, LA",LA,2012,4166,3623,543,13.0,-97
"West Carroll Parish, LA",LA,2011,4263,3618,645,15.1,-162
"West Carroll Parish, LA",LA,2010,4425,3742,683,15.4,0
"West Feliciana Parish, LA",LA,2021,5253,5060,193,3.7,84
"West Feliciana Parish, LA",LA,2020,5169,4869,300,5.8,-269
"West Feliciana Parish, LA",LA,2019,5438,5223,215,4.0,28
"West Feliciana Parish, LA",LA,2018,5410,5200,210,3.9,74
"West Feliciana Parish, LA",LA,2017,5336,5114,222,4.2,2
"West Feliciana Parish, LA",LA,2016,5334,5058,276,5.2,-50
"West Feliciana Parish, LA",LA,2015,5384,5102,282,5.2,47
"West Feliciana Parish, LA",LA,2014,5337,5039,298,5.6,104
"West Feliciana Parish, LA",LA,2013,5233,4935,298,5.7,77
"West Feliciana Parish, LA",LA,2012,5156,4858,298,5.8,-4
"West Feliciana Parish, LA",LA,2011,5160,4837,323,6.3,-77
"West Feliciana Parish, LA",LA,2010,5237,4905,332,6.3,0
"Westchester County, NY",NY,2021,480109,457009,23100,4.8,-5636
"Westchester County, NY",NY,2020,485745,446883,38862,8.0,-11849
"Westchester County, NY",NY,2019,497594,479626,17968,3.6,5193
"Westchester County, NY",NY,2018,492401,473384,19017,3.9,2725
"Westchester County, NY",NY,2017,489676,467736,21940,4.5,11713
"Westchester County, NY",NY,2016,477963,457115,20848,4.4,331
"Westchester County, NY",NY,2015,477632,455780,21852,4.6,7626
"Westchester County, NY",NY,2014,470006,445694,24312,5.2,-6993
"Westchester County, NY",NY,2013,476999,446382,30617,6.4,264
"Westchester County, NY",NY,2012,476735,441625,35110,7.4,2574
"Westchester County, NY",NY,2011,474161,440360,33801,7.1,-4895
"Westchester County, NY",NY,2010,479056,443099,35957,7.5,0
"Westmoreland County, PA",PA,2021,175353,164272,11081,6.3,-3420
"Westmoreland County, PA",PA,2020,178773,162500,16273,9.1,-4036
"Westmoreland County, PA",PA,2019,182809,174387,8422,4.6,823
"Westmoreland County, PA",PA,2018,181986,173627,8359,4.6,-478
"Westmoreland County, PA",PA,2017,182464,172856,9608,5.3,-600
"Westmoreland County, PA",PA,2016,183064,172471,10593,5.8,75
"Westmoreland County, PA",PA,2015,182989,172937,10052,5.5,-42
"Westmoreland County, PA",PA,2014,183031,172387,10644,5.8,-2724
"Westmoreland County, PA",PA,2013,185755,173182,12573,6.8,-1500
"Westmoreland County, PA",PA,2012,187255,173745,13510,7.2,1707
"Westmoreland County, PA",PA,2011,185548,171833,13715,7.4,824
"Westmoreland County, PA",PA,2010,184724,169950,14774,8.0,0
"Westmoreland County, VA",VA,2021,9508,9087,421,4.4,-19
"Westmoreland County, VA",VA,2020,9527,8972,555,5.8,-107
"Westmoreland County, VA",VA,2019,9634,9300,334,3.5,171
"Westmoreland County, VA",VA,2018,9463,9120,343,3.6,19
"Westmoreland County, VA",VA,2017,9444,9027,417,4.4,455
"Westmoreland County, VA",VA,2016,8989,8584,405,4.5,35
"Westmoreland County, VA",VA,2015,8954,8478,476,5.3,-88
"Westmoreland County, VA",VA,2014,9042,8468,574,6.3,-57
"Westmoreland County, VA",VA,2013,9099,8489,610,6.7,-37
"Westmoreland County, VA",VA,2012,9136,8485,651,7.1,-252
"Westmoreland County, VA",VA,2011,9388,8684,704,7.5,195
"Westmoreland County, VA",VA,2010,9193,8432,761,8.3,0
"Weston County, WY",WY,2021,3741,3622,119,3.2,-48
"Weston County, WY",WY,2020,3789,3645,144,3.8,-4
"Weston County, WY",WY,2019,3793,3679,114,3.0,7
"Weston County, WY",WY,2018,3786,3652,134,3.5,21
"Weston County, WY",WY,2017,3765,3611,154,4.1,-195
"Weston County, WY",WY,2016,3960,3761,199,5.0,30
"Weston County, WY",WY,2015,3930,3798,132,3.4,5
"Weston County, WY",WY,2014,3925,3789,136,3.5,26
"Weston County, WY",WY,2013,3899,3758,141,3.6,-26
"Weston County, WY",WY,2012,3925,3761,164,4.2,14
"Weston County, WY",WY,2011,3911,3723,188,4.8,-81
"Weston County, WY",WY,2010,3992,3784,208,5.2,0
"Wetzel County, WV",WV,2021,6698,6249,449,6.7,201
"Wetzel County, WV",WV,2020,6497,5858,639,9.8,-132
"Wetzel County, WV",WV,2019,6629,6148,481,7.3,4
"Wetzel County, WV",WV,2018,6625,6157,468,7.1,-155
"Wetzel County, WV",WV,2017,6780,6267,513,7.6,-445
"Wetzel County, WV",WV,2016,7225,6557,668,9.2,-13
"Wetzel County, WV",WV,2015,7238,6531,707,9.8,-86
"Wetzel County, WV",WV,2014,7324,6586,738,10.1,35
"Wetzel County, WV",WV,2013,7289,6633,656,9.0,30
"Wetzel County, WV",WV,2012,7259,6602,657,9.1,223
"Wetzel County, WV",WV,2011,7036,6309,727,10.3,27
"Wetzel County, WV",WV,2010,7009,6184,825,11.8,0
"Wexford County, MI",MI,2021,14561,13694,867,6.0,-305
"Wexford County, MI",MI,2020,14866,13293,1573,10.6,4
"Wexford County, MI",MI,2019,14862,14179,683,4.6,123
"Wexford County, MI",MI,2018,14739,14043,696,4.7,-39
"Wexford County, MI",MI,2017,14778,13966,812,5.5,37
"Wexford County, MI",MI,2016,14741,13868,873,5.9,93
"Wexford County, MI",MI,2015,14648,13647,1001,6.8,-76
"Wexford County, MI",MI,2014,14724,13463,1261,8.6,49
"Wexford County, MI",MI,2013,14675,13063,1612,11.0,152
"Wexford County, MI",MI,2012,14523,12943,1580,10.9,-87
"Wexford County, MI",MI,2011,14610,12900,1710,11.7,-449
"Wexford County, MI",MI,2010,15059,12950,2109,14.0,0
"Wharton County, TX",TX,2021,21120,19914,1206,5.7,-41
"Wharton County, TX",TX,2020,21161,19724,1437,6.8,-248
"Wharton County, TX",TX,2019,21409,20683,726,3.4,329
"Wharton County, TX",TX,2018,21080,20291,789,3.7,136
"Wharton County, TX",TX,2017,20944,19996,948,4.5,-136
"Wharton County, TX",TX,2016,21080,20018,1062,5.0,-158
"Wharton County, TX",TX,2015,21238,20294,944,4.4,-304
"Wharton County, TX",TX,2014,21542,20524,1018,4.7,77
"Wharton County, TX",TX,2013,21465,20175,1290,6.0,81
"Wharton County, TX",TX,2012,21384,19946,1438,6.7,-108
"Wharton County, TX",TX,2011,21492,19661,1831,8.5,183
"Wharton County, TX",TX,2010,21309,19450,1859,8.7,0
"Whatcom County, WA",WA,2021,113751,106929,6822,6.0,-3222
"Whatcom County, WA",WA,2020,116973,106333,10640,9.1,338
"Whatcom County, WA",WA,2019,116635,110694,5941,5.1,4315
"Whatcom County, WA",WA,2018,112320,107001,5319,4.7,1828
"Whatcom County, WA",WA,2017,110492,105060,5432,4.9,3279
"Whatcom County, WA",WA,2016,107213,101059,6154,5.7,2927
"Whatcom County, WA",WA,2015,104286,98270,6016,5.8,3127
"Whatcom County, WA",WA,2014,101159,94713,6446,6.4,-898
"Whatcom County, WA",WA,2013,102057,94643,7414,7.3,-715
"Whatcom County, WA",WA,2012,102772,95113,7659,7.5,1003
"Whatcom County, WA",WA,2011,101769,93557,8212,8.1,-532
"Whatcom County, WA",WA,2010,102301,93541,8760,8.6,0
"Wheatland County, MT",MT,2021,760,720,40,5.3,-2
"Wheatland County, MT",MT,2020,762,709,53,7.0,-11
"Wheatland County, MT",MT,2019,773,744,29,3.8,-34
"Wheatland County, MT",MT,2018,807,767,40,5.0,18
"Wheatland County, MT",MT,2017,789,754,35,4.4,-8
"Wheatland County, MT",MT,2016,797,755,42,5.3,9
"Wheatland County, MT",MT,2015,788,744,44,5.6,5
"Wheatland County, MT",MT,2014,783,744,39,5.0,-43
"Wheatland County, MT",MT,2013,826,775,51,6.2,-12
"Wheatland County, MT",MT,2012,838,787,51,6.1,2
"Wheatland County, MT",MT,2011,836,772,64,7.7,-25
"Wheatland County, MT",MT,2010,861,794,67,7.8,0
"Wheeler County, GA",GA,2021,1637,1547,90,5.5,26
"Wheeler County, GA",GA,2020,1611,1495,116,7.2,-67
"Wheeler County, GA",GA,2019,1678,1552,126,7.5,7
"Wheeler County, GA",GA,2018,1671,1547,124,7.4,-85
"Wheeler County, GA",GA,2017,1756,1598,158,9.0,22
"Wheeler County, GA",GA,2016,1734,1576,158,9.1,58
"Wheeler County, GA",GA,2015,1676,1491,185,11.0,-188
"Wheeler County, GA",GA,2014,1864,1633,231,12.4,-29
"Wheeler County, GA",GA,2013,1893,1655,238,12.6,-58
"Wheeler County, GA",GA,2012,1951,1694,257,13.2,-27
"Wheeler County, GA",GA,2011,1978,1688,290,14.7,34
"Wheeler County, GA",GA,2010,1944,1646,298,15.3,0
"Wheeler County, NE",NE,2021,563,556,7,1.2,-6
"Wheeler County, NE",NE,2020,569,559,10,1.8,-4
"Wheeler County, NE",NE,2019,573,558,15,2.6,-6
"Wheeler County, NE",NE,2018,579,565,14,2.4,-10
"Wheeler County, NE",NE,2017,589,576,13,2.2,20
"Wheeler County, NE",NE,2016,569,557,12,2.1,5
"Wheeler County, NE",NE,2015,564,551,13,2.3,5
"Wheeler County, NE",NE,2014,559,543,16,2.9,35
"Wheeler County, NE",NE,2013,524,507,17,3.2,3
"Wheeler County, NE",NE,2012,521,504,17,3.3,-3
"Wheeler County, NE",NE,2011,524,507,17,3.2,10
"Wheeler County, NE",NE,2010,514,494,20,3.9,0
"Wheeler County, OR",OR,2021,726,702,24,3.3,32
"Wheeler County, OR",OR,2020,694,664,30,4.3,-15
"Wheeler County, OR",OR,2019,709,679,30,4.2,-7
"Wheeler County, OR",OR,2018,716,692,24,3.4,-13
"Wheeler County, OR",OR,2017,729,701,28,3.8,45
"Wheeler County, OR",OR,2016,684,656,28,4.1,-8
"Wheeler County, OR",OR,2015,692,657,35,5.1,-42
"Wheeler County, OR",OR,2014,734,689,45,6.1,-3
"Wheeler County, OR",OR,2013,737,691,46,6.2,-48
"Wheeler County, OR",OR,2012,785,731,54,6.9,17
"Wheeler County, OR",OR,2011,768,702,66,8.6,-11
"Wheeler County, OR",OR,2010,779,704,75,9.6,0
"Wheeler County, TX",TX,2021,2066,1937,129,6.2,-108
"Wheeler County, TX",TX,2020,2174,2042,132,6.1,-63
"Wheeler County, TX",TX,2019,2237,2170,67,3.0,-166
"Wheeler County, TX",TX,2018,2403,2327,76,3.2,68
"Wheeler County, TX",TX,2017,2335,2242,93,4.0,-149
"Wheeler County, TX",TX,2016,2484,2366,118,4.8,-338
"Wheeler County, TX",TX,2015,2822,2712,110,3.9,-254
"Wheeler County, TX",TX,2014,3076,2965,111,3.6,-54
"Wheeler County, TX",TX,2013,3130,2994,136,4.3,242
"Wheeler County, TX",TX,2012,2888,2763,125,4.3,36
"Wheeler County, TX",TX,2011,2852,2706,146,5.1,116
"Wheeler County, TX",TX,2010,2736,2568,168,6.1,0
"White County, AR",AR,2021,33712,32361,1351,4.0,-308
"White County, AR",AR,2020,34020,31880,2140,6.3,83
"White County, AR",AR,2019,33937,32452,1485,4.4,333
"White County, AR",AR,2018,33604,32156,1448,4.3,-24
"White County, AR",AR,2017,33628,32090,1538,4.6,-464
"White County, AR",AR,2016,34092,32318,1774,5.2,-589
"White County, AR",AR,2015,34681,32557,2124,6.1,-39
"White County, AR",AR,2014,34720,32332,2388,6.9,-584
"White County, AR",AR,2013,35304,32619,2685,7.6,-1128
"White County, AR",AR,2012,36432,33682,2750,7.5,-213
"White County, AR",AR,2011,36645,33620,3025,8.3,236
"White County, AR",AR,2010,36409,33516,2893,7.9,0
"White County, GA",GA,2021,16616,16194,422,2.5,369
"White County, GA",GA,2020,16247,15545,702,4.3,-336
"White County, GA",GA,2019,16583,16118,465,2.8,385
"White County, GA",GA,2018,16198,15699,499,3.1,344
"White County, GA",GA,2017,15854,15237,617,3.9,1373
"White County, GA",GA,2016,14481,13801,680,4.7,856
"White County, GA",GA,2015,13625,12906,719,5.3,-187
"White County, GA",GA,2014,13812,12950,862,6.2,35
"White County, GA",GA,2013,13777,12766,1011,7.3,253
"White County, GA",GA,2012,13524,12371,1153,8.5,382
"White County, GA",GA,2011,13142,11848,1294,9.8,201
"White County, GA",GA,2010,12941,11603,1338,10.3,0
"White County, IL",IL,2021,5956,5660,296,5.0,-128
"White County, IL",IL,2020,6084,5605,479,7.9,-543
"White County, IL",IL,2019,6627,6381,246,3.7,-109
"White County, IL",IL,2018,6736,6450,286,4.2,43
"White County, IL",IL,2017,6693,6363,330,4.9,-226
"White County, IL",IL,2016,6919,6464,455,6.6,-22
"White County, IL",IL,2015,6941,6542,399,5.7,-129
"White County, IL",IL,2014,7070,6652,418,5.9,48
"White County, IL",IL,2013,7022,6485,537,7.6,-224
"White County, IL",IL,2012,7246,6695,551,7.6,-174
"White County, IL",IL,2011,7420,6833,587,7.9,-149
"White County, IL",IL,2010,7569,6920,649,8.6,0
"White County, IN",IN,2021,13117,12775,342,2.6,-51
"White County, IN",IN,2020,13168,12492,676,5.1,-447
"White County, IN",IN,2019,13615,13254,361,2.7,-86
"White County, IN",IN,2018,13701,13286,415,3.0,352
"White County, IN",IN,2017,13349,12915,434,3.3,-309
"White County, IN",IN,2016,13658,13122,536,3.9,49
"White County, IN",IN,2015,13609,13059,550,4.0,148
"White County, IN",IN,2014,13461,12780,681,5.1,506
"White County, IN",IN,2013,12955,12081,874,6.7,-87
"White County, IN",IN,2012,13042,12039,1003,7.7,-100
"White County, IN",IN,2011,13142,12027,1115,8.5,162
"White County, IN",IN,2010,12980,11651,1329,10.2,0
"White County, TN",TN,2021,11843,11379,464,3.9,-225
"White County, TN",TN,2020,12068,11221,847,7.0,-254
"White County, TN",TN,2019,12322,11866,456,3.7,40
"White County, TN",TN,2018,12282,11840,442,3.6,367
"White County, TN",TN,2017,11915,11440,475,4.0,145
"White County, TN",TN,2016,11770,11182,588,5.0,332
"White County, TN",TN,2015,11438,10750,688,6.0,-23
"White County, TN",TN,2014,11461,10609,852,7.4,-447
"White County, TN",TN,2013,11908,10784,1124,9.4,-291
"White County, TN",TN,2012,12199,10988,1211,9.9,-255
"White County, TN",TN,2011,12454,11209,1245,10.0,110
"White County, TN",TN,2010,12344,11024,1320,10.7,0
"White Pine County, NV",NV,2021,4628,4487,141,3.0,86
"White Pine County, NV",NV,2020,4542,4350,192,4.2,-130
"White Pine County, NV",NV,2019,4672,4530,142,3.0,126
"White Pine County, NV",NV,2018,4546,4385,161,3.5,122
"White Pine County, NV",NV,2017,4424,4244,180,4.1,-24
"White Pine County, NV",NV,2016,4448,4238,210,4.7,-237
"White Pine County, NV",NV,2015,4685,4429,256,5.5,-108
"White Pine County, NV",NV,2014,4793,4492,301,6.3,-31
"White Pine County, NV",NV,2013,4824,4455,369,7.6,-195
"White Pine County, NV",NV,2012,5019,4620,399,7.9,-22
"White Pine County, NV",NV,2011,5041,4593,448,8.9,405
"White Pine County, NV",NV,2010,4636,4207,429,9.3,0
"Whiteside County, IL",IL,2021,27339,26015,1324,4.8,-279
"Whiteside County, IL",IL,2020,27618,25367,2251,8.2,-1141
"Whiteside County, IL",IL,2019,28759,27593,1166,4.1,107
"Whiteside County, IL",IL,2018,28652,27371,1281,4.5,424
"Whiteside County, IL",IL,2017,28228,26869,1359,4.8,-623
"Whiteside County, IL",IL,2016,28851,27177,1674,5.8,284
"Whiteside County, IL",IL,2015,28567,26796,1771,6.2,-9
"Whiteside County, IL",IL,2014,28576,26581,1995,7.0,-784
"Whiteside County, IL",IL,2013,29360,26809,2551,8.7,-9
"Whiteside County, IL",IL,2012,29369,26773,2596,8.8,-278
"Whiteside County, IL",IL,2011,29647,26843,2804,9.5,-195
"Whiteside County, IL",IL,2010,29842,26748,3094,10.4,0
"Whitfield County, GA",GA,2021,43361,41664,1697,3.9,251
"Whitfield County, GA",GA,2020,43110,40013,3097,7.2,-868
"Whitfield County, GA",GA,2019,43978,41941,2037,4.6,-1138
"Whitfield County, GA",GA,2018,45116,42939,2177,4.8,-258
"Whitfield County, GA",GA,2017,45374,42883,2491,5.5,632
"Whitfield County, GA",GA,2016,44742,41968,2774,6.2,-342
"Whitfield County, GA",GA,2015,45084,42154,2930,6.5,422
"Whitfield County, GA",GA,2014,44662,41146,3516,7.9,64
"Whitfield County, GA",GA,2013,44598,40363,4235,9.5,-981
"Whitfield County, GA",GA,2012,45579,40804,4775,10.5,-1762
"Whitfield County, GA",GA,2011,47341,41802,5539,11.7,-430
"Whitfield County, GA",GA,2010,47771,42030,5741,12.0,0
"Whitley County, IN",IN,2021,17253,16793,460,2.7,-19
"Whitley County, IN",IN,2020,17272,16233,1039,6.0,-461
"Whitley County, IN",IN,2019,17733,17211,522,2.9,37
"Whitley County, IN",IN,2018,17696,17194,502,2.8,413
"Whitley County, IN",IN,2017,17283,16781,502,2.9,31
"Whitley County, IN",IN,2016,17252,16591,661,3.8,236
"Whitley County, IN",IN,2015,17016,16322,694,4.1,166
"Whitley County, IN",IN,2014,16850,15984,866,5.1,60
"Whitley County, IN",IN,2013,16790,15640,1150,6.8,-126
"Whitley County, IN",IN,2012,16916,15591,1325,7.8,-446
"Whitley County, IN",IN,2011,17362,15777,1585,9.1,-240
"Whitley County, IN",IN,2010,17602,15630,1972,11.2,0
"Whitley County, KY",KY,2021,14007,13309,698,5.0,216
"Whitley County, KY",KY,2020,13791,12841,950,6.9,-37
"Whitley County, KY",KY,2019,13828,13156,672,4.9,97
"Whitley County, KY",KY,2018,13731,13058,673,4.9,-32
"Whitley County, KY",KY,2017,13763,12984,779,5.7,414
"Whitley County, KY",KY,2016,13349,12480,869,6.5,232
"Whitley County, KY",KY,2015,13117,12235,882,6.7,-289
"Whitley County, KY",KY,2014,13406,12241,1165,8.7,-442
"Whitley County, KY",KY,2013,13848,12395,1453,10.5,-39
"Whitley County, KY",KY,2012,13887,12400,1487,10.7,-46
"Whitley County, KY",KY,2011,13933,12262,1671,12.0,-267
"Whitley County, KY",KY,2010,14200,12397,1803,12.7,0
"Whitman County, WA",WA,2021,22366,21370,996,4.5,176
"Whitman County, WA",WA,2020,22190,20921,1269,5.7,-2243
"Whitman County, WA",WA,2019,24433,23347,1086,4.4,746
"Whitman County, WA",WA,2018,23687,22652,1035,4.4,264
"Whitman County, WA",WA,2017,23423,22413,1010,4.3,291
"Whitman County, WA",WA,2016,23132,21989,1143,4.9,365
"Whitman County, WA",WA,2015,22767,21694,1073,4.7,635
"Whitman County, WA",WA,2014,22132,21009,1123,5.1,-73
"Whitman County, WA",WA,2013,22205,20894,1311,5.9,-167
"Whitman County, WA",WA,2012,22372,21024,1348,6.0,6
"Whitman County, WA",WA,2011,22366,21068,1298,5.8,255
"Whitman County, WA",WA,2010,22111,20772,1339,6.1,0
"Wibaux County, MT",MT,2021,423,407,16,3.8,-27
"Wibaux County, MT",MT,2020,450,428,22,4.9,-10
"Wibaux County, MT",MT,2019,460,446,14,3.0,-10
"Wibaux County, MT",MT,2018,470,453,17,3.6,-16
"Wibaux County, MT",MT,2017,486,470,16,3.3,-27
"Wibaux County, MT",MT,2016,513,492,21,4.1,-33
"Wibaux County, MT",MT,2015,546,528,18,3.3,-4
"Wibaux County, MT",MT,2014,550,534,16,2.9,-9
"Wibaux County, MT",MT,2013,559,540,19,3.4,-2
"Wibaux County, MT",MT,2012,561,544,17,3.0,35
"Wibaux County, MT",MT,2011,526,505,21,4.0,-4
"Wibaux County, MT",MT,2010,530,508,22,4.2,0
"Wichita County, KS",KS,2021,1179,1156,23,2.0,-64
"Wichita County, KS",KS,2020,1243,1220,23,1.9,-142
"Wichita County, KS",KS,2019,1385,1359,26,1.9,63
"Wichita County, KS",KS,2018,1322,1295,27,2.0,146
"Wichita County, KS",KS,2017,1176,1147,29,2.5,-35
"Wichita County, KS",KS,2016,1211,1183,28,2.3,-47
"Wichita County, KS",KS,2015,1258,1221,37,2.9,21
"Wichita County, KS",KS,2014,1237,1202,35,2.8,-54
"Wichita County, KS",KS,2013,1291,1246,45,3.5,-46
"Wichita County, KS",KS,2012,1337,1267,70,5.2,1
"Wichita County, KS",KS,2011,1336,1285,51,3.8,0
"Wichita County, KS",KS,2010,1336,1291,45,3.4,0
"Wichita County, TX",TX,2021,55325,52400,2925,5.3,268
"Wichita County, TX",TX,2020,55057,51404,3653,6.6,-357
"Wichita County, TX",TX,2019,55414,53647,1767,3.2,-409
"Wichita County, TX",TX,2018,55823,53906,1917,3.4,164
"Wichita County, TX",TX,2017,55659,53588,2071,3.7,173
"Wichita County, TX",TX,2016,55486,53072,2414,4.4,138
"Wichita County, TX",TX,2015,55348,52958,2390,4.3,-1081
"Wichita County, TX",TX,2014,56429,53641,2788,4.9,-795
"Wichita County, TX",TX,2013,57224,53848,3376,5.9,-1107
"Wichita County, TX",TX,2012,58331,54805,3526,6.0,-651
"Wichita County, TX",TX,2011,58982,54788,4194,7.1,-378
"Wichita County, TX",TX,2010,59360,54733,4627,7.8,0
"Wicomico County, MD",MD,2021,49998,46932,3066,6.1,146
"Wicomico County, MD",MD,2020,49852,46087,3765,7.6,-2401
"Wicomico County, MD",MD,2019,52253,49896,2357,4.5,666
"Wicomico County, MD",MD,2018,51587,49045,2542,4.9,97
"Wicomico County, MD",MD,2017,51490,48660,2830,5.5,1131
"Wicomico County, MD",MD,2016,50359,47331,3028,6.0,177
"Wicomico County, MD",MD,2015,50182,46839,3343,6.7,132
"Wicomico County, MD",MD,2014,50050,46230,3820,7.6,-71
"Wicomico County, MD",MD,2013,50121,45800,4321,8.6,-359
"Wicomico County, MD",MD,2012,50480,45799,4681,9.3,-78
"Wicomico County, MD",MD,2011,50558,45559,4999,9.9,107
"Wicomico County, MD",MD,2010,50451,45440,5011,9.9,0
"Wilbarger County, TX",TX,2021,4891,4569,322,6.6,22
"Wilbarger County, TX",TX,2020,4869,4584,285,5.9,-24
"Wilbarger County, TX",TX,2019,4893,4719,174,3.6,-36
"Wilbarger County, TX",TX,2018,4929,4723,206,4.2,4
"Wilbarger County, TX",TX,2017,4925,4693,232,4.7,-125
"Wilbarger County, TX",TX,2016,5050,4812,238,4.7,-62
"Wilbarger County, TX",TX,2015,5112,4863,249,4.9,-175
"Wilbarger County, TX",TX,2014,5287,5024,263,5.0,-480
"Wilbarger County, TX",TX,2013,5767,5431,336,5.8,-143
"Wilbarger County, TX",TX,2012,5910,5556,354,6.0,-126
"Wilbarger County, TX",TX,2011,6036,5584,452,7.5,-113
"Wilbarger County, TX",TX,2010,6149,5663,486,7.9,0
"Wilcox County, AL",AL,2021,2644,2353,291,11.0,-277
"Wilcox County, AL",AL,2020,2921,2449,472,16.2,168
"Wilcox County, AL",AL,2019,2753,2547,206,7.5,-34
"Wilcox County, AL",AL,2018,2787,2524,263,9.4,-51
"Wilcox County, AL",AL,2017,2838,2507,331,11.7,43
"Wilcox County, AL",AL,2016,2795,2391,404,14.5,-24
"Wilcox County, AL",AL,2015,2819,2404,415,14.7,-49
"Wilcox County, AL",AL,2014,2868,2385,483,16.8,86
"Wilcox County, AL",AL,2013,2782,2239,543,19.5,-112
"Wilcox County, AL",AL,2012,2894,2305,589,20.4,-77
"Wilcox County, AL",AL,2011,2971,2290,681,22.9,-83
"Wilcox County, AL",AL,2010,3054,2266,788,25.8,0
"Wilcox County, GA",GA,2021,2778,2649,129,4.6,24
"Wilcox County, GA",GA,2020,2754,2588,166,6.0,36
"Wilcox County, GA",GA,2019,2718,2594,124,4.6,31
"Wilcox County, GA",GA,2018,2687,2545,142,5.3,-105
"Wilcox County, GA",GA,2017,2792,2629,163,5.8,72
"Wilcox County, GA",GA,2016,2720,2521,199,7.3,7
"Wilcox County, GA",GA,2015,2713,2496,217,8.0,-124
"Wilcox County, GA",GA,2014,2837,2577,260,9.2,22
"Wilcox County, GA",GA,2013,2815,2504,311,11.0,-41
"Wilcox County, GA",GA,2012,2856,2528,328,11.5,-70
"Wilcox County, GA",GA,2011,2926,2555,371,12.7,-17
"Wilcox County, GA",GA,2010,2943,2573,370,12.6,0
"Wilkes County, GA",GA,2021,3657,3486,171,4.7,15
"Wilkes County, GA",GA,2020,3642,3397,245,6.7,-174
"Wilkes County, GA",GA,2019,3816,3634,182,4.8,-17
"Wilkes County, GA",GA,2018,3833,3652,181,4.7,-19
"Wilkes County, GA",GA,2017,3852,3633,219,5.7,144
"Wilkes County, GA",GA,2016,3708,3459,249,6.7,-139
"Wilkes County, GA",GA,2015,3847,3564,283,7.4,117
"Wilkes County, GA",GA,2014,3730,3382,348,9.3,-2
"Wilkes County, GA",GA,2013,3732,3317,415,11.1,-94
"Wilkes County, GA",GA,2012,3826,3366,460,12.0,-96
"Wilkes County, GA",GA,2011,3922,3381,541,13.8,-108
"Wilkes County, GA",GA,2010,4030,3491,539,13.4,0
"Wilkes County, NC",NC,2021,27164,25885,1279,4.7,-312
"Wilkes County, NC",NC,2020,27476,25654,1822,6.6,-1639
"Wilkes County, NC",NC,2019,29115,27964,1151,4.0,-613
"Wilkes County, NC",NC,2018,29728,28593,1135,3.8,-749
"Wilkes County, NC",NC,2017,30477,29179,1298,4.3,368
"Wilkes County, NC",NC,2016,30109,28665,1444,4.8,512
"Wilkes County, NC",NC,2015,29597,27937,1660,5.6,56
"Wilkes County, NC",NC,2014,29541,27643,1898,6.4,-459
"Wilkes County, NC",NC,2013,30000,27393,2607,8.7,-856
"Wilkes County, NC",NC,2012,30856,27577,3279,10.6,-404
"Wilkes County, NC",NC,2011,31260,27583,3677,11.8,75
"Wilkes County, NC",NC,2010,31185,27037,4148,13.3,0
"Wilkin County, MN",MN,2021,3323,3230,93,2.8,-162
"Wilkin County, MN",MN,2020,3485,3337,148,4.2,-66
"Wilkin County, MN",MN,2019,3551,3424,127,3.6,13
"Wilkin County, MN",MN,2018,3538,3424,114,3.2,-30
"Wilkin County, MN",MN,2017,3568,3456,112,3.1,-150
"Wilkin County, MN",MN,2016,3718,3597,121,3.3,20
"Wilkin County, MN",MN,2015,3698,3573,125,3.4,98
"Wilkin County, MN",MN,2014,3600,3475,125,3.5,-28
"Wilkin County, MN",MN,2013,3628,3475,153,4.2,-157
"Wilkin County, MN",MN,2012,3785,3605,180,4.8,-42
"Wilkin County, MN",MN,2011,3827,3612,215,5.6,2
"Wilkin County, MN",MN,2010,3825,3615,210,5.5,0
"Wilkinson County, GA",GA,2021,3657,3505,152,4.2,-144
"Wilkinson County, GA",GA,2020,3801,3600,201,5.3,-256
"Wilkinson County, GA",GA,2019,4057,3899,158,3.9,204
"Wilkinson County, GA",GA,2018,3853,3680,173,4.5,6
"Wilkinson County, GA",GA,2017,3847,3628,219,5.7,197
"Wilkinson County, GA",GA,2016,3650,3416,234,6.4,87
"Wilkinson County, GA",GA,2015,3563,3298,265,7.4,-149
"Wilkinson County, GA",GA,2014,3712,3388,324,8.7,0
"Wilkinson County, GA",GA,2013,3712,3331,381,10.3,-12
"Wilkinson County, GA",GA,2012,3724,3302,422,11.3,-44
"Wilkinson County, GA",GA,2011,3768,3285,483,12.8,-88
"Wilkinson County, GA",GA,2010,3856,3307,549,14.2,0
"Wilkinson County, MS",MS,2021,2736,2431,305,11.1,15
"Wilkinson County, MS",MS,2020,2721,2372,349,12.8,-91
"Wilkinson County, MS",MS,2019,2812,2526,286,10.2,38
"Wilkinson County, MS",MS,2018,2774,2529,245,8.8,-54
"Wilkinson County, MS",MS,2017,2828,2572,256,9.1,3
"Wilkinson County, MS",MS,2016,2825,2532,293,10.4,-51
"Wilkinson County, MS",MS,2015,2876,2567,309,10.7,48
"Wilkinson County, MS",MS,2014,2828,2501,327,11.6,-157
"Wilkinson County, MS",MS,2013,2985,2616,369,12.4,-310
"Wilkinson County, MS",MS,2012,3295,2898,397,12.0,-168
"Wilkinson County, MS",MS,2011,3463,3023,440,12.7,16
"Wilkinson County, MS",MS,2010,3447,2983,464,13.5,0
"Will County, IL",IL,2021,354842,334452,20390,5.7,-3925
"Will County, IL",IL,2020,358767,326219,32548,9.1,-12165
"Will County, IL",IL,2019,370932,356223,14709,4.0,3316
"Will County, IL",IL,2018,367616,352220,15396,4.2,8
"Will County, IL",IL,2017,367608,348996,18612,5.1,4709
"Will County, IL",IL,2016,362899,340783,22116,6.1,5936
"Will County, IL",IL,2015,356963,334632,22331,6.3,-372
"Will County, IL",IL,2014,357335,329806,27529,7.7,-1910
"Will County, IL",IL,2013,359245,323807,35438,9.9,1802
"Will County, IL",IL,2012,357443,322411,35032,9.8,4983
"Will County, IL",IL,2011,352460,314639,37821,10.7,-2674
"Will County, IL",IL,2010,355134,315408,39726,11.2,0
"Willacy County, TX",TX,2021,6976,6245,731,10.5,426
"Willacy County, TX",TX,2020,6550,5766,784,12.0,78
"Willacy County, TX",TX,2019,6472,5938,534,8.3,139
"Willacy County, TX",TX,2018,6333,5703,630,9.9,53
"Willacy County, TX",TX,2017,6280,5582,698,11.1,-225
"Willacy County, TX",TX,2016,6505,5707,798,12.3,-250
"Willacy County, TX",TX,2015,6755,5868,887,13.1,-413
"Willacy County, TX",TX,2014,7168,6269,899,12.5,-259
"Willacy County, TX",TX,2013,7427,6247,1180,15.9,23
"Willacy County, TX",TX,2012,7404,6241,1163,15.7,-336
"Willacy County, TX",TX,2011,7740,6429,1311,16.9,-54
"Willacy County, TX",TX,2010,7794,6662,1132,14.5,0
"Williams County, ND",ND,2021,20877,19473,1404,6.7,-2437
"Williams County, ND",ND,2020,23314,21042,2272,9.7,-1841
"Williams County, ND",ND,2019,25155,24741,414,1.6,966
"Williams County, ND",ND,2018,24189,23748,441,1.8,1165
"Williams County, ND",ND,2017,23024,22450,574,2.5,439
"Williams County, ND",ND,2016,22585,21599,986,4.4,-5893
"Williams County, ND",ND,2015,28478,27801,677,2.4,-3022
"Williams County, ND",ND,2014,31500,31132,368,1.2,2552
"Williams County, ND",ND,2013,28948,28593,355,1.2,1992
"Williams County, ND",ND,2012,26956,26668,288,1.1,6916
"Williams County, ND",ND,2011,20040,19767,273,1.4,5601
"Williams County, ND",ND,2010,14439,14129,310,2.1,0
"Williams County, OH",OH,2021,18467,17672,795,4.3,-315
"Williams County, OH",OH,2020,18782,17330,1452,7.7,-408
"Williams County, OH",OH,2019,19190,18548,642,3.3,145
"Williams County, OH",OH,2018,19045,18356,689,3.6,-63
"Williams County, OH",OH,2017,19108,18274,834,4.4,8
"Williams County, OH",OH,2016,19100,18232,868,4.5,26
"Williams County, OH",OH,2015,19074,18222,852,4.5,241
"Williams County, OH",OH,2014,18833,17806,1027,5.5,190
"Williams County, OH",OH,2013,18643,17256,1387,7.4,-220
"Williams County, OH",OH,2012,18863,17374,1489,7.9,-12
"Williams County, OH",OH,2011,18875,16850,2025,10.7,-692
"Williams County, OH",OH,2010,19567,16988,2579,13.2,0
"Williamsburg city, VA",VA,2021,6579,6259,320,4.9,-252
"Williamsburg city, VA",VA,2020,6831,6277,554,8.1,4
"Williamsburg city, VA",VA,2019,6827,6565,262,3.8,90
"Williamsburg city, VA",VA,2018,6737,6468,269,4.0,-67
"Williamsburg city, VA",VA,2017,6804,6454,350,5.1,84
"Williamsburg city, VA",VA,2016,6720,6354,366,5.4,38
"Williamsburg city, VA",VA,2015,6682,6264,418,6.3,24
"Williamsburg city, VA",VA,2014,6658,6178,480,7.2,-218
"Williamsburg city, VA",VA,2013,6876,6360,516,7.5,44
"Williamsburg city, VA",VA,2012,6832,6273,559,8.2,99
"Williamsburg city, VA",VA,2011,6733,6130,603,9.0,203
"Williamsburg city, VA",VA,2010,6530,5853,677,10.4,0
"Williamsburg County, SC",SC,2021,11170,10487,683,6.1,-293
"Williamsburg County, SC",SC,2020,11463,10541,922,8.0,-299
"Williamsburg County, SC",SC,2019,11762,11239,523,4.4,-81
"Williamsburg County, SC",SC,2018,11843,11203,640,5.4,-50
"Williamsburg County, SC",SC,2017,11893,11148,745,6.3,-538
"Williamsburg County, SC",SC,2016,12431,11490,941,7.6,-374
"Williamsburg County, SC",SC,2015,12805,11637,1168,9.1,170
"Williamsburg County, SC",SC,2014,12635,11405,1230,9.7,-64
"Williamsburg County, SC",SC,2013,12699,11149,1550,12.2,265
"Williamsburg County, SC",SC,2012,12434,10509,1925,15.5,-1039
"Williamsburg County, SC",SC,2011,13473,11251,2222,16.5,-10
"Williamsburg County, SC",SC,2010,13483,11126,2357,17.5,0
"Williamson County, IL",IL,2021,31145,29419,1726,5.5,-215
"Williamson County, IL",IL,2020,31360,28585,2775,8.8,-843
"Williamson County, IL",IL,2019,32203,30886,1317,4.1,5
"Williamson County, IL",IL,2018,32198,30576,1622,5.0,346
"Williamson County, IL",IL,2017,31852,30213,1639,5.1,-608
"Williamson County, IL",IL,2016,32460,30465,1995,6.1,477
"Williamson County, IL",IL,2015,31983,30002,1981,6.2,594
"Williamson County, IL",IL,2014,31389,29133,2256,7.2,-67
"Williamson County, IL",IL,2013,31456,28631,2825,9.0,-265
"Williamson County, IL",IL,2012,31721,28964,2757,8.7,-596
"Williamson County, IL",IL,2011,32317,29384,2933,9.1,-168
"Williamson County, IL",IL,2010,32485,29292,3193,9.8,0
"Williamson County, TN",TN,2021,133778,130456,3322,2.5,4351
"Williamson County, TN",TN,2020,129427,123362,6065,4.7,-2335
"Williamson County, TN",TN,2019,131762,128542,3220,2.4,6411
"Williamson County, TN",TN,2018,125351,122232,3119,2.5,5651
"Williamson County, TN",TN,2017,119700,116468,3232,2.7,6069
"Williamson County, TN",TN,2016,113631,109736,3895,3.4,5811
"Williamson County, TN",TN,2015,107820,103534,4286,4.0,3910
"Williamson County, TN",TN,2014,103910,99185,4725,4.5,2347
"Williamson County, TN",TN,2013,101563,96348,5215,5.1,2745
"Williamson County, TN",TN,2012,98818,93837,4981,5.0,1709
"Williamson County, TN",TN,2011,97109,91345,5764,5.9,2597
"Williamson County, TN",TN,2010,94512,88189,6323,6.7,0
"Williamson County, TX",TX,2021,340568,326982,13586,4.0,19194
"Williamson County, TX",TX,2020,321374,302663,18711,5.8,6306
"Williamson County, TX",TX,2019,315068,306186,8882,2.8,13813
"Williamson County, TX",TX,2018,301255,291963,9292,3.1,12650
"Williamson County, TX",TX,2017,288605,279094,9511,3.3,9888
"Williamson County, TX",TX,2016,278717,269349,9368,3.4,14620
"Williamson County, TX",TX,2015,264097,254904,9193,3.5,9130
"Williamson County, TX",TX,2014,254967,243698,11269,4.4,8848
"Williamson County, TX",TX,2013,246119,233019,13100,5.3,9253
"Williamson County, TX",TX,2012,236866,223136,13730,5.8,6110
"Williamson County, TX",TX,2011,230756,214564,16192,7.0,7782
"Williamson County, TX",TX,2010,222974,206656,16318,7.3,0
"Wilson County, KS",KS,2021,3837,3683,154,4.0,-66
"Wilson County, KS",KS,2020,3903,3607,296,7.6,-51
"Wilson County, KS",KS,2019,3954,3801,153,3.9,-73
"Wilson County, KS",KS,2018,4027,3856,171,4.2,20
"Wilson County, KS",KS,2017,4007,3819,188,4.7,-126
"Wilson County, KS",KS,2016,4133,3886,247,6.0,114
"Wilson County, KS",KS,2015,4019,3755,264,6.6,-156
"Wilson County, KS",KS,2014,4175,3889,286,6.9,56
"Wilson County, KS",KS,2013,4119,3754,365,8.9,-85
"Wilson County, KS",KS,2012,4204,3787,417,9.9,-82
"Wilson County, KS",KS,2011,4286,3803,483,11.3,-206
"Wilson County, KS",KS,2010,4492,3965,527,11.7,0
"Wilson County, NC",NC,2021,33434,31183,2251,6.7,-144
"Wilson County, NC",NC,2020,33578,30693,2885,8.6,-1127
"Wilson County, NC",NC,2019,34705,32741,1964,5.7,-84
"Wilson County, NC",NC,2018,34789,32614,2175,6.3,-668
"Wilson County, NC",NC,2017,35457,32894,2563,7.2,-920
"Wilson County, NC",NC,2016,36377,33408,2969,8.2,-320
"Wilson County, NC",NC,2015,36697,33251,3446,9.4,-892
"Wilson County, NC",NC,2014,37589,34120,3469,9.2,-574
"Wilson County, NC",NC,2013,38163,33805,4358,11.4,-531
"Wilson County, NC",NC,2012,38694,33547,5147,13.3,237
"Wilson County, NC",NC,2011,38457,33114,5343,13.9,101
"Wilson County, NC",NC,2010,38356,33079,5277,13.8,0
"Wilson County, TN",TN,2021,79606,77054,2552,3.2,1711
"Wilson County, TN",TN,2020,77895,72992,4903,6.3,-726
"Wilson County, TN",TN,2019,78621,76501,2120,2.7,3800
"Wilson County, TN",TN,2018,74821,72745,2076,2.8,3779
"Wilson County, TN",TN,2017,71042,68930,2112,3.0,3166
"Wilson County, TN",TN,2016,67876,65252,2624,3.9,3113
"Wilson County, TN",TN,2015,64763,61820,2943,4.5,2108
"Wilson County, TN",TN,2014,62655,59336,3319,5.3,958
"Wilson County, TN",TN,2013,61697,57825,3872,6.3,1110
"Wilson County, TN",TN,2012,60587,56643,3944,6.5,690
"Wilson County, TN",TN,2011,59897,55302,4595,7.7,1347
"Wilson County, TN",TN,2010,58550,53558,4992,8.5,0
"Wilson County, TX",TX,2021,24999,23899,1100,4.4,751
"Wilson County, TX",TX,2020,24248,22860,1388,5.7,-373
"Wilson County, TX",TX,2019,24621,23920,701,2.8,313
"Wilson County, TX",TX,2018,24308,23555,753,3.1,306
"Wilson County, TX",TX,2017,24002,23157,845,3.5,242
"Wilson County, TX",TX,2016,23760,22830,930,3.9,779
"Wilson County, TX",TX,2015,22981,22103,878,3.8,468
"Wilson County, TX",TX,2014,22513,21565,948,4.2,347
"Wilson County, TX",TX,2013,22166,20992,1174,5.3,485
"Wilson County, TX",TX,2012,21681,20487,1194,5.5,152
"Wilson County, TX",TX,2011,21529,20079,1450,6.7,267
"Wilson County, TX",TX,2010,21262,19804,1458,6.9,0
"Winchester city, VA",VA,2021,14437,13932,505,3.5,-251
"Winchester city, VA",VA,2020,14688,13818,870,5.9,-265
"Winchester city, VA",VA,2019,14953,14539,414,2.8,263
"Winchester city, VA",VA,2018,14690,14258,432,2.9,79
"Winchester city, VA",VA,2017,14611,14083,528,3.6,266
"Winchester city, VA",VA,2016,14345,13780,565,3.9,89
"Winchester city, VA",VA,2015,14256,13640,616,4.3,-225
"Winchester city, VA",VA,2014,14481,13753,728,5.0,118
"Winchester city, VA",VA,2013,14363,13547,816,5.7,140
"Winchester city, VA",VA,2012,14223,13292,931,6.5,170
"Winchester city, VA",VA,2011,14053,13014,1039,7.4,348
"Winchester city, VA",VA,2010,13705,12545,1160,8.5,0
"Windham County, CT",CT,2021,61835,57975,3860,6.2,-1289
"Windham County, CT",CT,2020,63124,58291,4833,7.7,-2123
"Windham County, CT",CT,2019,65247,62758,2489,3.8,850
"Windham County, CT",CT,2018,64397,61624,2773,4.3,632
"Windham County, CT",CT,2017,63765,60717,3048,4.8,1126
"Windham County, CT",CT,2016,62639,59342,3297,5.3,101
"Windham County, CT",CT,2015,62538,58629,3909,6.3,-162
"Windham County, CT",CT,2014,62700,58074,4626,7.4,450
"Windham County, CT",CT,2013,62250,56651,5599,9.0,-866
"Windham County, CT",CT,2012,63116,57120,5996,9.5,-1320
"Windham County, CT",CT,2011,64436,57926,6510,10.1,-123
"Windham County, CT",CT,2010,64559,57576,6983,10.8,0
"Windham County, VT",VT,2021,20410,19506,904,4.4,-1270
"Windham County, VT",VT,2020,21680,20239,1441,6.6,-1119
"Windham County, VT",VT,2019,22799,22228,571,2.5,-394
"Windham County, VT",VT,2018,23193,22545,648,2.8,-267
"Windham County, VT",VT,2017,23460,22733,727,3.1,166
"Windham County, VT",VT,2016,23294,22545,749,3.2,-283
"Windham County, VT",VT,2015,23577,22745,832,3.5,-46
"Windham County, VT",VT,2014,23623,22647,976,4.1,-452
"Windham County, VT",VT,2013,24075,22947,1128,4.7,-529
"Windham County, VT",VT,2012,24604,23366,1238,5.0,-349
"Windham County, VT",VT,2011,24953,23534,1419,5.7,-503
"Windham County, VT",VT,2010,25456,23833,1623,6.4,0
"Windsor County, VT",VT,2021,28071,27145,926,3.3,-940
"Windsor County, VT",VT,2020,29011,27312,1699,5.9,-1033
"Windsor County, VT",VT,2019,30044,29424,620,2.1,78
"Windsor County, VT",VT,2018,29966,29279,687,2.3,110
"Windsor County, VT",VT,2017,29856,29088,768,2.6,427
"Windsor County, VT",VT,2016,29429,28594,835,2.8,-192
"Windsor County, VT",VT,2015,29621,28678,943,3.2,-214
"Windsor County, VT",VT,2014,29835,28723,1112,3.7,-465
"Windsor County, VT",VT,2013,30300,29029,1271,4.2,-350
"Windsor County, VT",VT,2012,30650,29261,1389,4.5,-683
"Windsor County, VT",VT,2011,31333,29600,1733,5.5,-580
"Windsor County, VT",VT,2010,31913,29891,2022,6.3,0
"Winkler County, TX",TX,2021,3726,3439,287,7.7,-215
"Winkler County, TX",TX,2020,3941,3569,372,9.4,-68
"Winkler County, TX",TX,2019,4009,3894,115,2.9,23
"Winkler County, TX",TX,2018,3986,3872,114,2.9,752
"Winkler County, TX",TX,2017,3234,3067,167,5.2,163
"Winkler County, TX",TX,2016,3071,2834,237,7.7,-33
"Winkler County, TX",TX,2015,3104,2926,178,5.7,-177
"Winkler County, TX",TX,2014,3281,3135,146,4.4,-35
"Winkler County, TX",TX,2013,3316,3140,176,5.3,137
"Winkler County, TX",TX,2012,3179,3000,179,5.6,128
"Winkler County, TX",TX,2011,3051,2825,226,7.4,148
"Winkler County, TX",TX,2010,2903,2634,269,9.3,0
"Winn Parish, LA",LA,2021,4602,4381,221,4.8,-83
"Winn Parish, LA",LA,2020,4685,4327,358,7.6,-193
"Winn Parish, LA",LA,2019,4878,4582,296,6.1,-90
"Winn Parish, LA",LA,2018,4968,4664,304,6.1,-92
"Winn Parish, LA",LA,2017,5060,4734,326,6.4,-131
"Winn Parish, LA",LA,2016,5191,4788,403,7.8,-126
"Winn Parish, LA",LA,2015,5317,4870,447,8.4,-77
"Winn Parish, LA",LA,2014,5394,4995,399,7.4,19
"Winn Parish, LA",LA,2013,5375,4953,422,7.9,-336
"Winn Parish, LA",LA,2012,5711,5246,465,8.1,45
"Winn Parish, LA",LA,2011,5666,5159,507,8.9,-138
"Winn Parish, LA",LA,2010,5804,5292,512,8.8,0
"Winnebago County, IA",IA,2021,4949,4741,208,4.2,-128
"Winnebago County, IA",IA,2020,5077,4761,316,6.2,-143
"Winnebago County, IA",IA,2019,5220,5083,137,2.6,149
"Winnebago County, IA",IA,2018,5071,4941,130,2.6,-140
"Winnebago County, IA",IA,2017,5211,5049,162,3.1,-15
"Winnebago County, IA",IA,2016,5226,5046,180,3.4,56
"Winnebago County, IA",IA,2015,5170,4967,203,3.9,-55
"Winnebago County, IA",IA,2014,5225,5005,220,4.2,52
"Winnebago County, IA",IA,2013,5173,4925,248,4.8,35
"Winnebago County, IA",IA,2012,5138,4862,276,5.4,-331
"Winnebago County, IA",IA,2011,5469,5133,336,6.1,-338
"Winnebago County, IA",IA,2010,5807,5411,396,6.8,0
"Winnebago County, IL",IL,2021,133417,122161,11256,8.4,-2017
"Winnebago County, IL",IL,2020,135434,119837,15597,11.5,-4262
"Winnebago County, IL",IL,2019,139696,132166,7530,5.4,-1964
"Winnebago County, IL",IL,2018,141660,133661,7999,5.6,2430
"Winnebago County, IL",IL,2017,139230,130256,8974,6.4,-2680
"Winnebago County, IL",IL,2016,141910,132448,9462,6.7,-289
"Winnebago County, IL",IL,2015,142199,132206,9993,7.0,366
"Winnebago County, IL",IL,2014,141833,129969,11864,8.4,-1048
"Winnebago County, IL",IL,2013,142881,127922,14959,10.5,-2414
"Winnebago County, IL",IL,2012,145295,129872,15423,10.6,-1923
"Winnebago County, IL",IL,2011,147218,129684,17534,11.9,-2367
"Winnebago County, IL",IL,2010,149585,128423,21162,14.1,0
"Winnebago County, WI",WI,2021,93109,90123,2986,3.2,729
"Winnebago County, WI",WI,2020,92380,87328,5052,5.5,520
"Winnebago County, WI",WI,2019,91860,89227,2633,2.9,-601
"Winnebago County, WI",WI,2018,92461,89949,2512,2.7,-1433
"Winnebago County, WI",WI,2017,93894,91113,2781,3.0,1056
"Winnebago County, WI",WI,2016,92838,89604,3234,3.5,1605
"Winnebago County, WI",WI,2015,91233,87453,3780,4.1,-250
"Winnebago County, WI",WI,2014,91483,86781,4702,5.1,-162
"Winnebago County, WI",WI,2013,91645,85832,5813,6.3,-755
"Winnebago County, WI",WI,2012,92400,86346,6054,6.6,208
"Winnebago County, WI",WI,2011,92192,85864,6328,6.9,-300
"Winnebago County, WI",WI,2010,92492,85419,7073,7.6,0
"Winneshiek County, IA",IA,2021,11385,10913,472,4.1,185
"Winneshiek County, IA",IA,2020,11200,10666,534,4.8,-955
"Winneshiek County, IA",IA,2019,12155,11824,331,2.7,198
"Winneshiek County, IA",IA,2018,11957,11639,318,2.7,0
"Winneshiek County, IA",IA,2017,11957,11596,361,3.0,-168
"Winneshiek County, IA",IA,2016,12125,11702,423,3.5,-104
"Winneshiek County, IA",IA,2015,12229,11785,444,3.6,169
"Winneshiek County, IA",IA,2014,12060,11549,511,4.2,154
"Winneshiek County, IA",IA,2013,11906,11355,551,4.6,-28
"Winneshiek County, IA",IA,2012,11934,11382,552,4.6,-230
"Winneshiek County, IA",IA,2011,12164,11548,616,5.1,-98
"Winneshiek County, IA",IA,2010,12262,11573,689,5.6,0
"Winona County, MN",MN,2021,27272,26494,778,2.9,-1138
"Winona County, MN",MN,2020,28410,26971,1439,5.1,-510
"Winona County, MN",MN,2019,28920,28033,887,3.1,93
"Winona County, MN",MN,2018,28827,28016,811,2.8,-274
"Winona County, MN",MN,2017,29101,28187,914,3.1,-149
"Winona County, MN",MN,2016,29250,28213,1037,3.5,-290
"Winona County, MN",MN,2015,29540,28539,1001,3.4,131
"Winona County, MN",MN,2014,29409,28286,1123,3.8,-200
"Winona County, MN",MN,2013,29609,28295,1314,4.4,-247
"Winona County, MN",MN,2012,29856,28384,1472,4.9,358
"Winona County, MN",MN,2011,29498,27773,1725,5.8,264
"Winona County, MN",MN,2010,29234,27210,2024,6.9,0
"Winston County, AL",AL,2021,10110,9830,280,2.8,-161
"Winston County, AL",AL,2020,10271,9734,537,5.2,-9
"Winston County, AL",AL,2019,10280,9922,358,3.5,364
"Winston County, AL",AL,2018,9916,9503,413,4.2,110
"Winston County, AL",AL,2017,9806,9301,505,5.1,351
"Winston County, AL",AL,2016,9455,8783,672,7.1,101
"Winston County, AL",AL,2015,9354,8645,709,7.6,-293
"Winston County, AL",AL,2014,9647,8822,825,8.6,9
"Winston County, AL",AL,2013,9638,8719,919,9.5,17
"Winston County, AL",AL,2012,9621,8637,984,10.2,-185
"Winston County, AL",AL,2011,9806,8496,1310,13.4,-62
"Winston County, AL",AL,2010,9868,8322,1546,15.7,0
"Winston County, MS",MS,2021,7180,6735,445,6.2,-77
"Winston County, MS",MS,2020,7257,6642,615,8.5,-159
"Winston County, MS",MS,2019,7416,6965,451,6.1,127
"Winston County, MS",MS,2018,7289,6863,426,5.8,87
"Winston County, MS",MS,2017,7202,6756,446,6.2,126
"Winston County, MS",MS,2016,7076,6563,513,7.2,11
"Winston County, MS",MS,2015,7065,6474,591,8.4,-68
"Winston County, MS",MS,2014,7133,6414,719,10.1,-258
"Winston County, MS",MS,2013,7391,6581,810,11.0,-411
"Winston County, MS",MS,2012,7802,6923,879,11.3,-213
"Winston County, MS",MS,2011,8015,6970,1045,13.0,71
"Winston County, MS",MS,2010,7944,6631,1313,16.5,0
"Wirt County, WV",WV,2021,2271,2098,173,7.6,39
"Wirt County, WV",WV,2020,2232,1996,236,10.6,-83
"Wirt County, WV",WV,2019,2315,2133,182,7.9,80
"Wirt County, WV",WV,2018,2235,2081,154,6.9,24
"Wirt County, WV",WV,2017,2211,2036,175,7.9,-28
"Wirt County, WV",WV,2016,2239,2042,197,8.8,-42
"Wirt County, WV",WV,2015,2281,2050,231,10.1,-3
"Wirt County, WV",WV,2014,2284,2067,217,9.5,-36
"Wirt County, WV",WV,2013,2320,2087,233,10.0,26
"Wirt County, WV",WV,2012,2294,2051,243,10.6,19
"Wirt County, WV",WV,2011,2275,2019,256,11.3,-15
"Wirt County, WV",WV,2010,2290,2003,287,12.5,0
"Wise County, TX",TX,2021,32980,31380,1600,4.9,1051
"Wise County, TX",TX,2020,31929,29841,2088,6.5,4
"Wise County, TX",TX,2019,31925,30896,1029,3.2,975
"Wise County, TX",TX,2018,30950,29876,1074,3.5,1002
"Wise County, TX",TX,2017,29948,28738,1210,4.0,510
"Wise County, TX",TX,2016,29438,28044,1394,4.7,753
"Wise County, TX",TX,2015,28685,27345,1340,4.7,235
"Wise County, TX",TX,2014,28450,27045,1405,4.9,99
"Wise County, TX",TX,2013,28351,26639,1712,6.0,165
"Wise County, TX",TX,2012,28186,26379,1807,6.4,44
"Wise County, TX",TX,2011,28142,25940,2202,7.8,429
"Wise County, TX",TX,2010,27713,25293,2420,8.7,0
"Wise County, VA",VA,2021,12722,12058,664,5.2,-403
"Wise County, VA",VA,2020,13125,12138,987,7.5,-388
"Wise County, VA",VA,2019,13513,12895,618,4.6,178
"Wise County, VA",VA,2018,13335,12683,652,4.9,-331
"Wise County, VA",VA,2017,13666,12804,862,6.3,455
"Wise County, VA",VA,2016,13211,12109,1102,8.3,-620
"Wise County, VA",VA,2015,13831,12701,1130,8.2,-640
"Wise County, VA",VA,2014,14471,13123,1348,9.3,-615
"Wise County, VA",VA,2013,15086,13561,1525,10.1,-893
"Wise County, VA",VA,2012,15979,14580,1399,8.8,-1250
"Wise County, VA",VA,2011,17229,15911,1318,7.6,224
"Wise County, VA",VA,2010,17005,15553,1452,8.5,0
"Wolfe County, KY",KY,2021,2222,2092,130,5.9,143
"Wolfe County, KY",KY,2020,2079,1925,154,7.4,114
"Wolfe County, KY",KY,2019,1965,1833,132,6.7,68
"Wolfe County, KY",KY,2018,1897,1756,141,7.4,-29
"Wolfe County, KY",KY,2017,1926,1753,173,9.0,9
"Wolfe County, KY",KY,2016,1917,1725,192,10.0,9
"Wolfe County, KY",KY,2015,1908,1716,192,10.1,-148
"Wolfe County, KY",KY,2014,2056,1825,231,11.2,-54
"Wolfe County, KY",KY,2013,2110,1813,297,14.1,6
"Wolfe County, KY",KY,2012,2104,1803,301,14.3,-5
"Wolfe County, KY",KY,2011,2109,1796,313,14.8,-55
"Wolfe County, KY",KY,2010,2164,1807,357,16.5,0
"Wood County, OH",OH,2021,69203,66238,2965,4.3,17
"Wood County, OH",OH,2020,69186,64309,4877,7.0,-2853
"Wood County, OH",OH,2019,72039,69384,2655,3.7,898
"Wood County, OH",OH,2018,71141,68303,2838,4.0,94
"Wood County, OH",OH,2017,71047,67933,3114,4.4,120
"Wood County, OH",OH,2016,70927,67946,2981,4.2,1115
"Wood County, OH",OH,2015,69812,66796,3016,4.3,471
"Wood County, OH",OH,2014,69341,65730,3611,5.2,296
"Wood County, OH",OH,2013,69045,64210,4835,7.0,342
"Wood County, OH",OH,2012,68703,63991,4712,6.9,525
"Wood County, OH",OH,2011,68178,62529,5649,8.3,-468
"Wood County, OH",OH,2010,68646,61828,6818,9.9,0
"Wood County, TX",TX,2021,17988,16977,1011,5.6,264
"Wood County, TX",TX,2020,17724,16551,1173,6.6,233
"Wood County, TX",TX,2019,17491,16810,681,3.9,301
"Wood County, TX",TX,2018,17190,16452,738,4.3,-23
"Wood County, TX",TX,2017,17213,16400,813,4.7,-35
"Wood County, TX",TX,2016,17248,16339,909,5.3,478
"Wood County, TX",TX,2015,16770,15873,897,5.3,23
"Wood County, TX",TX,2014,16747,15735,1012,6.0,54
"Wood County, TX",TX,2013,16693,15468,1225,7.3,0
"Wood County, TX",TX,2012,16693,15389,1304,7.8,-276
"Wood County, TX",TX,2011,16969,15457,1512,8.9,-24
"Wood County, TX",TX,2010,16993,15447,1546,9.1,0
"Wood County, WI",WI,2021,34769,33241,1528,4.4,-86
"Wood County, WI",WI,2020,34855,32511,2344,6.7,-394
"Wood County, WI",WI,2019,35249,33968,1281,3.6,-90
"Wood County, WI",WI,2018,35339,34134,1205,3.4,222
"Wood County, WI",WI,2017,35117,33816,1301,3.7,599
"Wood County, WI",WI,2016,34518,32929,1589,4.6,190
"Wood County, WI",WI,2015,34328,32481,1847,5.4,-388
"Wood County, WI",WI,2014,34716,32431,2285,6.6,-4279
"Wood County, WI",WI,2013,38995,36178,2817,7.2,-671
"Wood County, WI",WI,2012,39666,36722,2944,7.4,-240
"Wood County, WI",WI,2011,39906,36663,3243,8.1,-79
"Wood County, WI",WI,2010,39985,36337,3648,9.1,0
"Wood County, WV",WV,2021,36539,34608,1931,5.3,437
"Wood County, WV",WV,2020,36102,32991,3111,8.6,-707
"Wood County, WV",WV,2019,36809,34924,1885,5.1,399
"Wood County, WV",WV,2018,36410,34451,1959,5.4,48
"Wood County, WV",WV,2017,36362,34363,1999,5.5,-578
"Wood County, WV",WV,2016,36940,34816,2124,5.7,-573
"Wood County, WV",WV,2015,37513,35206,2307,6.1,-655
"Wood County, WV",WV,2014,38168,35938,2230,5.8,-325
"Wood County, WV",WV,2013,38493,36133,2360,6.1,-58
"Wood County, WV",WV,2012,38551,35845,2706,7.0,-66
"Wood County, WV",WV,2011,38617,35517,3100,8.0,-679
"Wood County, WV",WV,2010,39296,35800,3496,8.9,0
"Woodbury County, IA",IA,2021,54789,52431,2358,4.3,-115
"Woodbury County, IA",IA,2020,54904,52079,2825,5.1,-2101
"Woodbury County, IA",IA,2019,57005,55538,1467,2.6,1206
"Woodbury County, IA",IA,2018,55799,54403,1396,2.5,867
"Woodbury County, IA",IA,2017,54932,53219,1713,3.1,-1112
"Woodbury County, IA",IA,2016,56044,54065,1979,3.5,-156
"Woodbury County, IA",IA,2015,56200,54099,2101,3.7,244
"Woodbury County, IA",IA,2014,55956,53508,2448,4.4,668
"Woodbury County, IA",IA,2013,55288,52641,2647,4.8,785
"Woodbury County, IA",IA,2012,54503,51644,2859,5.2,-297
"Woodbury County, IA",IA,2011,54800,51601,3199,5.8,-1061
"Woodbury County, IA",IA,2010,55861,52119,3742,6.7,0
"Woodford County, IL",IL,2021,18001,17289,712,4.0,56
"Woodford County, IL",IL,2020,17945,16831,1114,6.2,-1022
"Woodford County, IL",IL,2019,18967,18294,673,3.5,-147
"Woodford County, IL",IL,2018,19114,18341,773,4.0,158
"Woodford County, IL",IL,2017,18956,18125,831,4.4,-477
"Woodford County, IL",IL,2016,19433,18367,1066,5.5,-161
"Woodford County, IL",IL,2015,19594,18598,996,5.1,-77
"Woodford County, IL",IL,2014,19671,18574,1097,5.6,-227
"Woodford County, IL",IL,2013,19898,18492,1406,7.1,-502
"Woodford County, IL",IL,2012,20400,19176,1224,6.0,-87
"Woodford County, IL",IL,2011,20487,19167,1320,6.4,202
"Woodford County, IL",IL,2010,20285,18719,1566,7.7,0
"Woodford County, KY",KY,2021,15053,14543,510,3.4,202
"Woodford County, KY",KY,2020,14851,14132,719,4.8,-229
"Woodford County, KY",KY,2019,15080,14633,447,3.0,327
"Woodford County, KY",KY,2018,14753,14308,445,3.0,-219
"Woodford County, KY",KY,2017,14972,14494,478,3.2,210
"Woodford County, KY",KY,2016,14762,14294,468,3.2,387
"Woodford County, KY",KY,2015,14375,13876,499,3.5,130
"Woodford County, KY",KY,2014,14245,13611,634,4.5,-11
"Woodford County, KY",KY,2013,14256,13508,748,5.2,127
"Woodford County, KY",KY,2012,14129,13369,760,5.4,-231
"Woodford County, KY",KY,2011,14360,13430,930,6.5,-151
"Woodford County, KY",KY,2010,14511,13449,1062,7.3,0
"Woodruff County, AR",AR,2021,2790,2651,139,5.0,-36
"Woodruff County, AR",AR,2020,2826,2661,165,5.8,56
"Woodruff County, AR",AR,2019,2770,2628,142,5.1,-30
"Woodruff County, AR",AR,2018,2800,2670,130,4.6,-125
"Woodruff County, AR",AR,2017,2925,2783,142,4.9,-49
"Woodruff County, AR",AR,2016,2974,2811,163,5.5,-69
"Woodruff County, AR",AR,2015,3043,2851,192,6.3,-146
"Woodruff County, AR",AR,2014,3189,2952,237,7.4,-65
"Woodruff County, AR",AR,2013,3254,2953,301,9.3,-139
"Woodruff County, AR",AR,2012,3393,3061,332,9.8,-147
"Woodruff County, AR",AR,2011,3540,3170,370,10.5,-81
"Woodruff County, AR",AR,2010,3621,3258,363,10.0,0
"Woods County, OK",OK,2021,4733,4634,99,2.1,153
"Woods County, OK",OK,2020,4580,4421,159,3.5,-1
"Woods County, OK",OK,2019,4581,4492,89,1.9,-50
"Woods County, OK",OK,2018,4631,4535,96,2.1,-277
"Woods County, OK",OK,2017,4908,4787,121,2.5,-308
"Woods County, OK",OK,2016,5216,5055,161,3.1,-151
"Woods County, OK",OK,2015,5367,5222,145,2.7,78
"Woods County, OK",OK,2014,5289,5151,138,2.6,152
"Woods County, OK",OK,2013,5137,4975,162,3.2,83
"Woods County, OK",OK,2012,5054,4918,136,2.7,573
"Woods County, OK",OK,2011,4481,4335,146,3.3,194
"Woods County, OK",OK,2010,4287,4113,174,4.1,0
"Woodson County, KS",KS,2021,1528,1475,53,3.5,-33
"Woodson County, KS",KS,2020,1561,1470,91,5.8,-64
"Woodson County, KS",KS,2019,1625,1558,67,4.1,22
"Woodson County, KS",KS,2018,1603,1535,68,4.2,6
"Woodson County, KS",KS,2017,1597,1527,70,4.4,-27
"Woodson County, KS",KS,2016,1624,1531,93,5.7,9
"Woodson County, KS",KS,2015,1615,1534,81,5.0,-14
"Woodson County, KS",KS,2014,1629,1544,85,5.2,-2
"Woodson County, KS",KS,2013,1631,1529,102,6.3,-19
"Woodson County, KS",KS,2012,1650,1548,102,6.2,-76
"Woodson County, KS",KS,2011,1726,1611,115,6.7,-10
"Woodson County, KS",KS,2010,1736,1601,135,7.8,0
"Woodward County, OK",OK,2021,8665,8300,365,4.2,-216
"Woodward County, OK",OK,2020,8881,8271,610,6.9,-65
"Woodward County, OK",OK,2019,8946,8700,246,2.7,-290
"Woodward County, OK",OK,2018,9236,8995,241,2.6,-168
"Woodward County, OK",OK,2017,9404,9036,368,3.9,-98
"Woodward County, OK",OK,2016,9502,8933,569,6.0,-793
"Woodward County, OK",OK,2015,10295,9775,520,5.1,-468
"Woodward County, OK",OK,2014,10763,10441,322,3.0,37
"Woodward County, OK",OK,2013,10726,10357,369,3.4,175
"Woodward County, OK",OK,2012,10551,10191,360,3.4,656
"Woodward County, OK",OK,2011,9895,9456,439,4.4,552
"Woodward County, OK",OK,2010,9343,8723,620,6.6,0
"Worcester County, MA",MA,2021,443682,417617,26065,5.9,1571
"Worcester County, MA",MA,2020,442111,401024,41087,9.3,-9116
"Worcester County, MA",MA,2019,451227,436248,14979,3.3,-252
"Worcester County, MA",MA,2018,451479,434968,16511,3.7,9086
"Worcester County, MA",MA,2017,442393,424645,17748,4.0,12358
"Worcester County, MA",MA,2016,430035,411749,18286,4.3,2518
"Worcester County, MA",MA,2015,427517,405817,21700,5.1,766
"Worcester County, MA",MA,2014,426751,400741,26010,6.1,5855
"Worcester County, MA",MA,2013,420896,390976,29920,7.1,389
"Worcester County, MA",MA,2012,420507,390151,30356,7.2,761
"Worcester County, MA",MA,2011,419746,387512,32234,7.7,-562
"Worcester County, MA",MA,2010,420308,384217,36091,8.6,0
"Worcester County, MD",MD,2021,24913,22861,2052,8.2,-454
"Worcester County, MD",MD,2020,25367,22436,2931,11.6,-812
"Worcester County, MD",MD,2019,26179,24307,1872,7.2,424
"Worcester County, MD",MD,2018,25755,23811,1944,7.5,46
"Worcester County, MD",MD,2017,25709,23592,2117,8.2,551
"Worcester County, MD",MD,2016,25158,22900,2258,9.0,-265
"Worcester County, MD",MD,2015,25423,22784,2639,10.4,-217
"Worcester County, MD",MD,2014,25640,22722,2918,11.4,-248
"Worcester County, MD",MD,2013,25888,22663,3225,12.5,-220
"Worcester County, MD",MD,2012,26108,22776,3332,12.8,-270
"Worcester County, MD",MD,2011,26378,22718,3660,13.9,-151
"Worcester County, MD",MD,2010,26529,22894,3635,13.7,0
"Worth County, GA",GA,2021,8888,8536,352,4.0,75
"Worth County, GA",GA,2020,8813,8335,478,5.4,-249
"Worth County, GA",GA,2019,9062,8700,362,4.0,93
"Worth County, GA",GA,2018,8969,8565,404,4.5,-388
"Worth County, GA",GA,2017,9357,8899,458,4.9,232
"Worth County, GA",GA,2016,9125,8586,539,5.9,381
"Worth County, GA",GA,2015,8744,8168,576,6.6,-185
"Worth County, GA",GA,2014,8929,8223,706,7.9,-303
"Worth County, GA",GA,2013,9232,8387,845,9.2,-354
"Worth County, GA",GA,2012,9586,8625,961,10.0,-191
"Worth County, GA",GA,2011,9777,8660,1117,11.4,-33
"Worth County, GA",GA,2010,9810,8607,1203,12.3,0
"Worth County, IA",IA,2021,4016,3846,170,4.2,-99
"Worth County, IA",IA,2020,4115,3899,216,5.2,-161
"Worth County, IA",IA,2019,4276,4162,114,2.7,49
"Worth County, IA",IA,2018,4227,4112,115,2.7,-17
"Worth County, IA",IA,2017,4244,4118,126,3.0,-48
"Worth County, IA",IA,2016,4292,4146,146,3.4,64
"Worth County, IA",IA,2015,4228,4061,167,3.9,24
"Worth County, IA",IA,2014,4204,4014,190,4.5,14
"Worth County, IA",IA,2013,4190,3974,216,5.2,-48
"Worth County, IA",IA,2012,4238,4006,232,5.5,-69
"Worth County, IA",IA,2011,4307,4027,280,6.5,-25
"Worth County, IA",IA,2010,4332,4012,320,7.4,0
"Worth County, MO",MO,2021,1181,1151,30,2.5,11
"Worth County, MO",MO,2020,1170,1122,48,4.1,16
"Worth County, MO",MO,2019,1154,1124,30,2.6,-36
"Worth County, MO",MO,2018,1190,1157,33,2.8,0
"Worth County, MO",MO,2017,1190,1160,30,2.5,-20
"Worth County, MO",MO,2016,1210,1174,36,3.0,0
"Worth County, MO",MO,2015,1210,1170,40,3.3,-79
"Worth County, MO",MO,2014,1289,1237,52,4.0,-25
"Worth County, MO",MO,2013,1314,1260,54,4.1,78
"Worth County, MO",MO,2012,1236,1183,53,4.3,2
"Worth County, MO",MO,2011,1234,1162,72,5.8,-10
"Worth County, MO",MO,2010,1244,1160,84,6.8,0
"Wrangell Borough/city, AK",AK,2021,946,875,71,7.5,-9
"Wrangell Borough/city, AK",AK,2020,955,867,88,9.2,-76
"Wrangell Borough/city, AK",AK,2019,1031,961,70,6.8,-10
"Wrangell Borough/city, AK",AK,2018,1041,975,66,6.3,-7
"Wrangell Borough/city, AK",AK,2017,1048,973,75,7.2,-5
"Wrangell Borough/city, AK",AK,2016,1053,977,76,7.2,25
"Wrangell Borough/city, AK",AK,2015,1028,950,78,7.6,-29
"Wrangell Borough/city, AK",AK,2014,1057,970,87,8.2,3
"Wrangell Borough/city, AK",AK,2013,1054,969,85,8.1,32
"Wrangell Borough/city, AK",AK,2012,1022,937,85,8.3,-26
"Wrangell Borough/city, AK",AK,2011,1048,967,81,7.7,20
"Wrangell Borough/city, AK",AK,2010,1028,942,86,8.4,0
"Wright County, IA",IA,2021,6679,6402,277,4.1,-340
"Wright County, IA",IA,2020,7019,6747,272,3.9,-88
"Wright County, IA",IA,2019,7107,6934,173,2.4,553
"Wright County, IA",IA,2018,6554,6385,169,2.6,-37
"Wright County, IA",IA,2017,6591,6368,223,3.4,-135
"Wright County, IA",IA,2016,6726,6452,274,4.1,-182
"Wright County, IA",IA,2015,6908,6641,267,3.9,-43
"Wright County, IA",IA,2014,6951,6667,284,4.1,97
"Wright County, IA",IA,2013,6854,6547,307,4.5,35
"Wright County, IA",IA,2012,6819,6452,367,5.4,0
"Wright County, IA",IA,2011,6819,6343,476,7.0,-21
"Wright County, IA",IA,2010,6840,6342,498,7.3,0
"Wright County, MN",MN,2021,75116,72797,2319,3.1,-2043
"Wright County, MN",MN,2020,77159,72766,4393,5.7,-321
"Wright County, MN",MN,2019,77480,74807,2673,3.4,1806
"Wright County, MN",MN,2018,75674,73266,2408,3.2,1162
"Wright County, MN",MN,2017,74512,71863,2649,3.6,1452
"Wright County, MN",MN,2016,73060,70243,2817,3.9,909
"Wright County, MN",MN,2015,72151,69443,2708,3.8,798
"Wright County, MN",MN,2014,71353,68273,3080,4.3,720
"Wright County, MN",MN,2013,70633,67015,3618,5.1,268
"Wright County, MN",MN,2012,70365,66223,4142,5.9,-62
"Wright County, MN",MN,2011,70427,65617,4810,6.8,281
"Wright County, MN",MN,2010,70146,64495,5651,8.1,0
"Wright County, MO",MO,2021,7596,7290,306,4.0,222
"Wright County, MO",MO,2020,7374,6866,508,6.9,-18
"Wright County, MO",MO,2019,7392,7024,368,5.0,-19
"Wright County, MO",MO,2018,7411,7107,304,4.1,-197
"Wright County, MO",MO,2017,7608,7234,374,4.9,13
"Wright County, MO",MO,2016,7595,7146,449,5.9,-4
"Wright County, MO",MO,2015,7599,7114,485,6.4,-16
"Wright County, MO",MO,2014,7615,7058,557,7.3,36
"Wright County, MO",MO,2013,7579,6936,643,8.5,39
"Wright County, MO",MO,2012,7540,6885,655,8.7,-33
"Wright County, MO",MO,2011,7573,6813,760,10.0,-7
"Wright County, MO",MO,2010,7580,6683,897,11.8,0
"Wyandot County, OH",OH,2021,12816,12363,453,3.5,-77
"Wyandot County, OH",OH,2020,12893,12001,892,6.9,-250
"Wyandot County, OH",OH,2019,13143,12730,413,3.1,368
"Wyandot County, OH",OH,2018,12775,12366,409,3.2,55
"Wyandot County, OH",OH,2017,12720,12251,469,3.7,-4
"Wyandot County, OH",OH,2016,12724,12249,475,3.7,337
"Wyandot County, OH",OH,2015,12387,11929,458,3.7,1
"Wyandot County, OH",OH,2014,12386,11842,544,4.4,36
"Wyandot County, OH",OH,2013,12350,11571,779,6.3,211
"Wyandot County, OH",OH,2012,12139,11310,829,6.8,54
"Wyandot County, OH",OH,2011,12085,10973,1112,9.2,-110
"Wyandot County, OH",OH,2010,12195,10837,1358,11.1,0
"Wyandotte County, KS",KS,2021,77532,73905,3627,4.7,-131
"Wyandotte County, KS",KS,2020,77663,71699,5964,7.7,312
"Wyandotte County, KS",KS,2019,77351,74027,3324,4.3,41
"Wyandotte County, KS",KS,2018,77310,73640,3670,4.7,-436
"Wyandotte County, KS",KS,2017,77746,73714,4032,5.2,972
"Wyandotte County, KS",KS,2016,76774,72523,4251,5.5,425
"Wyandotte County, KS",KS,2015,76349,71773,4576,6.0,691
"Wyandotte County, KS",KS,2014,75658,70513,5145,6.8,712
"Wyandotte County, KS",KS,2013,74946,68999,5947,7.9,314
"Wyandotte County, KS",KS,2012,74632,68370,6262,8.4,-181
"Wyandotte County, KS",KS,2011,74813,67823,6990,9.3,-84
"Wyandotte County, KS",KS,2010,74897,67492,7405,9.9,0
"Wyoming County, NY",NY,2021,17916,17115,801,4.5,-265
"Wyoming County, NY",NY,2020,18181,16866,1315,7.2,-341
"Wyoming County, NY",NY,2019,18522,17742,780,4.2,170
"Wyoming County, NY",NY,2018,18352,17508,844,4.6,115
"Wyoming County, NY",NY,2017,18237,17220,1017,5.6,122
"Wyoming County, NY",NY,2016,18115,17133,982,5.4,-235
"Wyoming County, NY",NY,2015,18350,17307,1043,5.7,19
"Wyoming County, NY",NY,2014,18331,17126,1205,6.6,-469
"Wyoming County, NY",NY,2013,18800,17272,1528,8.1,-76
"Wyoming County, NY",NY,2012,18876,17183,1693,9.0,-33
"Wyoming County, NY",NY,2011,18909,17246,1663,8.8,-561
"Wyoming County, NY",NY,2010,19470,17601,1869,9.6,0
"Wyoming County, PA",PA,2021,13216,12380,836,6.3,-124
"Wyoming County, PA",PA,2020,13340,12215,1125,8.4,-357
"Wyoming County, PA",PA,2019,13697,13012,685,5.0,-59
"Wyoming County, PA",PA,2018,13756,13109,647,4.7,-221
"Wyoming County, PA",PA,2017,13977,13227,750,5.4,-150
"Wyoming County, PA",PA,2016,14127,13261,866,6.1,5
"Wyoming County, PA",PA,2015,14122,13246,876,6.2,-137
"Wyoming County, PA",PA,2014,14259,13299,960,6.7,-12
"Wyoming County, PA",PA,2013,14271,13079,1192,8.4,-89
"Wyoming County, PA",PA,2012,14360,13102,1258,8.8,64
"Wyoming County, PA",PA,2011,14296,13065,1231,8.6,9
"Wyoming County, PA",PA,2010,14287,13072,1215,8.5,0
"Wyoming County, WV",WV,2021,7183,6767,416,5.8,354
"Wyoming County, WV",WV,2020,6829,6164,665,9.7,162
"Wyoming County, WV",WV,2019,6667,6200,467,7.0,-205
"Wyoming County, WV",WV,2018,6872,6399,473,6.9,-36
"Wyoming County, WV",WV,2017,6908,6419,489,7.1,-536
"Wyoming County, WV",WV,2016,7444,6685,759,10.2,-389
"Wyoming County, WV",WV,2015,7833,7095,738,9.4,-188
"Wyoming County, WV",WV,2014,8021,7271,750,9.4,-275
"Wyoming County, WV",WV,2013,8296,7537,759,9.1,-81
"Wyoming County, WV",WV,2012,8377,7633,744,8.9,69
"Wyoming County, WV",WV,2011,8308,7595,713,8.6,-98
"Wyoming County, WV",WV,2010,8406,7530,876,10.4,0
"Wythe County, VA",VA,2021,13516,12972,544,4.0,-343
"Wythe County, VA",VA,2020,13859,12790,1069,7.7,-43
"Wythe County, VA",VA,2019,13902,13410,492,3.5,41
"Wythe County, VA",VA,2018,13861,13350,511,3.7,-301
"Wythe County, VA",VA,2017,14162,13457,705,5.0,489
"Wythe County, VA",VA,2016,13673,12905,768,5.6,-21
"Wythe County, VA",VA,2015,13694,12961,733,5.4,-140
"Wythe County, VA",VA,2014,13834,12960,874,6.3,-161
"Wythe County, VA",VA,2013,13995,12931,1064,7.6,-101
"Wythe County, VA",VA,2012,14096,13028,1068,7.6,-264
"Wythe County, VA",VA,2011,14360,13045,1315,9.2,58
"Wythe County, VA",VA,2010,14302,12681,1621,11.3,0
"Yabucoa Municipio, PR",PR,2021,9164,8217,947,10.3,
"Yabucoa Municipio, PR",PR,2020,N.A.,N.A.,N.A.,N.A.,
"Yabucoa Municipio, PR",PR,2019,8841,7686,1155,13.1,50
"Yabucoa Municipio, PR",PR,2018,8791,7534,1257,14.3,-209
"Yabucoa Municipio, PR",PR,2017,9000,7512,1488,16.5,-81
"Yabucoa Municipio, PR",PR,2016,9081,7545,1536,16.9,-117
"Yabucoa Municipio, PR",PR,2015,9198,7593,1605,17.4,-444
"Yabucoa Municipio, PR",PR,2014,9642,7546,2096,21.7,-527
"Yabucoa Municipio, PR",PR,2013,10169,7742,2427,23.9,-133
"Yabucoa Municipio, PR",PR,2012,10302,7903,2399,23.3,-328
"Yabucoa Municipio, PR",PR,2011,10630,7924,2706,25.5,-373
"Yabucoa Municipio, PR",PR,2010,11003,8210,2793,25.4,0
"Yadkin County, NC",NC,2021,17084,16362,722,4.2,235
"Yadkin County, NC",NC,2020,16849,15687,1162,6.9,-731
"Yadkin County, NC",NC,2019,17580,16983,597,3.4,205
"Yadkin County, NC",NC,2018,17375,16779,596,3.4,-68
"Yadkin County, NC",NC,2017,17443,16755,688,3.9,-114
"Yadkin County, NC",NC,2016,17557,16786,771,4.4,86
"Yadkin County, NC",NC,2015,17471,16608,863,4.9,-58
"Yadkin County, NC",NC,2014,17529,16564,965,5.5,-387
"Yadkin County, NC",NC,2013,17916,16567,1349,7.5,-205
"Yadkin County, NC",NC,2012,18121,16414,1707,9.4,54
"Yadkin County, NC",NC,2011,18067,16201,1866,10.3,-200
"Yadkin County, NC",NC,2010,18267,16282,1985,10.9,0
"Yakima County, WA",WA,2021,131217,122071,9146,7.0,-2162
"Yakima County, WA",WA,2020,133379,120855,12524,9.4,-134
"Yakima County, WA",WA,2019,133513,123998,9515,7.1,3763
"Yakima County, WA",WA,2018,129750,121562,8188,6.3,3639
"Yakima County, WA",WA,2017,126111,117646,8465,6.7,221
"Yakima County, WA",WA,2016,125890,116529,9361,7.4,4175
"Yakima County, WA",WA,2015,121715,112179,9536,7.8,2484
"Yakima County, WA",WA,2014,119231,109163,10068,8.4,368
"Yakima County, WA",WA,2013,118863,107243,11620,9.8,-1518
"Yakima County, WA",WA,2012,120381,108705,11676,9.7,1411
"Yakima County, WA",WA,2011,118970,107479,11491,9.7,-598
"Yakima County, WA",WA,2010,119568,108095,11473,9.6,0
"Yakutat Borough/city, AK",AK,2021,308,286,22,7.1,29
"Yakutat Borough/city, AK",AK,2020,279,255,24,8.6,28
"Yakutat Borough/city, AK",AK,2019,251,234,17,6.8,4
"Yakutat Borough/city, AK",AK,2018,247,229,18,7.3,14
"Yakutat Borough/city, AK",AK,2017,233,213,20,8.6,-11
"Yakutat Borough/city, AK",AK,2016,244,224,20,8.2,-15
"Yakutat Borough/city, AK",AK,2015,259,237,22,8.5,-14
"Yakutat Borough/city, AK",AK,2014,273,246,27,9.9,-11
"Yakutat Borough/city, AK",AK,2013,284,257,27,9.5,-3
"Yakutat Borough/city, AK",AK,2012,287,259,28,9.8,-13
"Yakutat Borough/city, AK",AK,2011,300,267,33,11.0,3
"Yakutat Borough/city, AK",AK,2010,297,264,33,11.1,0
"Yalobusha County, MS",MS,2021,4902,4633,269,5.5,61
"Yalobusha County, MS",MS,2020,4841,4469,372,7.7,-138
"Yalobusha County, MS",MS,2019,4979,4693,286,5.7,-127
"Yalobusha County, MS",MS,2018,5106,4848,258,5.1,40
"Yalobusha County, MS",MS,2017,5066,4783,283,5.6,202
"Yalobusha County, MS",MS,2016,4864,4553,311,6.4,-48
"Yalobusha County, MS",MS,2015,4912,4556,356,7.2,5
"Yalobusha County, MS",MS,2014,4907,4450,457,9.3,-119
"Yalobusha County, MS",MS,2013,5026,4527,499,9.9,-462
"Yalobusha County, MS",MS,2012,5488,4946,542,9.9,106
"Yalobusha County, MS",MS,2011,5382,4763,619,11.5,172
"Yalobusha County, MS",MS,2010,5210,4522,688,13.2,0
"Yamhill County, OR",OR,2021,55328,52704,2624,4.7,1197
"Yamhill County, OR",OR,2020,54131,50468,3663,6.8,-221
"Yamhill County, OR",OR,2019,54352,52525,1827,3.4,322
"Yamhill County, OR",OR,2018,54030,52076,1954,3.6,359
"Yamhill County, OR",OR,2017,53671,51688,1983,3.7,604
"Yamhill County, OR",OR,2016,53067,50668,2399,4.5,2167
"Yamhill County, OR",OR,2015,50900,48276,2624,5.2,561
"Yamhill County, OR",OR,2014,50339,47153,3186,6.3,632
"Yamhill County, OR",OR,2013,49707,46009,3698,7.4,-1120
"Yamhill County, OR",OR,2012,50827,46519,4308,8.5,-612
"Yamhill County, OR",OR,2011,51439,46666,4773,9.3,26
"Yamhill County, OR",OR,2010,51413,46014,5399,10.5,0
"Yancey County, NC",NC,2021,7992,7649,343,4.3,72
"Yancey County, NC",NC,2020,7920,7410,510,6.4,-449
"Yancey County, NC",NC,2019,8369,8061,308,3.7,239
"Yancey County, NC",NC,2018,8130,7833,297,3.7,809
"Yancey County, NC",NC,2017,7321,6987,334,4.6,-134
"Yancey County, NC",NC,2016,7455,7070,385,5.2,47
"Yancey County, NC",NC,2015,7408,6976,432,5.8,-81
"Yancey County, NC",NC,2014,7489,6998,491,6.6,-332
"Yancey County, NC",NC,2013,7821,7094,727,9.3,-225
"Yancey County, NC",NC,2012,8046,7166,880,10.9,130
"Yancey County, NC",NC,2011,7916,7019,897,11.3,79
"Yancey County, NC",NC,2010,7837,6917,920,11.7,0
"Yankton County, SD",SD,2021,11629,11313,316,2.7,-47
"Yankton County, SD",SD,2020,11676,11175,501,4.3,-182
"Yankton County, SD",SD,2019,11858,11568,290,2.4,75
"Yankton County, SD",SD,2018,11783,11497,286,2.4,193
"Yankton County, SD",SD,2017,11590,11278,312,2.7,-53
"Yankton County, SD",SD,2016,11643,11341,302,2.6,-30
"Yankton County, SD",SD,2015,11673,11374,299,2.6,217
"Yankton County, SD",SD,2014,11456,11120,336,2.9,-138
"Yankton County, SD",SD,2013,11594,11214,380,3.3,-98
"Yankton County, SD",SD,2012,11692,11285,407,3.5,152
"Yankton County, SD",SD,2011,11540,11040,500,4.3,53
"Yankton County, SD",SD,2010,11487,10932,555,4.8,0
"Yates County, NY",NY,2021,11527,11089,438,3.8,-250
"Yates County, NY",NY,2020,11777,11039,738,6.3,-431
"Yates County, NY",NY,2019,12208,11771,437,3.6,172
"Yates County, NY",NY,2018,12036,11585,451,3.7,198
"Yates County, NY",NY,2017,11838,11322,516,4.4,118
"Yates County, NY",NY,2016,11720,11194,526,4.5,-2
"Yates County, NY",NY,2015,11722,11134,588,5.0,45
"Yates County, NY",NY,2014,11677,11011,666,5.7,-284
"Yates County, NY",NY,2013,11961,11122,839,7.0,-110
"Yates County, NY",NY,2012,12071,11116,955,7.9,-33
"Yates County, NY",NY,2011,12104,11190,914,7.6,-135
"Yates County, NY",NY,2010,12239,11317,922,7.5,0
"Yauco Municipio, PR",PR,2021,10213,9014,1199,11.7,
"Yauco Municipio, PR",PR,2020,N.A.,N.A.,N.A.,N.A.,
"Yauco Municipio, PR",PR,2019,9851,8409,1442,14.6,103
"Yauco Municipio, PR",PR,2018,9748,8315,1433,14.7,-412
"Yauco Municipio, PR",PR,2017,10160,8409,1751,17.2,-575
"Yauco Municipio, PR",PR,2016,10735,8719,2016,18.8,-13
"Yauco Municipio, PR",PR,2015,10748,8717,2031,18.9,-283
"Yauco Municipio, PR",PR,2014,11031,8665,2366,21.4,-319
"Yauco Municipio, PR",PR,2013,11350,8959,2391,21.1,-181
"Yauco Municipio, PR",PR,2012,11531,9140,2391,20.7,-229
"Yauco Municipio, PR",PR,2011,11760,9263,2497,21.2,-338
"Yauco Municipio, PR",PR,2010,12098,9514,2584,21.4,0
"Yavapai County, AZ",AZ,2021,105108,100771,4337,4.1,1637
"Yavapai County, AZ",AZ,2020,103471,95949,7522,7.3,160
"Yavapai County, AZ",AZ,2019,103311,98601,4710,4.6,1611
"Yavapai County, AZ",AZ,2018,101700,97201,4499,4.4,2352
"Yavapai County, AZ",AZ,2017,99348,94790,4558,4.6,-568
"Yavapai County, AZ",AZ,2016,99916,94913,5003,5.0,3181
"Yavapai County, AZ",AZ,2015,96735,91286,5449,5.6,1858
"Yavapai County, AZ",AZ,2014,94877,88836,6041,6.4,2218
"Yavapai County, AZ",AZ,2013,92659,85427,7232,7.8,-503
"Yavapai County, AZ",AZ,2012,93162,85150,8012,8.6,-418
"Yavapai County, AZ",AZ,2011,93580,84420,9160,9.8,-3154
"Yavapai County, AZ",AZ,2010,96734,86472,10262,10.6,0
"Yazoo County, MS",MS,2021,8946,8292,654,7.3,-18
"Yazoo County, MS",MS,2020,8964,8067,897,10.0,-976
"Yazoo County, MS",MS,2019,9940,9311,629,6.3,587
"Yazoo County, MS",MS,2018,9353,8817,536,5.7,284
"Yazoo County, MS",MS,2017,9069,8501,568,6.3,-139
"Yazoo County, MS",MS,2016,9208,8515,693,7.5,27
"Yazoo County, MS",MS,2015,9181,8420,761,8.3,-70
"Yazoo County, MS",MS,2014,9251,8321,930,10.1,-195
"Yazoo County, MS",MS,2013,9446,8412,1034,10.9,-497
"Yazoo County, MS",MS,2012,9943,8848,1095,11.0,-216
"Yazoo County, MS",MS,2011,10159,8963,1196,11.8,231
"Yazoo County, MS",MS,2010,9928,8746,1182,11.9,0
"Yell County, AR",AR,2021,7831,7520,311,4.0,-102
"Yell County, AR",AR,2020,7933,7526,407,5.1,-458
"Yell County, AR",AR,2019,8391,8063,328,3.9,-93
"Yell County, AR",AR,2018,8484,8134,350,4.1,-74
"Yell County, AR",AR,2017,8558,8211,347,4.1,-142
"Yell County, AR",AR,2016,8700,8311,389,4.5,-301
"Yell County, AR",AR,2015,9001,8551,450,5.0,-127
"Yell County, AR",AR,2014,9128,8627,501,5.5,-14
"Yell County, AR",AR,2013,9142,8559,583,6.4,-184
"Yell County, AR",AR,2012,9326,8725,601,6.4,-278
"Yell County, AR",AR,2011,9604,8921,683,7.1,-118
"Yell County, AR",AR,2010,9722,8967,755,7.8,0
"Yellow Medicine County, MN",MN,2021,4961,4813,148,3.0,-374
"Yellow Medicine County, MN",MN,2020,5335,5084,251,4.7,-80
"Yellow Medicine County, MN",MN,2019,5415,5196,219,4.0,44
"Yellow Medicine County, MN",MN,2018,5371,5199,172,3.2,-5
"Yellow Medicine County, MN",MN,2017,5376,5188,188,3.5,-99
"Yellow Medicine County, MN",MN,2016,5475,5265,210,3.8,-114
"Yellow Medicine County, MN",MN,2015,5589,5379,210,3.8,90
"Yellow Medicine County, MN",MN,2014,5499,5266,233,4.2,-47
"Yellow Medicine County, MN",MN,2013,5546,5270,276,5.0,-140
"Yellow Medicine County, MN",MN,2012,5686,5398,288,5.1,-69
"Yellow Medicine County, MN",MN,2011,5755,5425,330,5.7,-127
"Yellow Medicine County, MN",MN,2010,5882,5511,371,6.3,0
"Yellowstone County, MT",MT,2021,84311,81654,2657,3.2,667
"Yellowstone County, MT",MT,2020,83644,79187,4457,5.3,551
"Yellowstone County, MT",MT,2019,83093,80365,2728,3.3,799
"Yellowstone County, MT",MT,2018,82294,79543,2751,3.3,472
"Yellowstone County, MT",MT,2017,81822,78912,2910,3.6,693
"Yellowstone County, MT",MT,2016,81129,78099,3030,3.7,332
"Yellowstone County, MT",MT,2015,80797,78046,2751,3.4,1320
"Yellowstone County, MT",MT,2014,79477,76525,2952,3.7,130
"Yellowstone County, MT",MT,2013,79347,75946,3401,4.3,638
"Yellowstone County, MT",MT,2012,78709,75206,3503,4.5,1539
"Yellowstone County, MT",MT,2011,77170,73155,4015,5.2,702
"Yellowstone County, MT",MT,2010,76468,72045,4423,5.8,0
"Yoakum County, TX",TX,2021,3284,3027,257,7.8,-200
"Yoakum County, TX",TX,2020,3484,3066,418,12.0,-218
"Yoakum County, TX",TX,2019,3702,3595,107,2.9,25
"Yoakum County, TX",TX,2018,3677,3571,106,2.9,-117
"Yoakum County, TX",TX,2017,3794,3659,135,3.6,32
"Yoakum County, TX",TX,2016,3762,3582,180,4.8,-285
"Yoakum County, TX",TX,2015,4047,3894,153,3.8,-239
"Yoakum County, TX",TX,2014,4286,4155,131,3.1,82
"Yoakum County, TX",TX,2013,4204,4041,163,3.9,-122
"Yoakum County, TX",TX,2012,4326,4153,173,4.0,165
"Yoakum County, TX",TX,2011,4161,3936,225,5.4,466
"Yoakum County, TX",TX,2010,3695,3436,259,7.0,0
"Yolo County, CA",CA,2021,106122,99926,6196,5.8,1484
"Yolo County, CA",CA,2020,104638,96435,8203,7.8,-3483
"Yolo County, CA",CA,2019,108121,103583,4538,4.2,584
"Yolo County, CA",CA,2018,107537,102886,4651,4.3,973
"Yolo County, CA",CA,2017,106564,101083,5481,5.1,486
"Yolo County, CA",CA,2016,106078,99812,6266,5.9,1924
"Yolo County, CA",CA,2015,104154,97384,6770,6.5,2126
"Yolo County, CA",CA,2014,102028,94258,7770,7.6,553
"Yolo County, CA",CA,2013,101475,92218,9257,9.1,-922
"Yolo County, CA",CA,2012,102397,91322,11075,10.8,764
"Yolo County, CA",CA,2011,101633,89464,12169,12.0,-620
"Yolo County, CA",CA,2010,102253,89606,12647,12.4,0
"York County, ME",ME,2021,112246,107197,5049,4.5,1709
"York County, ME",ME,2020,110537,105050,5487,5.0,-4805
"York County, ME",ME,2019,115342,112492,2850,2.5,436
"York County, ME",ME,2018,114906,111685,3221,2.8,641
"York County, ME",ME,2017,114265,110844,3421,3.0,2829
"York County, ME",ME,2016,111436,107686,3750,3.4,2243
"York County, ME",ME,2015,109193,104891,4302,3.9,-950
"York County, ME",ME,2014,110143,104495,5648,5.1,-992
"York County, ME",ME,2013,111135,104047,7088,6.4,612
"York County, ME",ME,2012,110523,103173,7350,6.7,894
"York County, ME",ME,2011,109629,101749,7880,7.2,581
"York County, ME",ME,2010,109048,100031,9017,8.3,0
"York County, NE",NE,2021,7338,7195,143,1.9,11
"York County, NE",NE,2020,7327,7086,241,3.3,-57
"York County, NE",NE,2019,7384,7189,195,2.6,6
"York County, NE",NE,2018,7378,7188,190,2.6,-17
"York County, NE",NE,2017,7395,7204,191,2.6,30
"York County, NE",NE,2016,7365,7166,199,2.7,-3
"York County, NE",NE,2015,7368,7155,213,2.9,-32
"York County, NE",NE,2014,7400,7167,233,3.1,-81
"York County, NE",NE,2013,7481,7218,263,3.5,-104
"York County, NE",NE,2012,7585,7312,273,3.6,67
"York County, NE",NE,2011,7518,7191,327,4.3,117
"York County, NE",NE,2010,7401,7051,350,4.7,0
"York County, PA",PA,2021,234914,222181,12733,5.4,-1457
"York County, PA",PA,2020,236371,217448,18923,8.0,-2113
"York County, PA",PA,2019,238484,229069,9415,3.9,1439
"York County, PA",PA,2018,237045,227519,9526,4.0,242
"York County, PA",PA,2017,236803,226281,10522,4.4,1722
"York County, PA",PA,2016,235081,224336,10745,4.6,2484
"York County, PA",PA,2015,232597,221333,11264,4.8,2244
"York County, PA",PA,2014,230353,217797,12556,5.5,-1029
"York County, PA",PA,2013,231382,216313,15069,6.5,-1349
"York County, PA",PA,2012,232731,215842,16889,7.3,2538
"York County, PA",PA,2011,230193,213294,16899,7.3,495
"York County, PA",PA,2010,229698,210966,18732,8.2,0
"York County, SC",SC,2021,145482,140086,5396,3.7,2874
"York County, SC",SC,2020,142608,134279,8329,5.8,4180
"York County, SC",SC,2019,138428,134687,3741,2.7,4955
"York County, SC",SC,2018,133473,129186,4287,3.2,2255
"York County, SC",SC,2017,131218,126065,5153,3.9,938
"York County, SC",SC,2016,130280,124395,5885,4.5,3677
"York County, SC",SC,2015,126603,119739,6864,5.4,3979
"York County, SC",SC,2014,122624,115119,7505,6.1,2818
"York County, SC",SC,2013,119806,110828,8978,7.5,1057
"York County, SC",SC,2012,118749,107974,10775,9.1,1224
"York County, SC",SC,2011,117525,104847,12678,10.8,841
"York County, SC",SC,2010,116684,102355,14329,12.3,0
"York County, VA",VA,2021,31945,30888,1057,3.3,-856
"York County, VA",VA,2020,32801,30991,1810,5.5,-720
"York County, VA",VA,2019,33521,32638,883,2.6,538
"York County, VA",VA,2018,32983,32073,910,2.8,166
"York County, VA",VA,2017,32817,31676,1141,3.5,662
"York County, VA",VA,2016,32155,30926,1229,3.8,34
"York County, VA",VA,2015,32121,30763,1358,4.2,177
"York County, VA",VA,2014,31944,30376,1568,4.9,97
"York County, VA",VA,2013,31847,30175,1672,5.3,175
"York County, VA",VA,2012,31672,29876,1796,5.7,-184
"York County, VA",VA,2011,31856,29904,1952,6.1,530
"York County, VA",VA,2010,31326,29363,1963,6.3,0
"Young County, TX",TX,2021,8066,7701,365,4.5,380
"Young County, TX",TX,2020,7686,7280,406,5.3,-217
"Young County, TX",TX,2019,7903,7668,235,3.0,-186
"Young County, TX",TX,2018,8089,7824,265,3.3,73
"Young County, TX",TX,2017,8016,7711,305,3.8,-296
"Young County, TX",TX,2016,8312,7947,365,4.4,-161
"Young County, TX",TX,2015,8473,8109,364,4.3,-184
"Young County, TX",TX,2014,8657,8299,358,4.1,101
"Young County, TX",TX,2013,8556,8111,445,5.2,6
"Young County, TX",TX,2012,8550,8065,485,5.7,-39
"Young County, TX",TX,2011,8589,7953,636,7.4,-69
"Young County, TX",TX,2010,8658,7990,668,7.7,0
"Yuba County, CA",CA,2021,30752,28148,2604,8.5,87
"Yuba County, CA",CA,2020,30665,27370,3295,10.7,872
"Yuba County, CA",CA,2019,29793,27944,1849,6.2,552
"Yuba County, CA",CA,2018,29241,27346,1895,6.5,523
"Yuba County, CA",CA,2017,28718,26570,2148,7.5,565
"Yuba County, CA",CA,2016,28153,25722,2431,8.6,427
"Yuba County, CA",CA,2015,27726,25135,2591,9.3,-127
"Yuba County, CA",CA,2014,27853,24696,3157,11.3,-313
"Yuba County, CA",CA,2013,28166,24414,3752,13.3,-632
"Yuba County, CA",CA,2012,28798,24297,4501,15.6,-135
"Yuba County, CA",CA,2011,28933,23940,4993,17.3,-204
"Yuba County, CA",CA,2010,29137,23841,5296,18.2,0
"Yukon-Koyukuk Census Area, AK",AK,2021,2441,2138,303,12.4,107
"Yukon-Koyukuk Census Area, AK",AK,2020,2334,2041,293,12.6,-107
"Yukon-Koyukuk Census Area, AK",AK,2019,2441,2129,312,12.8,-98
"Yukon-Koyukuk Census Area, AK",AK,2018,2539,2194,345,13.6,80
"Yukon-Koyukuk Census Area, AK",AK,2017,2459,2051,408,16.6,51
"Yukon-Koyukuk Census Area, AK",AK,2016,2408,1994,414,17.2,13
"Yukon-Koyukuk Census Area, AK",AK,2015,2395,1968,427,17.8,-176
"Yukon-Koyukuk Census Area, AK",AK,2014,2571,2091,480,18.7,-152
"Yukon-Koyukuk Census Area, AK",AK,2013,2723,2223,500,18.4,-43
"Yukon-Koyukuk Census Area, AK",AK,2012,2766,2280,486,17.6,63
"Yukon-Koyukuk Census Area, AK",AK,2011,2703,2196,507,18.8,128
"Yukon-Koyukuk Census Area, AK",AK,2010,2575,2117,458,17.8,0
"Yuma County, AZ",AZ,2021,93693,81591,12102,12.9,-1075
"Yuma County, AZ",AZ,2020,94768,78717,16051,16.9,-2370
"Yuma County, AZ",AZ,2019,97138,80826,16312,16.8,2740
"Yuma County, AZ",AZ,2018,94398,78454,15944,16.9,1072
"Yuma County, AZ",AZ,2017,93326,77245,16081,17.2,-1345
"Yuma County, AZ",AZ,2016,94671,76590,18081,19.1,422
"Yuma County, AZ",AZ,2015,94249,73736,20513,21.8,253
"Yuma County, AZ",AZ,2014,93996,72444,21552,22.9,-1952
"Yuma County, AZ",AZ,2013,95948,71342,24606,25.6,1335
"Yuma County, AZ",AZ,2012,94613,72028,22585,23.9,2353
"Yuma County, AZ",AZ,2011,92260,70065,22195,24.1,-649
"Yuma County, AZ",AZ,2010,92909,69699,23210,25.0,0
"Yuma County, CO",CO,2021,5668,5513,155,2.7,116
"Yuma County, CO",CO,2020,5552,5404,148,2.7,-513
"Yuma County, CO",CO,2019,6065,5974,91,1.5,113
"Yuma County, CO",CO,2018,5952,5842,110,1.8,322
"Yuma County, CO",CO,2017,5630,5546,84,1.5,189
"Yuma County, CO",CO,2016,5441,5330,111,2.0,308
"Yuma County, CO",CO,2015,5133,5004,129,2.5,177
"Yuma County, CO",CO,2014,4956,4792,164,3.3,219
"Yuma County, CO",CO,2013,4737,4515,222,4.7,-131
"Yuma County, CO",CO,2012,4868,4614,254,5.2,-78
"Yuma County, CO",CO,2011,4946,4675,271,5.5,41
"Yuma County, CO",CO,2010,4905,4614,291,5.9,0
"Zapata County, TX",TX,2021,4526,3980,546,12.1,-114
"Zapata County, TX",TX,2020,4640,4072,568,12.2,-417
"Zapata County, TX",TX,2019,5057,4802,255,5.0,-252
"Zapata County, TX",TX,2018,5309,5012,297,5.6,-42
"Zapata County, TX",TX,2017,5351,4949,402,7.5,141
"Zapata County, TX",TX,2016,5210,4648,562,10.8,-984
"Zapata County, TX",TX,2015,6194,5718,476,7.7,-735
"Zapata County, TX",TX,2014,6929,6564,365,5.3,-121
"Zapata County, TX",TX,2013,7050,6607,443,6.3,248
"Zapata County, TX",TX,2012,6802,6374,428,6.3,337
"Zapata County, TX",TX,2011,6465,5925,540,8.4,696
"Zapata County, TX",TX,2010,5769,5167,602,10.4,0
"Zavala County, TX",TX,2021,3276,2861,415,12.7,-94
"Zavala County, TX",TX,2020,3370,2889,481,14.3,60
"Zavala County, TX",TX,2019,3310,3030,280,8.5,-218
"Zavala County, TX",TX,2018,3528,3186,342,9.7,-178
"Zavala County, TX",TX,2017,3706,3289,417,11.3,-181
"Zavala County, TX",TX,2016,3887,3347,540,13.9,77
"Zavala County, TX",TX,2015,3810,3381,429,11.3,-86
"Zavala County, TX",TX,2014,3896,3417,479,12.3,-110
"Zavala County, TX",TX,2013,4006,3421,585,14.6,-372
"Zavala County, TX",TX,2012,4378,3790,588,13.4,-220
"Zavala County, TX",TX,2011,4598,3932,666,14.5,34
"Zavala County, TX",TX,2010,4564,3928,636,13.9,0
"Ziebach County, SD",SD,2021,952,909,43,4.5,10
"Ziebach County, SD",SD,2020,942,902,40,4.2,15
"Ziebach County, SD",SD,2019,927,883,44,4.7,10
"Ziebach County, SD",SD,2018,917,873,44,4.8,-18
"Ziebach County, SD",SD,2017,935,889,46,4.9,-46
"Ziebach County, SD",SD,2016,981,936,45,4.6,-8
"Ziebach County, SD",SD,2015,989,940,49,5.0,-22
"Ziebach County, SD",SD,2014,1011,953,58,5.7,-26
"Ziebach County, SD",SD,2013,1037,974,63,6.1,-28
"Ziebach County, SD",SD,2012,1065,995,70,6.6,-6
"Ziebach County, SD",SD,2011,1071,1004,67,6.3,11
"Ziebach County, SD",SD,2010,1060,999,61,5.8,0